UUBUUUUUUBUUBUUUBUUUBUBUUUUBUUUUUUUUUUBUUUUUUUBBUUUUUUUBBUUUUUBBUUUUUBUBUBUBUUUUBBUUUUUUUUUUUBUUUUBUB
BUUUUBUUBBBUUUUUUBUUBUUBUUUBBUBUUUUUBUUUUUUUBUUUUBUUUBBUUUUUBUUBUUUBBUUBUUUUUUUUBUUUUBBUUBBBBBUBUBUUU
UBUUBUUUUBBUBBUUUUUBUBUUBUUUUUBUUBUUUUUUUUUUUBUUBUBUUUUUUUBBBUUBUUUUUUUUUBBUBUBUBUUUUUUUBUUUUUBBUUUUB
UUUUUBBBBUUUUBBBBUUUBUBUBBUUBUUBUBBUUUUBBBBBUUUBBUUUUUUBBBUUUBBUUBUUUBBUBUUUBUUUBUUUUBUUUUUUUUUBUBUUB
UUBUBBUUUUUUUUBBUBBUUUUUUBUUBUUUUUUUUUUBBUUUUUBBUUUUUUUUBUUUUUUUUUBUUBUBBUBUUUUBUUBUUBUUBUBBUUUUUUUUB
BUUBUUUUBBUUUUUUBUUUBUUUUUUBUUUUUBBUUBUUUUUUUBUUBUBUUUBBBUUUUUUBBUUUUBBBUUBUUUUBUUUBUBUUUUUUUBBUUUUBU
UUUUBUUUUUBUUUUUUBBBBBUUBBUBUUBUUUUUBUBUUBUUUUUUUBUBBUUBBBUBUUUUBUBUUUBUUUBBBUBUBBUUBUBUUUUBUUUUUUUUU
BUUBUUBUUUUBUUUBUUUUUUUBBUUUBUUUUBUUBUUUBBUUUUUUBUUUBUUBBUUUUBUUUUUUUUBBUUBBUUBUUBUUUUBBBUUUBUUBBBUBU
UBUUUUUBUUUBUBBBBUUUBUBUBBUBUUBUUUUUBUUUBUUUUBBUUUBUUUBBUUUUBUUUUUUUBBBBBBUUUUUUUUUUUUBUBUUUBUUUUUUUU
BUUBBUUUUUUUUBBUBUUBBUUUUUBBUUUUUUUUBBUUUBBUUUUUUUUUBUBBUUUUUBUBUUUUBUUBBBUBUUBUUUUUBBUUBBUBUBBUUBUBU
UBBUBUBUUUBUBUUUUUBUUBBUUBUUUUUUBUUUBBBUUUBUUUUUUUBUBUBUUUBUUUBUUUUUUUUUUUUBBBUBUUUUUUBUBUUUBBUBUUBUB
UBUUBBBUBUUUBBUUBUUBBUUUUUUUUUUUBBUUBUUBUUBUBUUBUUBUBUUUUUUUUUBUUUUUUUUBBBUBUBUUBBUBUBUUBUBUBBUUUUUUU
BUUUBBBUUUUUBBUUUBUBBUUUBUUUUBBBUUBBBBUUBUBUUUUUBUUUUUBUUUBUUUUBUUBUUBUUBBUBUUBBUBBUUUUUBBBBUUBUUUUUU
BBUUBBUUUBBBUUBUUUUBUUBUUUBBBBBUUUUUBUUBBUUUUUUBUUUUUUUBUUUUUUUUUUBUUUBUUUUUUBUBUUUUBUUUUBUUUBUBBBBBU
UBUUUUUUBUUUUBUUUUBUUBUUUBUUUUUUUUUUUUUUBUUBUUUUUBBUUBUUUUUUBUBUBUUUUUUUUUUUUUUBUUBBUUBUUUUUBBUUBBBUB
BUBBUUUUBBUUBUUUBUBUUUBUUUUUBUUUUUUUUBBUUUUUUUBUBUUUUBBUBUBUBUUBBBUUUBUUBUUUBUBBUUBUUUUUUUBBUUBBUUUUU
UUBUUBBBUUUUUBBUBUUUBUUBBUUBUBUUUUBUBUBUBUUBUUUUBBBUUUBBUBUBUUUUUBUUBBUUUBBUBUUUUUUUUUUBUUUUUUUBUBBUU
BBUBUUBBUBUUUUUUUBUBUUBUUUUUBUUUUBUUUUUUUUUUUUUUUUUUUUUUUUBUUUUUBUUUBUUUBBBUUUUBUUUBUBUBUUUUBUBUUUBBU
UUUBBUUUBUBUBUUUUUUBUUBUUBUBBUUUUUBUUUUBUUUUBUBUUUBUUBBBUBUUUUBBBUUBUUUUUUUBUUUUUUUBUBUUUUUUBBBUBUBBU
UUBUUUBUUUUBUUBBBUUUUUBUBUUUUUUUUUUUBUBUUUUBBUUUBUBUUBUUUBUUUUBUBUUUUUBUBUUUBBUUUBBUUUUBUUUBUUUUUUUBB
UBUUUUUUBUBUBUUBBBUUBUUUUUUBBUUBUUUUBUUBUUUUBUUUUUUBBUBUUUBBUUUUUUUBUUUUUBUUUBUUUBBUUUUUUUUUUUUBBBUBU
UUUUUUUUBUBUUUBUUUBUUUUBUBUUBBBUUBBUUUUUUUUUUUUBBUUUUUUBBBUUUUBBUUUUBUBUUBUBBBBUUUUBUUUBBUUBUUBUUUUUU
UUUBBUUUUBUUBUUUUBUBBUBUUUUUUUUUUBBBUUUBUUBUUUUUUUUUUUUUBUBUUUUUUBBBBUBUUUUUBUUUUUBBUUUUUUUUUUUUBUBUU
UUUUUUBUUBBUBUBBUUUUUUUUBUUUBBUUUBUUUBBUBUUUUUUUUUBUUBUUBBUBUBUUBUUUBUUBBUUUUBBUUBBUBUUBBUUBUBUUUUUBU
UUUUUUUBUUBUUUUUBUUBUUUUUBUUUUUUBUBUUUUBUBUUUUUBUUBUUUBUBBUBUUUUUUBBUBBUUUUUUUBUUUUBUUUUUUUBUBUUUUBUB
BBBUUUBBUUBUUBUUUBUBBUUUUBUBBBBUUUUBBUUBUUBUUBUUUBBBUBBBBUUUUBUUBUUUUUUBUUBUUBUUUUUUBUBUUUUBBBUUUUUUU
UUUBUUBUUBUUUUUUBBUBBUUUUBBUUUUUUUUUUUBUUUUBBUUUUUUUUUUUBUBUUBUBUUBUBUUBUUUUBUUUBUBUUUUUUUUBUUUUUBUUU
UUUBUBUUUUUUUUBUBUUBBUUBUUUUBBUUUUUUBUUUUUBBUUUUUUUUUUUUBUBBUBUUUUUUUUBUBBUUUUUUUUBUUUBUUUBBUUUUBBUBU
UUBBUUUBBUUUBUUUUUUUUUUUUUBBUUUBUBUUUUBUBBUBUBUUBUUUUBBUUUUUBBUBUUUUBUUUBBUUUBUUBUUBBUUUBBUBUUUUBBUUU
UBBBBBBUUBUUUBBBUUBBUUUBBUUUUUUUUBBUUBUUUBUBUUUUUUUUUBUUBBBUUUUBUUBUUUUUUBUUBBBUUUUUBUUUBUBUUUUUUBBBU
UUBBBUUUUUUUUBBUUBBUUUUUUUBBUBBBUUUUBBBUUBBUUUUBUUUUUUUBUBUUBUBUBBUUUBUUUUBBUUUBBUUUUBUUUUUUBUUUUBUBU
UUBBUBUUBBUBUUUUUUUBBUBUUUBBUBUUBUUUUUBUUUUBBUBBUBUBUUBUUBUUBUUUUUUUBUUBUUUBUBUUUUBUUUBUBUUUBUBUUBBUU
BBUUUBUUUUUUBUBUBUUUUBUUBUUUUUBUUUUUUUUUUUUBBUBBUUUUUUUUUBBUUUUUBUUUUBBUUUUBUUUUUBUBBUBUBUUBUUUBUBUUU
UUUUUUUBUUUUUUBUUUBUUUBUUBUUBBUUUUBBUUUBUUUUUUUBUUUUBBUBUUUUBUUBBUBBUBUUUUBBBUBUBBUUUUUUUUUUBBUUUUUUU
BUUBBUUBUBUBBUUBUUUUUUUBUUUUUUUUUBUUBBBUUBUBUUBUUUBBUBUBBUUUUUBUBUBBUBUUUUBUUBUUBUUUUBUUUBUUUBUUUUUBU
BUUUBUUUUBBUUBUBUUBUUUBBUUUBBBUUBUBBBUBBUUBUBUUUBUUUUBUUUBBUUBBUUUUUUUUBUUUBUUUUUBBUUBUUUBUBBUUUUBUUU
UUUBBUUUBUUBUUUUUUUUUUUUUUUUUBUBUUUUUBBUUUUUUUUUBUBUBUUUBUBUUUUBBUUUUUUUUBUUUUUBUUBUUUUUUBUUBBUUBUUUB
UUUBUBUUBUUBUUUUUUUBUBBUUUUBUBUBUUUBBBUUUUUUUBUUUUBUBUUUBUBUUUUBUBUUUBBUUBBBUBUUUUUUBUUBBUBUUBUBBUUUU
BBUUUUUBUUUBUUBUBBUUUBUUUUBUUUBUUUUUUBUUBBBBBBUUUUBBUUUBUUBBUBBUUUUBUUUUUUUBBUUUUUBUUUUUBUBUBUUBUUUUU
UBBBUUUUUUUUUUUUBUUUUBUBUUBUUBUUBUUBBUUUBUUUUBUUUUUUBBUUUUUUBBUBUBUBBUUUUBUBUBBBUBUBUBBBBUUUBUUBBBBUU
UUBUUUUBUBUUUUBBBUUUUUBUBUUBUUUUBUUUUUUUUUUUBUBUBUUUBUUBBBUUUBBUUUUUUUBBUUUUUUUUUUBUUUUUUBUBUUUBUUUUU
UBUUUUUUUBBUBBUBUBUUUUUUUUUUUBUUUBUUUUBBUBUBUUUBUUUUBUUUBBBBUUBUUBBBUBBUUUUBBUUBUUUUUUUBUUUUBUBUUUBBB
BBUBBUUUUUUUUUUBUUBBBUUUBUBBUBUBBUUUUUUUUBUUUUBUUBBUUUUUUUBUBUUUUBUUUUBUUUUUUBUUUUBUBUUBBUBUUUUBUBBBU
UUUUUBUUUUBUUUUUUUBUUBBUUUBUUUBUBUBBUBBUUBUUUUUBUBUUUBUUBUBUUUUUUUBUUBUUUUUUUUUBUUUUUUBUBBUUUUUUUUUUB
UBUUUBUUUBUUUBUBUUUUUUUUBUBUUUBUBBUBBBBUBBUUBBUUUUBUBUBBUBUBBUUBUUUBBBBUUUUBUUUUUUBUUUUUUBUBBUUBUUUUU
UBBBUUUBBUUBBUUUUBBUUBUUUUUUUUUUBUUUUUUBUUUUUUUBUBUBUUUBBBBBUUUUBUUUUBUBUBUUUBUUBUUUUUUUUBUUUUUUUUUUU
UUUUUUUBUUUUUUUUBUBBUUBUUBUUBUUUBBUBUBBBUUBUBBUBUUBUUBBBBUUUBUUBUUUUUUUBUBUUUUBBUUUUUUUUBUUUUUUBUUUBU
UUUUUUBBBUUBUUUBUBBBBUBUBUUUBBUUUBUUUUUBUBUBBUBBBBUUUUUBUUBBBUUUUBUUUUUBUUUUUUBUUUUBUUUUUUBUUUUUBUBUB
UUUUBBUBUUBBUBUUBUUBUUUUUUUBUUBUUBUUBBBBBBBBBUBUUUUUUBUUBUUUUUBUUUUBUBUBUUBBUUBUUUUUUBUUUBUBUUUBBBUUU
UBBBUBUUUUUBUUBUUUUBUUBUUUUBBUUUUBUUBBUUBUBBBUUUUUUUUUUUUUUUBUUUUUBUBBBUUUBBUUUBUUUUUUBUUBBUUBUUUUUBU
BBBUBBUBBUBBUUUUUUUBUUBUUUBBUBBUUUUUBBUUUUUUBBUUUBUBBBUBUUUUBUUBUUUUUUUUUUUUUUUUUBBUUUUUUBUBUUUUUUUUU
UBBUUBUBBUUUBUBBUUUUUUUBBBUBUUUBUBUBUUUUUBBUUUUUBUUBUUBUUUBUUUUUUBUUBUUBBUUUUUUUBUUUUUUUBUUUUUUUUUBUB
UBBUBUUUUUUUUUUUUUBBUUUBUUUUUUBBUUBBUUUBBUBUUUUBUUUUUUBBUBUUUBBUBUUUUUUUBBUBUBBUUUBUBBUBUBUUUUUBUUUBU
UUUBUUBUUUUUUUUUUUUUUBUUBUBUUUBUBUBUUBUUBUUBUBUUUUBBUBUUUUUUUBUBUUUBUUUBUUBUUBBUBUBBUBUBBUUUUUUUUUUUU
UUUBUUUUUUUUUUUUBBUUBBUUUUUUUBUUUUBUUUUUBUUUUUBUBBUBUUUUUBUUUUUBUUUUUUUUBUUUUUBUBUUBBUUUBUBUBBBUUBUUU
BUUUUUUUUBUBUUUBUBBUUUUUBUBUUBUUUUBBBBUUBUUUBUUUUUUUUUUUUUUBBUBUUUUBUUUUUUUUBUUUUUUUBUBUUUUUUUBBUUUUU
UUUUUUBUUBUUBUUUUUBBUUBUUBBUBUBUUBUUUUBUUUUUUUBBUBBUUUUBUUUBUUBBUUUUUUBUUBUUBBUUUUUUUUUBBUBBUBUUUBBUU
UUUUUBUUUUUBUUBUUUBBUUUUBUBBUUBUUUUUBUUBUUUBUUUUBUUBUBBBUUUBUUUUUBUUUUUUBUUUUUBUBUUUUUUUBUUUBUUUBBBUB
UUUBUUBBUBUBBBUUUBUUUUUBUUUUBUUUBUUUUUUBBBBUUUBBBUUUUBUBUBBUUUUBUUUBUUUUUUUUUUUUUUBBUBUUBUUUUUUUUUUBU
UUUUUUUUBUUBUBUUUUUBBUUUBUUUBUBBUBBUUUBUUUBUBUBUUBUUUUBUUUBBUUUUBUBUBUBUUBBUUUUUBUUUUBUUUUUBBUBUUUUUU
UBUUBUUBUUBBUBUUBBUBBBUBUBBBBUUUUUUUUBUBBUBUBUUBBBUBUBUUBBBUUUBUBUUUUUUBUUBUUBBBUUBUBBUUBUUUUUUBUUUUU
UUBBUBBUBUBUBBUBBBUBBUUUUBUUUBBUUUUUUBUUUUBUUUUUBBUBBUUBUBBUUUUUUUUUUUUUUBUUUUUUUBBUUBUUUUUUUUBUBBBUU
UBUBUUUUUUUUBUBBUUUBBBUUUUBUUBBUBUUBUUBBUUBBUBUUUUUUUUBUUUUUBUUUUUUUUBUUUBUUBUUUBUBUUUUUUBBUUUUUUUUBU
UBUUUUUUUUUBBBBBUUUUUUBUUBBUUBBBUUUBBBUUUUUUBUBBUBUUUBUBBUUUBBUUUUUUUBUUUUBUBUUBUUUBUUBUUUUBUUBBBUUUB
UUBUBUUUBUUUUUUUUBUBUUUBUBUUUBUBUUUUUUUUUBUUBBUBUUUUBBBUBUUUUUBUUUUBUUBUUBUBUBUUBUBBUUBBUUUUUBUUUBBBB
UUUUUUBUBBBUBUBBUUUUUUUBUUUBUUUUUBBUUUBUBUUUUUBUUUBUUBUBUUUUUUUBUBUBUBUBUBUBUUBUUUBBUUUUUUUUUUUBBUUUB
BUUUUBUUUUUUUUBBBBUUUBUUBBUUBUUBUUUBUUUUBBUUUUBBBUUBUUUUBUBUUBUUUBUUUUBBBUUBUUUBUUUUUUUBUUBBUUBUUBUUB
UUUBBBUBBBUUUUUUUUUUUUBBUBUBUUUUUUUBUUBUUBUUBBUUUUUUUUUUBUBBUUUUUBBBUUUUUBUUBBUUUUUUUBUUBUUUUUUBUBBUU
BUBUBBUBBBUUBBBBUUUBUUUBUUBUUBUBUUBBUUBUUBUUUUUUBUBUUUUBUUBBUUUUUUBBUUUUBBUUBUBUUUBUUUUBUUBUBUUBUUBUU
UUBBUBUUBUUUUUUUBUUBUUBUUUUUUUUUBBUUUBUBUBUUUUUUUUBBUBUBUUUBUBUUUUBUUUUUUUBBUBUUBUUUBUUUUUBUUBUUUBUUB
BUUUUUUBUBUBUUUUBUUUBUUUUUUUUUUUUUBUUUUBUUBUUBBUBBUUUBUUUUUUUUUUUUUBUUBBUBUUUUBUUBBUUUUUUUUUUUUUUUUUU
UUUUUBUUBUUBUUUUBUUUBUBUUUUBBUUUUBUBUUUUBUBUBBUUBUUUBBUBUBUUUUBBBBBBUUUUUUUUBBBBUUBUUBBUBBUBUUBUUUUBB
UUUUBUUUUUBUBUUUBUBUUUUUUUUUBUBUUBUBUUBUUBUBBBUUUUUBUUUUUUUUBUUUUUBUBUBUBUBUBBUUBUUUUUUUUBUUUUUBUBUBU
BUBUUUUBBUUUBUUBUUUUUUUUUBBUUUUUUUUUUUBUUBBBUUBBUUBUBBUBBUUUBUUUUUBUUUUBBBUUBUUBUUBUUUUUUUUUUUUUUUUUU
UUBUBUUUUBUBUUUUUUBBUBUUBUBUUBUUUUUBBBBUBBUUBBUUBUBUBBUBBBUBUBBBBBUBBBUBUUBUBUBUUUUUUBBUUUUBUUUUBBUUU
BUUUBUUUUBUUUUUUUUUUUUUBUUBUUUUUUUUUUUUBUUBUUBBUUUUUUBUUBUUUUUUBUBUUUUUUUUUUUUBUBUBUBBUUUUUBUBUBBBUUB
UUUBUUUBUUUUUUUUUBBBUUUUUUUBBBBUBUUBUUUUUUUUBUBBUBUBBUUUBUUUUBUUBUUBBUUUUUUUUBBBUUBUBUBBUBUUBUUUUUBUU
UBUUUUBUUUUBBBUUUBBUUBUBUUUUBUUUUUUUBBUBUUUUBUBUUUBUUUUUBUUUUBUBBUUUBUBUUUBBUUUUBBUUUBUUBUUUUUBUUUUUU
BUUUUBBUUUUUUUBBUUBUUBUBUUUUBUUBBUUUUUUUBBBBUUUUUUUBBBBBBUBBUUUBBUBUUUBUUUBUUUUBBUUUBUUUUUBUUUUUUUUBB
UUUUUUBUUUBBUUUUBBUBUUUUUUBBBUUBBUUUUBBUBUBUUUBUBBUUUUUBUUUBUBUUBUUUUUBBUUUBBBBBBBBBUUUBUUUUUBBUUBUBB
UBUUUUUUUUUUUUUUUBBUUUBUUBBUBBUUBBUBBUBUBBUUBUUUUBUUBUUBUUUBUUBBUUUUBUUUUBUUUBBUUUUBUUBBUBBUUUBUUBBUU
UUBUUUUBBUBUBUUUUUBBUUUUUUUUUUUUUBUUBUUUUUBUBBBBBUUUUUUBUUUBUBUBUUUUUUBBUUUBUUUBUUUUUUUUUUUUUBUUUUUUB
UUUUUUUUUUUUUUUUUUUUUUUBBBUBUUUUUUUUUUUBUUUUUUUBUUUUUBUUBUBUUUBBUBUUUUUUUBUUBUUUUUUUBUUBUUUUBBUBUBBUU
UUUBUUUUUBBUBUUUBUBBUUUUUUUBBUUUBBBBBUUUUUBBUBUUBUBUUBUUUUUBBUUBBUUBUUBUUUUUUUUBUBUUUUUUUUBBUBBBBUBUU
UUUUUBBUUUBBBBUUUUUUBBBBUUUUBUUUUBUUUUUUUUBBUUUUBUUUBUUUUBUBUBBBUBUBUUBUUUUBUUUUUBUUBBUBBUBBUUUBUUUBU
UUUUBBUBUBBBUBBUUUBBBUUUBBUUUUUUBUUBBUBBUBUBBUBBBUUUUBUUUBUUUUUUUBUUUUUBBUUUBUBUUUBBBUUUUBUBBUBUBBUUU
UUUBBBUUUBUUUUUBBUBUUUBUUUUUUUUBUBBUBUUUUUBBUUUBBBBBUBBBUUBUUBBBBUUUUUUUBBBUUBUUUUUUUUBBBBUUUBUUUUBBU
UUUBUBUBUUUUUUUUUBUUBUBBBBUUUUBBUBUUBUUUUUUBUUBBUUUBUUUBBBUUBUUUUUUUUUBBUUUUUBUBUUUUBUBUBUBUBUBUBUUUU
UUUBUUUUUUUBUUBUUBUBUBBUUUUUBBBBBUBUUUUUBBUBUUUBBBBUUUUUUUUBBBBUBUBUUUUUBUUUUUBUUUUUUBUUUBUUBBUUUUUBU
BBUUUBUUUUBUUUUUUBBUUUUBBUUUUUUUUUBBBUUBUUUBUUUUBBUUUBUUUUBBBBUUUUUUUBBUBBUUUUBBBBUUUUBBUBBUUUUUUUUUB
UUUBUUUUBUBUUUBUUBBUBUUUUBUUBBUUUUUBUUUBUUBBBBBBBBUBUUBUUBUBUUBUUBUUUUBUUBBUUUUUUUBBBUUUBUUBUUUUUUUUU
UUBUBUUUUBBUUUUBUUUBUUUUUUUUUUUUUUUBBBBBUUBUUUUUBUBBUUUUUUUBBUBUUUUUUUUUUBUUUUUUBUUUUUUBUBUUUBBUBUBBB
UUUUUUUUBUUUUUUUUUBBUUBUUBUUUBUUUUUBUBUUUUUBUBUUUUBUUUUUBUUUUUUUUBBBUBBBUBBUUBBBBUBUUUUUBUBUUUUUUUUBU
UUBUUUBUBUUUBUUUUBUUBUUUBUUBBUUUBUBBUBUBBBUBBUBUUUUBUUUUUBUUUUBUUUBUUBBUUBUUUUBBUUUUUUUUUUUUUUUUUUUUU
UUBUUUBUBUBBBUUUBBUBUUUUUUBUUUUUUUUBUUBUBUUUUUUUUBUUUUUUUUUBUBUBBUUBUBUUBUUBBUBUBUUBBUUUUUUBUUUUUBUUU
UUBUUUUUBBUUBUBBUUUUBUUUUUBUUUUUBUBUUUBUUUUUBUUUUUUUUUBUUUUUUUBUUUUUUUBUUUBUBUUUUUUBUUBUBBUUBUUUUBBUB
UUBBUUUBUUUUUUUBBUUBUUUUBBUUUUUUUUUUBBUUUUUUUUBUUBUBUUUBBUUUUBBUUUUUUBUUUUUUUBUBUUUUBBBUUUUUUUUUUUUUB
UBBUBBBBUUUUBUBUUBUUUUUUBBBUUBUUUBUUUUUUUBUBBUBUUUUUUUUUBUUUBUUUUUBUUUUBBUUUUUUUBUUUUUUUUBBUBUUUBUBBB
UUUUUUUUBBUUUUBUUBUUUUUUUUUBUBUBUUBBUUBUUUUUUUBBUBUUUUUUUBUBUUUUUBUBUUBUBUUBUUBUUUUBUUUUUUUUUUUBUUUUU
UBUUUUUUBBUUUUUBUBBUBUBBUUUBUUUUUUUUBUUUUUBUUUUUUBUUUBBBUUUBUBUUUUUBBUUUUBBBUUUUUBBUUUBUUBUUBUBUUUBUU
UUUBUUUBUBUUBUUUUBUBUBUUBBBUUUUUUBUUUUBUUBUUUUUUUUBBUUUUUBBUUBBUUBBUUBUUUBUUUUUUUUBBUUBUBUUUUUUBBUUUU
