UBUUUUUUUUBBUUUUBUUUUBUUUBUBBUUUUUUUUUUUBBUUUUBUUUUUBUUUUUBBUUUUUUBUUUBUUUBBUBBUUUUBUUBBUBBBUUUUUUBUU
UUUUUUUUBUBUUBUUUBBUBUUUUBUBBBUUBBUUBUUUUUBBUBUBBBBBUUUUBUBUUUUBUUUUUUUBUBUBUUBBUBUUUBUUUUBUUUUUUBUBB
UUUUUUUBBBBUBUUBUBUUUUBUUUUUBUUUUUUUUUBUBBUUBUBBUUUUBUBBBUBBUUBUBBUUBUUUUUBBUUUBUUUUUUBUUUUBUBUBUUUUU
UUUUUUBBUBUUBUUBBUBUUUUBBUUBUUUBBUBUUUBUUUUBUUUUUUBUUUUUBUBUBBUUBUBUUUBBBBUUBUUUUUUUBUUUUUBUUUBUBUUBB
UUUBUUBBUUUUUBUUUUUBUUUUUUUUUUBUBBBUUUUUUBBUUUBUUUBBUUUBBBUUUUBUUUBBUUUUUUBUUBUUBUBUBUBUUBBUBUUBUUBUU
UUUUBUBUUUUUBBUBUUUBUBBUUUBUUBBBBBUBUUUBBBBUUBUBBBUUUUUUUUUUBBUUUUUUBUBUUBUUBBUBUBUUUUBBUUUBUUUUBUUBU
UUUUUBUUBBUBUUUBUUUUUUUUUUUUUUUUUUUUBUUUUUUUUBUBUBBUUBUUUUUUUBUUUUUBBBUUUBUUUUUBUUUUUUUUUUBBBUUUUUUUB
UUBUUBUBUUUUUUUBUUBUBBUUUUUUUUUUUUBUBUUBUBUBUUUBUUBUBBUUUUBBBUBUUUUUUUUBUBUBUUUBUBUBUUUBUUUUBUUBBBUBU
BUUBUUUBUUUUUBBUBUUUUBUUUUUBUUUBUUUBUUBUBUUBUUUBUUUBUUUBUBUBUBUBUBUBUUBUUBUUBBUBBUUBUUUBBUUUBUUUUBUBU
BUBBBUBUBUBUUUUUBUUUUBBBUUUUBUBBUBUUBUUUUUBUBUUUUUUBUUUBUUBUUUUUUUUBUBBBUUUUBUBUUBUUUUUUUUBBUUUBUUUUU
BBBBBUBUBBUUUUUUBUUUBUUUUUUBUUUBUUBBUUUUUUUBUBBUBUUUUBUUUUBUUBBUUUUUBUBBUUUUUUUUUBUUUUUUUUUUUBUUUUUUB
BUUUUUUUUUUUUUBUUBBUUBBUUUUUUBUUBUBUUBBUBUUUUUBUUUUUBBBBUUUUUBUUBUBUUUUUUBBUUUBUUUUUUBUUUUUBUBBUUBUUU
BUUUUUUBBUUUBBUUUUUUUUBUUUUUUBUBUUUUUUBUUUBUUUBBUUUBUBBUUBUUUUUUUUUBUUBUUUUUBUUUUUBUUUUBUBUUUUBBUBBBU
UUBUUBBBBUUUUBUUUBUUUBUUUUUUBBUUUUBBBBUUBUUUUUUUBUUBBUBUUUUUUBUBUUBBUBUUUUBUUUBBUUUUBBBUUBUUUUBUBUBBU
BUUBUBBUUUUUUUBUUBUBUUUUUBUBUUUUBUBUBUUUUUUBBUBUUBUUUUUUUUUUUUUBBUBUUBUUBUUUUBUUBBUBUUBBBBBBUUBBUUBBU
UUBBUUUUBBBUBUUUBBBUBBUBUUUUBUBBUUUBBUUUBUBBUBUBUBUUUUBBUUUUUUUBBUUBBUUUUBUUUUUUUBUUUUBBUUUBBUBUUUUUB
UBUUUBBUUUUBBUBBUUUUUUBUUUBUUUBUUUUUBUUUBUBBBUBBUUBUUUUUBBUUUUUUUBUBBBUUBUBUBUUUUUUUUUBUUUUUUUUUUUBBB
BBUUBUUUUUUUUUUBBUUBBBBUUUUUBUUUUBUBUUUUUBUUUUUUBUBUUUUBBBUUUUBBBUUUBUUUBUUUUBUUUBUUBBUUUUUBUUBUUUUUU
BUUUBUUUBBBUBBBUUUBUUUBUBBBUUUBUBUUUUBUUUUUUUUUUUBUBBUBBBUUUUBUUUUUUUBUUUUUUUBBUUUUUUUUUUUUUUUBUUUUUU
BUBUBUUBUUUUUUUBUUUUUUUBBUBUUBUUUUBUUUBBBBBUUUUUBBBBUUBUBBUUUBBBUUUUUBUUUUUUUUUUUUUUUUUBUUUUBBUBUUUUU
UUUBBUUBUUUUUUUUUUBUBBUBUBUBUBUUBUUUUUUUBUUUUUUUUUUBUUUUUBUUUUUBUBUUUBBBUBUBUUUUUUUUUUUUUUBBBUUUBUUUU
UUBUBUUUBUUBUBUBUBBUUBUUUBBUUUBUUUUBBUUBUUUBUUBUBBUBUUBUUUUUUUBUUBBBUUUUBUUUUBUBUUUUUBBBBUUUUUBBUUUUU
UUBUBUBUUUBUUUUBUBUUUUUUBUBBUUBUUUUUUUUUUUUBUUUUUBUBUUBUUBUUUUBBUUBUUUUUUBBUUUUUUUBUUUBUBUBBUUUUUUUBU
UUUBUUUBUUUUUBUUUUUUUUBBUUBUUUBUBUUUUBUBBUUUUUUUUBUUBBUUUUUUUBUUBUUUUUUUUBUUUUBUUUUUBUUUUUBUUUUUUUUBB
UBUUUUUBBUBBUUUUUUUUUBUBBUBUUUUUBUUBUUUUUUBBUUUUUUUBBUUUUBUUUUUBUUBUUUBUBUUUUBBBBUBUUUUBUBBUBUUBUUBUB
UBBBUUUUBUBUUUBBUUUUBBUUUUBUUUUUUUBBUUBUUUUBBUBBBUUBUUUBUUUBUBUUUUBUBUBUUUBBUBUUUUUUUBBUUUUUUUUUUUUUU
UUUUUUUUUUUUBBUUUUUUUBBBUBBUBUBBUUUUUBUUUBBUBBUUBBBBBBBUUUUUBUUBUUBBUUUUBUUUUUUUUUUUBUUBUBUUUBUBUBUUU
BUUBUUUUUUUUUUBBUUUUUBUBUUUBUUUUBUUUBBUUUBUBUUBUUUUUUUUUUUBBUBUBBBUUBBUUUBBUBBUBUUBBUUUBUUUUUBUUUUBBB
UBUUUUBUUUUUBUUBUBBUUBUBUUUBUUUUBUUUUUUUBUUUUUUBUUUBUBBUUUUBUUUUUUBBUBUUUUUUUBUUUBUBBBBUBUUUBBUUBUUBU
BUUUUUUUUBUBUBBBUUUUBUUUBUUBUUBUUUBUUBUUBUBUBUUUUUUBBBUUUBUUUUUBUUUBBUUUUUUUUBUUBUBUUBUUUUBBUUUUBBBUB
UUBUUBUUUBUUUUBBUUUUBBUUBUUUUUUBUUBUBBUBUUUUUUBUUBBUBUBBUUUUUUUBUUUUBBUUUBBUUUUUUBUUUUBUBBUUBUUUUUUUU
UUBBUUUUBUUUUUBUUUBBBUUUBBBUBUUUBBBBUUBBUBBBUUUUBBUUUUUUUUUUUUBUUUUBUUUBUUBUUUUUUUBUBUUUBUUUUBUUBBUBB
UBUUUUUBUUUBBUBBUUUBBUUBUUBUUBUUUBUUUBUBBUUUBUBUUUUBUBUUUBUBBUUBUUUUUUUUBUBBBUUUUUUUBBBUBBBUUUUBUUUBU
UBBBUBUBUBUUBUUBUUUUUUUBUUUUUBUUUUUUUUBUUUBUUUUBBUUUUUUBUBUUUUBUUUUBUUUUBUUUUUUBUBUBUUUUUUUBUUUUBUUUU
BBBUUUUUBUUUUUUUBUUBUUBBUBUBBBUUUUBBUUUUUUBUUUUUBUBUUUBUUBUUBUUUBUUUUUBUBUUBUUUBUBUBBBUUBUBUBUBBUUUUU
UUUUUBUUUBUBUUBUBUUBBUUUBUBUUUBBUBUUUBUBBBUBUUUUBBUBUBUUUUUUUUUUUBUUUUUUBUBUUUUUBUBUUUUUUBUUBUBBUBUBU
UUBUBUBUUBBBUUUUUBUUBUUBUUUUUUUBUUUBUUUBBUBBUUUBUUUUUUUUBBUUUUUUUUUUUUUUUUUUUUUUUBUUBUUUBBBBUUUUBUBBB
UUUBUUBUUUUUBUUUBUUUBUUBUBUUUBUUUUBUBUUUUBUBBUUUBBUUBUBBBUUUUUBUUUUUBBUUBUBUBUBUBUBUUBBUUUUUBUUBBBBUU
UUUUUUUUUBBUBUBBUBBUUBUBUUUBUUUBUUUBUUBBUUUBBUUBBUUUUUUUUUUUBBBBBBUBUUUUUBUBBUUUUBUUUUUBUUUUUBUUBUBUB
UBBUBUBUBUUUUUUUUUBBUBBUBBUBBBUBBUUUBUUBBUBUUUBUUUBUUBUBUUUUUUBUUBUUBUBUBUUUUBBUUUBBBUUUUBUUBUUUUBBUU
BUUUUUUUUUBUBBUUBUUBUUBBBUUUBUUUBUUBBUUBUUUUUUUUBUUUBUUUBUUUBUUUUBUUUUUUUUUUBBBUUUUUUUBUUUUBBUUUUBUUB
UUUUBBBUUUUUBUUUUUUUUBUBUBUBBUUUUBUUBUUUBBUBBBUBBUUBUUUUBBUBUBBUUUUUUUBUBUUBUUUUUUUUUBUBUBBBUUBUUUBBU
BUUUUUUUBBUUUUUBUUBUUBUUBUUUBUBUBUUUUUUBBUBBUUBUUUUUBUUUBUBUBUUUBUBUUUBUUUUUUUBUUBBUUUUUBUUBUUUBUUUUB
UUUUBUUBUUBUUUUUBBUBUUUUUUUUUUBUUUBUUUUBUBUBUBUUUUBUUUBBUUUBBUBUUUUUUUBBBBBUUUUBBUUBUBBBUUUUUUUUUBUUU
BBUUUBUUUUUBUBBUUUBUUUUUBBUUBUBBUUBBBUUUUUBUUUUUUUUUUUBUBUUUUBUUUBBUUUUUUBBUUBUBUBUUUBUBUUUUUUUUBBUUU
UBBBUBUUUBUBBUBUBUUUBBBUUUUBUUUBBUBUBUUBUUUBBUUUUUUUUUUUUUUUUUBUBBBUUUUUUBUUUUUUUUBUUUUBUBUUUBBBBUBUU
UUBUUUUUUBUBUUUUUUUUBUUUBUUUUUUUBUBUBUBUUUUUUUBUUUUUUBUUUUUBUUBUUUBBUUUUUUUUUBUUUBBBUUBUUUUUBBUBBBUUU
BBBUBUBBUUUUUUUUBUUUBUBUUUBUBUBUUUUBBUUUBBUUBBUBUUBUUUUUUBBUUBUBUUUBBUUUUBBUUUUUUUUBUUBBBBUUUUBUUBUBB
BBUBUBUUUUUUUUUUBUUUUUBBUUBUBUUBUUBUBUUUUBUUBUBUBUUUUBUUUBUBUUUUBUUUUUUBUUUUUUUUBUUUUBUUBBUUUUUUUUUUU
UBUUUBBUUBUBUUUUUUBUUUUUUUBUBUUUBUBBUBBUUUUUUUUUUUBUUUUBUUBBBUUUBUUUBUUUUUUUBUBBUUUUUUUUBUUUBUBUUUUUU
BUUBUBBBUUUBBUBUUUUUUUUBUUUUUUBUUUBUBBBUBBUUUUBBUUUUUUUUUBUUUBUUUUBUUBUUUUUUBUBBUUUBUUBUBUUBBUUUUUUUU
UUBBUBBUBUUBBUBBBUUUUBUBUUUUUUUUUBBUBUUUBBUBBBUUUUUUBUUBUBUBBUUBBBUUBBUUBUUBUUBUBUBUBUBBUUUUUBUUUUUUB
BUUBUBUBUUUBBUUBUUBUBUBUBBBUUUUBUUUUBUUUUUUUBUUUUUBUUBBBBBBUBBUUUUUUBUUUUUUUUUUUUBBUUUUUUBUUBUUUUBBUU
BUUUBBUBUUUUBBUBUBUUUBBUUUUUUBUUBUBBUBBUUUBUUBUUBBUUUUUBUUBBBUUUBUUUBUUBUUUUBBUBUUUUUUUUUBUBUUUUBBUBB
UBBUBUUUUUBUUUUBUBUBUUUBUUUUBUUUBUUUUUBUBUUUBUUUBUBUBUBBBUBBUBUBUUUUUBUUUBBBUUUBBUBBUUUUBBUBBUUBUUUBU
BUBUBUBUUUUBUBUUUUUUUUUBUUUUUUBUUUUUUUBUUUBUUUUUBBUBUBBUBUUUUBBUUBUUUUUUUUUUUBUUUBUUBUBBUUUUUUUUUUBUB
UUBBBUUUBUUBUUUUBUBUUBBUUBUBUUUUUUUBUUUUUUUBUBBUUUUUBUUUBBUUBUUUBUUUUBBUUBUBUUBUBUBBUBUBUBUUUUUBBUUUU
UBUUUUBUUUUBUUUUUUUUUUBUUUUBUUBUUUBUBUUUUBUUUUUUBUUUUBBBUBUUUUUBUBUUUUUUUBBUUUBUBUUUUUUUUUUBUUUUUUUUU
UBUBUUUUUBUUBUUUUUUBUUUUUUBUUUBUUBBUUBUBUUBUBUBBBBUBBBUUBUUUBBUBUUUUUUUUBUUUUUUUBUBBBBUBBBUUUUUUBUUUB
UUBUUBUUUUUUUUUUUUBBUUBUBUUUUUUUBUUBUUUBBUUBUUUUUUBUUUBUUUBBUUUBBBBUUUBUUBUUBUUUUUUBUUUBUUUUUUBUUUUBU
UUUUUUUUUUBBUUUUUUUUUUUBUBUBUUUUUUUUUUBUUBUUUBUUUUUBUUUUBBUUUBUBUBUUBUUUUUBUUUUUUBUUUUUUUUUUUBUUUBUUU
UUBUBUUUBUUUUUUUUBBUUUUUUUUUUUUUBUBUUUBUUUBBUUBBUUUUUUUBUUBUBUBBBUUUUUUUBUUBUBUUUUUUBUUUBUUUUBUBBUBUU
UUUUBUUBUBUBBUUUUUBBUUUBUUUUUUUUBBUUUUUBUUUUUUBUUUUBUBUUUUUBUUBUUUBUBUUUUUBUBUUUUUUUUBBBUUUBUBUBUBUUB
BUBUBUUUUUUUUUUUUUUUUUUUUUUUBUBUUUBBUBUBBBUUUUUUBBUUUUUUBUUUBUUUUBUUUUBBUUUBBBUUBBBBUUBBUBUUUUBUUUBUU
UBUUUUUBBBUUBUBUBUUUUUUUUUUBBBBUUUUUUUUUBBUUUBUBUUBBBUUBUUUBUUUUUUUUBBUUBBUUBUBUUUUBUBBBUBUBUBUUUUUUB
UUUBUUBUUUUBBUUUBBBBUUBUUUUUBBUUUBUUUUUUUBUUUUUBUUUBUUUUBUUBUUBUUUBUUBUUUUUUBUUUUUUUUUUUUBUUBUBUUBUUB
BUUUUUUUBUUUUUUBUBBUBUBUBUUUUUUUUUUUUUUBBUUUUUUUUUBUUUUUUUUUUUBBUUBBUUUUUUUUUUBUBUBBUUUUBUBBUUUUUUBUU
UUUUBUBUUUBUUUUUUBBBUBUUBUUBBBUUBUBUUUUBUUUBUUUUBBBUBUBUUBBUUUUBUUUUBBBBUBUUUUUUUBUUUUBUBBBUUBUBUBUBU
UUBBUUUUBBUUUUUBBUBUUBUUUUUBBUUUUBUUUBUBUBUUUUUUUUUUBBUUUBBBUUUBUUBUBUUUUUUUUUUUUUUUUUUUBUBBUUBUBUUUB
BBUUBBBBUBBBUUUBUUUUUBUBUBUUBUBUUUUUUUUBBBUUUUBBBUUBBUUUUBUUUBUBUUBBUUUUUUUBUUUUUUUBUBUBUBUUUUBUBUBUB
UBUUUUBUUUUUBUUUUBBUBBUBBUUUBUUUUUUUUBUBUUUUUBBUUUUBUUUUUUBUBUBUUUUBUUUBUUBUUBBUBBUUUBUUUUUBUUUUBUBBU
UUUUBUUBUBBUUUUUUUBUUUUUUUUBUUUUUUBBUUBUUBUUBUUUBUUUUUUUBUUUUBBUUBUUUUUUUUUUBBUUUUUBUUUUUBUUBUBBBUBUB
UUUUUUUUUUUUUUUBBUBUUBUUUUBBUUUUUUUUUUBUUUBUUBBBUBUUUUUBUUUUUUUUUBUUUBUUBUUBUBBBBUBUBUBUUBUUBUUUBUUUU
UBUUUUBUUBUUBBBUUUUUUBUBUUUBUUBBUUBUUUUUBUUBUUBUUUBUBBUUBUUBUUUBUBUUBUBUUUUUUUBBBUUBUUBUBUBUUUBBUUBUU
UUBBUBUBUUUUBBBUUUBBBUBBBBUUUBUUBUBBUUUUUUBBBUUUBUUUUUUUBUUBUBUUUUUBBUUUBUUUUUUBUBUUBUBUBUBUUUUUUUUUU
UBUUUUUUUUUUUBUUBUUUUUUBUUUBUUUUBBUUBUUUUBUUUUUUBUBUBUUUUBUUBUBUUUUBBBUUBUBUBUBUUUUUUUUUBUBUUBBBBUUUU
BUUUUBUBUBBUBUUUUBUUUUUBUBUUUUUBBBUUUUUUUUUBUBUUUUUUUBUUUUBUUUUUUUUBUBUUBUUBUUUUUUUBUUUUUUBUBBUBBBBUB
UUUUBUBBUUUUBBBBUUBUBBBBUUUBUUUBBBBBBUUBUBBUUUUUUUUUUUUUUUUBUBUUBUBUUBUUUUUBUUUBBBUUUBBUBUUBUUUBUBUUU
UUUUUUBBBUBBUUUUUBBUUBUUUUUUUBUUBUUUUUBUUBUUUUUUBUUUBUUUUBBBUBBUUBUUUUUBBUUUBUUUUUUUBBBUUUUUBUUUUUUBB
BBBBUUUBUBUUUUBUBUBUUBUUBUBBUUUUUUUUUUBUUUUUBUUUUUUUBUUUUUUUBUBBUUUBUUBUUBUBUUUUUUUUUBUUBUUUUUBBUUUBU
UUUUUBUBUUUBUUUUUUBUUUUUUBUUUUUUUUBUBUUUUUUUUUUUUBBBUUUUUUUBBBUBUBUUUBBUBUBUUUUUUUUBUUUUUBUUBBUUBUBBB
UUUBUBUUUUUBUBUUUUUUUBBUUUUBUBBUUUUUUUUUBUUBUUUUUBUUUUBUBBUBUUBUUUBUBUUUUUUUUUUBBUBUUUBUBUUUUBUUBUUUB
BUUUUBBBBUUUUUBUUUUBBUBUUUUBUUBBBBUUUUUUBUBUUUUBBUUBUUUBBUBUUBBUUUUBUUBUBUUBUBUBUUUUUUUUUUUBUUUBUUUUB
BBBUBBUUUUUBBUUUBUBBUBUBUBUUUUUBUUUUUUUUUUUUUUBUUUUUBUUUUUBUUUUUUUUUBBUBBUUUBUUUUBUBUUUUUUUUUUBUUUUUU
UBBUUUBBBUBBUUUUUUBUUUUBUUUUUUBBUBUBUUUUUUUUBBUBUBUUBUBUBBBUUUUBUBUBUBUBUUBUBUBBBUBUBUUUBUBUUUUUUUUUU
UUUBUBBUUUUUUUUUUUBUUUBBUBBUUUUUUBUBBUUBBUUUUBBUUBBBUUBUBBBBUUUUBBUUUUUUUUUUBBUBBUUBUUBBUUUUUUUUUUBUU
UUBUUUBBBUUUUBUBBUUUBBUUBUUUUBUUUUUUBBUUUUUUUUBUUUUUUUBUUBBUUBBUBBUUUUBUUUBUBBUBUUUUBUUBUUUUBUUUUUBBU
UUUUUBUUUBBUUBUBBUUBUUUUUBUBUUUUBBUBBBBUBBUUUBUBUBUUUUBUUUBUUUBUBUUUUUUBBBUUUUUUUUBBUBBUBUUUUBUUUUBUB
BUUBUUBUBUBUBUUUUUUUUUUBUUUUUUUBUUUUBUUUUUUUUBUUBBBUBUUUBUBBUUUUUUUUUUUBBUUUBBUBBUUBUBUUUUUUUBUUUBBUU
UUUBUUUUBUUUUUUBBBBUUUUBBUBUUBUUUUUBBUBUUBUBUUUUUUBUBBUBUUUUUBBBUUBUUBUBBUUUBUUUUUBUUUUBUBUBBBBUUUUUU
UUUUUUUUBUBUUBUBBUUUUBUBBUUUBUUBUUUUUBUBUUUUBUUUUUBUUBBBUBUUUBUBUBUUBBUUUBUUBUUBBUUUBUBUBUBUBUUUUBBUU
UUBUBUUBUUUUUUBUBUUUBUBUUUBUBUBBBBUUUUBUUBUUBUUUBUUUUUUUBUBBUUUBUUBUUBBBUUUBUUUUUUUBUUUUUBUUUUUUUBUUU
UUUUUUBUBBBUUBUBBUUUUBUUBBBUBUBUUBUBBUUUUUUUUUUUUBUUUUUUUUUUUUBUUUBUBBBUUUUUUUBUUUBUUBUBUUUBUUUUBBBUU
UUUUUBUUUUUUUUUUUUUBBBBBBBBUUUUUBUUBBUUUUBBUUBUBUUBUUUUUUUUBBBUUBUUUUUUUUUUUUBBUUUUUUUUBBUBUUUUUBUBBB
UUUUBUUUUUUUUUBUBUBUUUUUUUBUUUUUUUBUBUUBUUUUUUUBUUBBUUUUUBUUBUBUUUUUUUUUUBUUUBUUUUUBBUBUBUUBUUUUUBUUB
BUUUBBUBUBUUUUUUUUUUUBBUUBUUUUUUUUBUBUUUUBUBBUUUBUUUUBUUUUUBUUBBUUBBUUUBUBBUBBUUUUUUUBUUBBUUUUUUUUUBU
UBUUUUUUBUUUUUUBUUUUUUUUUUUUUUUUBUBUBUUBUBUUUUBBUBBUUUBBBUBUUUUUBBUUUBUUUBBUUBUUBUBUBUBBUUUBBUUUUUBBU
UUUUBBBBUBBUBUBUUUUBUUUBUUUUBUUUUBUUUUUBUUUUUBUBUUUBUUUUUUBUUBUUUBUUBUBUUBUUUBBBUUBUBUUUUUBUBUUUBUUUU
UUUBUBBUBUUBBUUUUBUUUBUUUBUBBUUUBUUUUBUUUUBUUBBBUBUUUBBUUBUUBUUBUBBUUUUUBUBUUUBBUBBUUBUBBBUUUUUUUUBUB
UUUUBBUBUUUUBUBBUUUUUUUBBUUBBUUUUBUUUUUBUBUUUUUUUUBUUBUBBBUUUUUBUBUUUBUUUBBBBUBBBUBUUUUUUUUBUUUUUUUUU
BBBBUBUUUUBUUUUUBUUUUUBBBBUUUUUUBUBUBUUUUUBUUUBUUUUUUBUUUUUUBBUUUBBUUUUBBUUUUBUUUUUUUUUUBBUUBUBUUUUUU
