UUUUUUBUBUUBUUBUUUBUUUBUUUBUUUUUUUUUUBBBUUUUUUBUBUBBBBUUBUUUUBUBUUUUBBBUUUUUUUUUBUUUUBUBUUUBUUUUUUUUU
BBUUUUUUBBUBUBBUUUBUUUUUBUUBUBUBBBUBBUUUUUUBUUUUBUBUBUUUBUUBUUUUUUUBUBUBUBUUUBBUBUUBUBUUUUUUUUUBUBUUU
UBBUBBUUUBUUUUUUBBBUUBUUUUBUBUUUBUUUBUBUBUBUUBUUUBBBUUUUBBUUUUBBUUUUUUUBUBUUUUUUUUUUUBBBUBUUUUBUUBUUB
BUUBBUUBBUUUUUUUUBUUUBBUUUUBUUUBBBUUBBBUUUBBBBUUBUBUBUUUUBUUUUUUUUUBBUUUUUUBUUUUUBUUUUBBUBUBUUUBUUUBU
UBUUBBUUUUUUUBBBBUBBUBUUBUUUUUUBUBUUBBBBUBUUUUUUUBBBBBBUUUUUUUUUUUUUUBUBBUUUUUUBUBBBBUUBBUUUUBUUUUUUU
BUUUUUBUBUUBUUBBUBUBUUBUUUUUUUUBUBBBUUUUUBUBBUUBUUUUBUUUBUBUUBBUUUUBBUUUUBUUUUBUBBBUBUUBUUUUBUBUBUUUB
BBBBBUUBUBUUUUBUBUUBUUUUBUBUBUUUUUUUUUUUBBBUBUUUUBBUBUUUBUBUBBUUUUUUUUBUUUUUUUUUUBUUUUUUUUUBUBUUUUBBU
UUUUUBUUBUUUUUUUUUBBUUUUBUBUUUUUUBUUUUBUUBUUUBUUBBUUUUBBUUBUUBUUUBUUUUBUBUBUBUUBUUUBUUBUBUUBUBUUUBBUU
BUBUUUUUUBBUBUBBUUBBUUUBUUUUUUUBUUBBUUUBUUBUUUUUBBBBUUUUUBUUUUUUUUUUUUUUBUUUUBBUUUBUBUUUBUUBUBUUUUBUB
UUBUUBUUUUBBUUUUUBBUBUUUUBBBBUUBBUBUBBUBUUUBBUUUUUUBBUUUUBUUBBBBUBUUUUUUUBUUUUUBUUUUUUBUUUBUUUBUUBBBU
UUBUUBUUBUUUUUUUUUUUBUUUUUUUBUBBBBUUBUUUUUUUUUUBUUBUUUBUUUUBUUBUBBUUBBUUUBUUUBUUUBUBUUUBUBBUUBUBBUUBB
UUBBBBBUBUBUUUUUUUUUUUUBUUBUUBBUUUBUUUUUUBUUUBUUUUUBUUUBUBBUUBUBUUBUUUBUUUUUUUUBUUUBUBUBUBUBUBUBBBUUU
UBUBUBUUUBUUUBUBUBUUUUUUBUUUUBUUUBUUUUUBBBUUUUUBUUUUBUUBUBUBUUUUBUBUUUUUUBUUUBUUUUUUUUBUUUUUUBUBUUUUU
UUUUBUBUUBBUUBBUUBUBUBBUUBUUUUUUUUUBBUUUBBUUUBBUUBBUUUUBUUUBUUUUUUUBUBUBUBUBUUUUBUBBBUUUBUUBUUUBUUUBB
UUBUUBUUBUUBBUUBBBUUUUUUBBUBBBBUUBUUBUUUUUUBUUUBBUBUUUUUUUUUBBUUUBUUUUUUUBUUUUUBUUBUUUUUUBBUBBBUBUBBB
UBUUUBBBUBUBUUUUUBUUBBUBUUUBBUUUUUUUUBBUBBUBUUBUUUUUUUUUBBUUUUUUUBUUUUUBUUUUBUUUBUUUUBUBUBUBUUUUUUUBB
UUBUUBUUUUUBUBBBUBBUUUUUUUUUUUUUUBBUUUUBUUUUUBUUBUUUUUUUUBUUUUUUUUUUBBUUBUBBUBBBBBBUBUUBUUUUBUUUUUUUU
UBUBUBUBUUBUUUBUUUUUBBUBBUBUBUUBBUUBBBUUUUUBUBUBBUBUUUUUUUBBBBBUBUUUBUUUUUBUUBUUUBUUBUBUUBUUBBBUUBUBU
BBUBUUUUBUUUBBBUUBBBUBBUUUUUUUUBUUUUUUUUBBUBUUUBBUUUUUUBBUBBBBUUBUUBBUUBUUUBUBUUUBUBUUUUBUUUUUUUUBUBB
UUUUBUUUUUUUBUUBBUUBBUBUUUUUBUUBBUUUUBBUUUBUUUUUUUUUBBBUBUUUUUUBBUBBUUUBUUUUUUUUUUUUBUUBBUBUBBUUUUUBU
UUUBUUUUUUUUUBUUUBUUUUBUBUUUBBUUUUUBUUBBUBUBUUUBBUUUUUBUUBUUUUUUBBUUBBUBUBBUUBUUBUBUUBBUUBUUBUUUUUUBU
UBUBBUUUUUBUUUUUUUBBBBBBUUBUBUUBUUUUUUUUBUUUBUBBUUUUUUUUUUUBBUBBUUUUUBBUUUUUBUBUBBUUUUUUUUUBUBBBBUUUB
UBUBUUUUUUUUBUUUUUUUBUUUUUUBUUBBUUUBUUUUUUUUUUUBUBBUUUBUUUUBUBBBUBUUUUUUBUUUUUUUUUUUUUUUUBUUUUUUUUUUU
UUUUBUUBBUUUBUUUUUUBBUBUUUBBUUUUUUUUBBBUUUUUUBBUBUBUUBUUBBUUUUBUUBUBUUUUUUUUBBBUUUUUBBUUUUUUBUBUBUUUU
UUUBUUUUBUBUBBUUBUBUUBBUUUBUUUUUUUUUUUBUBUUUBUUUUUUBUBUBUUUUUUBUUUUUUUUUUBUUUUBUUUUUUUBUUUBUUUUUUUBUU
UUUUUUBUUBBUUUUBUUUUBBUUBBUBUBUUUUUBUUBBUBUBBUBUBBUBUBBUBUBUUBUBUUUUBBUBUUUUUBBUBBBBUUUUBUUUUUBUUUUUB
BUBBUUUBBUUUBUBUUUUBBBBBUBBBBUBUBUUUUBUUBUBUBUBUUBUBUBUUUUUBUUBUUUUUUBUUUUUUUBUUUUUUUUUBBBBUUUUUUUBUU
UBUUUUUBUUUUBUUUUBBUBUUUUUUUBBUUUUUUBUUBUBUUBUUUUBBUUUBBBUUBBUBBUUBBBUBBUBUUBBBBBBBBBUUBBBBBBUUBUBUUU
UBUUUUUUBBBUBUUUUUBUUUUUUUUBUUUBUUUBUUUUUUBBUBUBBUUUUUUUUBUUUUUBUBUUBUUUBUUBUUUBBBUBUUUUBUUBUBBUUUUBU
UUUUUUUUBUUUUBUUBBUUUUUUBBUUUUUUUUUUUBUUUUUUUUBUBBBUBUBUBUUUBUBBUBBUUUUBUUUBBUUUUBUUBUUUBUBUUUUBUBUUB
BUUBUUBUBBBBBUBUBUUBUUUBUUUBUUUUUUBBBUUUUUUUBUUBUUBUUUUBUUUUUUUBBBBUBBBBUBUUUUBUUUUUUUBUUUBUUUUBUBUUU
BUBUBUUUUBUBBUBUUBBUBUBUBBBUUBBUUUBUUBUUUUUBUUBUUBUUUUUBUUUUUUBUUUBBUBBBBBUUUUUBBUUUBBUUUBUUUUUBBUUUU
UBUUUBUUUBUUBUUUUBUUUUUUUBUUUUBUUUBUUBUBBUUBUUBUBUBUUUUUUUUUUUUBUUUBBUBBBUBUUUBUUUUUBBUUUBUBUUBUUUBBB
UUBUUUBBUUUUBUUBUUUUBBUBBUUBUBUUUUUUBUBUUUUUUUUBUBUUBUUBUUUUUUUUUUUUUUBBUBUBBUUUBUUUUUBUBBBUUBUUUBUBU
UBUBBBBUUUBUBUUUBUBUUBBUBUUUBUUUUUUUUUBUBUUUUBUUBUUBBUUBUUUUUUUBUUUUBUUUUBUBUUBUUBUBUUUUUUUUBUBUBUUBU
BBBBUUUUUUUBBUUUBUUUBBUUUUBBUBUUUBUBBUBUBUBBBUBUBBUBBUUUUBUUUUUUUUUUUUUUBUUUBUUUUUUUBUBUUUBUUUBUUUBBU
UUUUUUUUUUUUBBUUUBUUUUUUBBUUBUUUUUUUUBUUUUBUUUBUUUUBUBBUUUUUUUUUUBUBUUBUBUUBUUBBUBUUBUUBUUBUUUBBBUUUB
UBBUBUUUBBUBUBBBUUUUUUUUUUUUUBUUUUBUUBUUBBBBBUUUUBBBUUUUUUUUUUUUUUBBUUUUUUBUUBBUBBUBUUUUUUUUUBUUBUUUU
UUBUUBBBUUUUUUBBBUUUUUBUUUUUUUBUUBBUUUUUBUBBUUUBUBBBUUBBUBUBBBUBUUBUBUBUBBBUUUUUUUUUUBBUUBUUUUBUUUUUU
UUBBUUBUUUUBUUUUBBBBBUBUUBBUUUUUUUBBUUUBUBUBUBUUUUUUUBBUBBUUUUUUBBBUUBUUUUBUBBUUUUBBUUUUBBUUUUUUUUUBU
UBUUBBUUBBBUUUUBBBUUUUUUUUUUUUUUUUUUUUUBBUUUBBUBUUBUBUUUUBBUUUBUUBUUBUBUUUBUBUUBUUBBUBUBUUBUUUUBUUBUU
BUUBBUBUBUUBUUBUUBUUBUUBUUBUUUUUUUUUBUUUUUBUUUBUBUUBUUBUUUUBUBUBBUUUUUBUUUUUUUUUUUBUBUUBUUUUBBUUUBUBU
UBUUUUUUUBUBUUUUUUBBUUUBBUUBUUUUUUBUUUBUUUBUBUUUUBBBUBUUUBBBUUBUUBUUUUUUUUBUUUBUUBUUBUBUUBUUUBUUUUUUU
UUUUBUUUBBBBUBUUUBBBUUBBBUUUUUBBUUUUUBBBUUUUUBUUUBBUBBUUBUUBBBBUBUBUUUUUUBUUUUBUUUBUUUBUBUBUBUUUUUUUB
BUUUUUUBBUUUUBUUUUUUBBUBUBUBUUBBUUUBUUBUUUUUUBUUUUUBUUUUUUUUUUUUBUUBUUUUBUUUUUBUBUUBUUBUUBUBUUUUUUUBU
UBUUUUUUUUUBUUUUUBBUBUUUUBBUBUUBUUBUUBUUUUUUBUUBUUUUUUUUBUUUUUUUUUUUUBUUBBUUUUUBUUUUBUUBUBUBUUUBBUUUU
BBBUBBUUBUBUUUUUUUUUBUBBBUUUUUBUUBUUUBBBUBBUUUUBUUUBBBUBBUUUUUUBBUUUBUBBUBUUUBBUUUUBUUUUBBBUUUUUUUUUU
UBUUUUUUUUUUBBUUUUUUUBBUUUUUBUBBUUUUBUUUBBUBUUUBUBUUBUUUBUUUBBUBUUBBUBUUUUUUUUUUUBUUBBBBUUUUBUUUBUUUU
UUBUUUUBUUBUBBUUBUUUUUUUUBUUUUUBUUUUUBUUUUUBUUUUBBUUUUUUUUBUUBUUBBBUUUUUBUUUBUUUUBUUBUUUUUBBUUUUBBUBU
UUUBBUUUUBBUUUBBBBUBBUUBBUUUBUUUBUUUBUUUBUUUUBUBUUUUBUUBBBBBUUUBUUUBBUUBUUUUUUUUUUBUBBBUUBUUBBUUBUBUB
UUBUUUBBUUUBUUUBBBBUUUBUUUBUUUUUUUUBUBBUUUBUBUBBUBBBUBUUBBUUUUUUUUUUUBBUUUUUUBUUBUBUBBUUUBUUUUBUUBUUU
BUUBUUUUBBUUUUUBBUUUUUBUUUUUUBBUUUUBBUUUUUUUUUUUUBUBBUUUUUUUUBBUUUBUUUUUUUBBBBBBUUBUUBBBUUUUUUUUUBUUB
UUBBUUUUBBUUUUUUUUUBUUUUUUUUBBUUUUUBBUBBUUBBUBBUBBBUUUUBUUBBBUBUUBUUUBBBUBBUUBBUUBUUUUUUUUBBBUUUBUUBU
UUUUBUBBUUUBBUUUUUBBBUBBUUUBUUUUBUUBBUUUUUBUBUUBUUBBUUUUUBUUUBBUBUUBBUBBBBUUUBUUUBUBUUUUUUUUUBUUBUUUU
BUUBBUBBUUBUUUBUUUBBUUUBBBUUBUUUBBUUUUBUBUUUUUUBUUUBUUUUUUUUBUUUBUUBUUUUUUUUUUUUUUUBUBUUUUUUUUUBBBUUU
UUUBBUUUBUUBBBUUUBUUUBBUUUUUUUUUBUUBUBUBBUBUUUUUUUUUUBUUUUUUUBUBBUBUBBUUUUUUUUUBUUUUUUBUUUUUUUUUUBUBU
BUUBUBUUUUBUUUUBUBUBUBUUUUUBUUUUBUUUBUUUBUUUBBUUBUUUUBUUUUUBUBBUUUBUBUUUBUUUUUUBBBBUUUUBUBBBUUUUBUBUU
UBBUUUUUBUBBUBUUBBBUBUBBBUBBBBBUUUBUUUUBUUUBUUBUBUUUUBBUUBBBUUUBUUUBUUUUUUUUUBBUUBUUUUUUUUUBBUUUUUBUU
UBBUUUUBUUUUUUUBUUUUUUUBUUUBUBUBUUBBUUUBBBUUUBBUBUUUBUUUBBUUBUUUUUUUBBBUBBBUUUUBBUBUUBUUUBBUUBUBUBBUB
BUUBUUBUUUBBBBUBBUUUBUBUBUUBBUUBUUBBUUUUUUBUBUUBUUBBBUUUUUUBBUUUUBUUUUUBUBUBUUUUBUUUBUUUUUBUUUBUUUBBU
BUUBUUUUUUUBUUUUUBBBBUUUUUUUUBUUUUUUBBUUUUBBUUBBUUUBUUUUBUUBUBUBUUBBBBBUUBUUUUUUBUUBUUBUBUBUUUUUUUUBU
UUUUUBBUUUBUUUUBUUUUBUUBUUBUUBUUUUUBUUUUUUBUUUBUUUBUUUUBBBUUUUBUUBUBUUUUUUUBBUUUUUBUUUBUUUBUBUUUUUUUU
UUUBUBBUUUBUUUBBUBUBUUBUBBUBUUUUUBBBUUBBBUUUUUUUUUUUBBUUBBUUUUBBUBUUUUUBUUBUUUUBBUUUUUBUBUUBUUBBBUUBU
UBUUBUBBUUUUUUUUBBUUBBUUUBBBBUUBUBUUBUUBUUUUBBBUUUUUBBUBBUUBBBUUBUUUUUBBBBUUUUUUUUUUUUUUUUBBBUUUUUBBU
UUUUBBUUUUUUUBUUUUUUUUUUBBBBUUUUBUBUUUUUUUUUBBUUBUUBBUUUUUUUUUBBBUBUUUUUUUUBUUUUUUBBUUBUBUUBBUUUBBUUU
UUUUUUUUUBUUBUUUBUUUUUBBUUBUUUUUUBBBBUBUBBUBBBUUBUUUUUUBUUUUUBUUBUUUUUUUUUUBUUUUUBBUBUUBUBUUUBBUUUBBB
BBUBBUUUBUUUBBUBUUBBUUUUUUBBBUUUUUUBBUUUUBBUUUUUUUUUBBBUUUBUUBBBUUBUUUUBUUUUUUUUBUBUBUBUUUUUUUUUUUUUU
UUBUUUUUBUUBUBUUUUUUUUBUBBBUUUBBUUBUBUUUUBUUUBBUUUUBUBUUUUUBUUUBUUUUUBUUUUUUBUUBBBBUUBUBUUUUUUUBBUUBB
BUUUUBBBUBUUUUBBBUUUUUUUBBBUBBUUBUUUUBBUUBUUUUUUUUBUBBUBUUBUBUUUBUUUBUUUUUUBUUUUBUUUUUUUUUBUBUUUBBBUU
UBUUBUUBUBBBBUBUUUBUUBBUUUUUBBUUUUUUUBUUBBBUUUUUUUUUUUUUUUBUUUUBUUUBUUBBUBUBUUBUUBUBBBBUBBUUUUUUUBUBB
BUBBUUUUUBUBUBUUBUUUBUBBUUUBUUUBBBBUUUBUBUBUUBUUBUBUUBUUBUUBUUUUUBUBUUUUBUUBUUUUUUUBBUBUUUUUUUBUBUUBB
UUUUUUUUBUBUBBBBUBUUUBUBUUBBUBUUUBUUUUUBUUBUUUBUUUUUUUUUUUUUBUUBUUUUUUBBBUBUUBUUUUUUUUUUUBUBUUUUUUUUB
BBUUBUUBBUUUBBUBBUUUBBUUBBUUUBBUBBUUUUUUUUUUBUUBUUUUBUUUBUBUBUUUUUUUUUUUBUUUBUUBUUUBUUBBBUUUUUBUBUUUU
BUBUUUUUUBBUUUUUBUUUBBUUBBUBUUUUUUUBUUBBBUUBUUUBBUUUUUBUUUBBUUUUBUUUUUUBBUUUBUUUUBUUUUUUUUBBUUUUUUBBU
UBUUUUUUUBBBBBUUUBUBUUUUUBUBUUUUUUBUBUUUUBUBBBUUUBUUBBUUUBBUBBBUUUUBUUUUBBUUUUBUBUBUUBUBUUUUUUUBUBUBU
UUUUUUUUUUUUBBUUUUUBUBUBUBUUBUUUBUUBUUUUUUUBBUBBUUUBBUUUBBUBBBBBUUUUUUBBUUUBUBUUBUUBBUUUUUUUUUBUBUBUU
UUUUUUUBBBUUBBUUUUUUUUUBUUBUBBUUUUBUUUUUUUUBUBUUUUUUUUBBUBUUBBUUUUBBUBBUUBUUUBUUUBUBUBBUUUUBUUBBUBUUU
BBUUUUBUUUBUUUBBUUBBBUUBUUUBUUUBUBUUUBUUBUUUBUBBUUUBBBUUBUUBBBUUBBBUBUUBBUUUUUUUBBBUUBBUUUUUUUUUBUBBU
UBUUBBUUUBUUBUUBUUUBUUUUBUUUUBUBUUUUUBUUUBUUUBUBUUBBBBBBBBUUUUUUBUUBBBUBUUUUBBUUUUUBUUUBUUUUBBBUUBBUB
UBUUBUBUUBUBUUUBUBUBBUBUUUUUBUUUUBUUBUBBUUBBUUUBBBUUUBUBUUUUUBUBUBBUBUBUBBUBBUUBBUBUUUBBUBUUUUUUUBBUU
BUUUUUUUUUBUUBUUBUBUUUUBUUUUUUUUUBUUBUBBUBUUUBUUUUUUUBBBUUUBUBUUUUBUBUUBUUBUUBUUBUBUBUBUUUBUUUUUUUUBU
UBUUBUUUUUUUUUBBUBBUUBUUUUUBUBUUBUUUUUBUBUUUUUBUBBBUUUBUUUUBUUBBBUUUUUUBBBUUUUUUUBUBUBUUUBUUBBUUBUBUB
BBUBUBBUUUUUUUUUUUBUUBBBUUUUUUUUBUBBUUUBUUBBUUUUUUBBUUUBBBBUBUUUUUUUUUUUUUUBUUUUUUUUUUUUBUBUBUUUUUUUU
UUBBUUUUUUUUUUBBUUUBUUBBBUUBUUUUUUBBBUUBUBBUUBBBUBUBBUUUUBUUUUBUBUBUBBUUUUBBUUUUBUUBUUUBUUUUUUUUUBUUU
BBUUBBUUBUUBUUUUUBUUUUUUUBBUBUBUBUUBBUUUUUBUUUBUUUUBBUBUUUUBUBBBUBUUUUUUUBBUUUUUUUBUUUBBBBUUUBBUUBUUU
BBUUUUUUBUUBUUUUUUUUUBUUUBUBBUUUUUUUUUUUUUUBUUUBUUBBUUUUUUUUUUBUUBUUUBBUBUUUUUBUUUUBBUUUUBUUBUUBUBUUU
BUUUUUUUUBBUUUUUUBUUBUBUUUUUUBUUBUUUBBUBBUBUUUBBUUUBUUBUBBUUUUUUUUUBUUUUUBUUBUUUUUBUUUBUUUBBBUBUBBUUU
UUUUUUUUUUUBUBUUUUBBUBUUUUUUUUUUBUUUUBUUUUUBUUUUUBBUUUBUUUUUUBUBBBBUUUBUUUUUUUUBBUBBUUUUUUUUBBUBUUBUU
UUBUUBBUBUBUUUUBUUUUUUUBUUUUUUUBUUBUUUUUBBUBBBUBUUUBBUUUUUUUUUUBUUUUUUUBUBUBUUUUBUUUUUUUUUUUUBUUUUUBU
UUUUBUBUBUBBUBBUUUBUUUUUBBUUBUUUUUBUUUBUUBUUUUUUUUBUUBBUUUUUUUBUUUUUBBBUBUUUUUUUUUUBUBUUUBUUUBUBUUUBU
UUBUUUBUUBUBUUUBUUUBUBUUUUUUBUUUUBUBBUUUUUUUBBUBUBUBUUUUUUUBUBUUUUUUBUUUUUUUUBBBUUUBUUUUBBBBUBBUUUUUU
BUUUBUUUUUUUUBUUBUUUUUUBUUBUUUUBUBUUUUUUBUUUUUUUUUUUUBUBBBUUBBUUUBUUUUUUUUUUUBBUUUUUUUUBUBUUBUBUBBUBB
UUBUBUUBUUUBUBBUUUUUBUUUUUUBUUUUUUUUBUBBUUUUBUUUUBUBBUBUBUUUUUBUUUUBBBBUUUBUUUBUUUBUUBUBUUUBBUUUUUUUU
BUUUUUUUUUBUBUBUBUUBUBUBUUUBUBUBUBUUUUUBUBBUUUUUBBUUUUUBUUUUUBUUBUUBUUUUUUUUUUUUUUBBBUUUUBBUUBUUBBUUB
UUUUUUUUUUUUBUUUUUBUUUUUUUUUUUUBUBUUUBUUUUUUUUBUUUBUUBUBUUUUUUUUUBUBBBBBBUUUUUBUUUUBUUUBUBUBBBBUBUBUU
UUUUUBUUUUUBUUUUUUBUUUBUUUBUUBUUBUUUUBUBUUUUUUUUUUBUUBUUUUBBBBUUBUUUUUUUBBUUBUBBUUUUUBBBUBBUBUUUUUUUB
UBUUBUUUBUUBUUUBUUBUBUUUBUBBUBUUBUUUUBUUUBBUUUUUBUUUUUUBUBUUUBUUUBUUBBUBBBUUUUUUBUUUBUUUUBBUUBUUUBUUU
UUUBBUBUUBUUUBUBUBUUBUBBUUUUBUBBUUBUUBUBBBUUUUUUUUUUUBBUBBUUUBBUUUUBUUUUBBBBBBUUUUUUUUBBUBBUBBUUUUBUB
UUUUBUBUBUUUBUBUUUBUUUBUUUUUBUUUUBBBUBUBUUBUUUUUUBUBUUBUUUBBUBBUBUUBBUBUUBUBUUUBUUBUBBUUUUUUBBUUUUUUU
UUBUUUUUUUBBBUUUUUUUUUBUUUUUBBBUUBBUUUUUUUUUUBBBBUUUUUBBBBUUUUUBBUUUUUBUUBUUBUUBUBBUBBUUBUBUUBBUBUBBU
UBUUUUUUBBUBBUUUUUUUUBUUUBUUUUUUUUBUBUUUBUUUUUBUUUUUUUUUUUBUUUBUBUUUUBBUUUUUUUUUUUBUBUUBUUUBUUUUUUUBU
