UBUUUUUBUUUUUUUUBUUUUUBUUUUUUBUUUUUBUUBUBUUUUUUUUUUBUUUUUUUBUBUUBUBUUUUUUUBUUUUUUUBUUUUBBBUUBUUUUBUUU
UUUBBBBUUBUBUUBUBBUUUUBBUUBUUBUBBUUBBUBUUBUUBUBUUBBUUBUBUUBUUUBUUBUUUUUUUUUUUUUBUUUBUBBUUUUBUUBUUUBUU
BBUBUUUUUBUUUUUUUUBUUUUBUBUBUUBBBBBBUUUBUBUUUUUBBUUBUUBUUUUUUBUBUUBUBUUBBUBUBUUUBUUUUUUUBUUUBBUUUBUUU
BUUBUUBUUUUUUBUUBBBUUUUBBUBUUBBUUUUBUUUUUUUUUBBUUUUUUUUUUBUUUBBBBUUUUBUUUBUBUUUBUUUUBBUUUBUBUBUBBUBBB
BUUUUUUUBBUUUUUUUBBUUBUBBUUUUUBBBUUUBBUUBUUUBUUUBUUBUUBUUUUBBBUUUUBUUBUUBBBUUUBUUUUUUUUUUUUUBBUBUUBUU
BBUUUUBBBUUBUUUBUUUBBUBUUUUBBUUUUUUUUBUUUUUBBUBUUBUBUUUBUUBBUUUBUUBUUUUUUUUUUBUBUBBUUUUUUUBUUUUUBUUUU
UUUUUBBUUUBUUUBBUUUBBBBBUUUBUBBUBUUBBUUBUUBUUBUUUUUUUUUBBBUBUUBBBBBUUUUUUBUBUUUUUBUUUUUBUUBBUUBUUBUUU
UUUBUUUUUUBUBBUUUUUUBUUUUUUUBUUUBUUUUUBUUUUUBUUUUUBUUUUBBBUUUUUUUUBBUUUBBBUBUBBUUBUUUUUUUUBUBUBUBBBUU
UUUUUUBBUUBBBUUUUUBUUUUBUUBBUUUBUBUBUUUUUUBUUUUUUBBUUUUUBUBUBUUBUBBBBUUUUUUBUUUUBBUBUBUUUUBBUBUUBUUBU
UUBUUUBUUBUUUUUBUUUUBUUUBBUUBUUBUUUUBBUUUUUUUUBUBBBUUUUUUUBUUUBUUUUBBUUUBUUBUUUBUBUUUUUBUUUUUUUBUUBBU
UBUUUUUUUBUUUUUUUBUUBUUUBUBUBUUUBUBBUBUUUBUBUUUUUUBUUUUUBBUBUBBUUUUUUUUUBUUUUBUUUBUUUUUBUUUBBBUUUUUBU
UUBUUUUUBBUBBUUBUUUUUBUUBBUUBBUUUUBUBUBUUUUUUUUBBUBUBUUBUUBUBUUUBUBUUUUUUUUUBBUUUBUUBBUUUUUBUBUUUUUUB
UBUBUBUBBUUUBBUUUUUUUUBBBUUUUUBUBUUBUUUBUBUUUUUUUUUUUUUUUUUUUUBUBBUBUUBUUBBUUUBUBUUUUUUUUBUUUBUUUUUUU
UUUUBBUBUBUUBUUUBUBUUUBUUUUUUUUBUUUBUUUUUBBUUUUUUUUBUBUUBBUUUUUBUUUBUUBBUBUUUUUUUUBUUBBBUUUBUUBUUUUUB
UUUUUUUBUBUUBUUBUUUUUUUUUBBUUUUUUBUBBUUUBUUUUBUBUUBBBUUUBUUUUUUUUUUUUUUUBUUUBBUUUBBUUUBUUUUUBBUUBUUUU
UBBUUUBUUUBUUUUUUUBUUBUUBBUUUBUUBUBUUBUBUUBUUUBBUUBBUUUUBUBUBUBUUUUUUUUUUUUBUUUUUUUUUUBUUBUUUUUUUUUBB
UUBUUUUUUBBUUUUUBBUUUBUUUUUUUUUUBUUUUBUBBUUUUUUUUUBUBBBBUUUUUBUBUUUBUUUBUUUUBUBUUBUUUUBUBUUUUUUBBUBUB
UBUBUUUUUUBUUUUBBUBBBUUBUUUUUBUBUBUUBBUBUBBUBUBBUUBUUBUBUUUBBUUBUUUUUUUBUUUBBBUBBUUUUUUUUBUUUUBUBUUBU
UUUUUUUUUUUUUUUUUUUUBUUUUUUBUBUUBUBUUUUUUUBBUBUUUUUBUUBUBBUUUBBUUUBUUUUUUBBUUBUBBUUBUUUUBBBUBUUBUBBUU
UUUUBBUUBUUUUUBUUUUUBBBUBUUBUUUBUUUUUUUUUBBUUBUUUUUUUBBBBUUUUUBUUUUUUBUBUUBUBUBUUUUBUUUUUUUUUUBUBUUUU
UUUBBUUUUUUUBBUUUUUBUUBBUUUUBUUUUBUUUBUUUBUUUUUUUBUUBUBUBUUUUUUUUBUUUUUBUUUBBUUUUUUBUBUBUUUUUBUUUUBBB
UUUUUUUBUUUUUUUBUBUUBUBUBUUBUUBUUUUBUUUUUUUBUUUUBBUBUUUUBUBUUBUUBUBBUUBUUBBUUUUUUUBUUUBUUBBUUUBBUBBUU
UBUUUUBUUUBUBBBUUUBUUUUUBUUUUBBUBUUBUUUUUUBUUUBBUUBUUUUUBUUUUUUUUBUBUUUUBUUUBUUUBUUBUBBUUUUUUBBUUUBUU
UUUUUUUBUUBUUUBUUUUUUUUUBUUBBUUBUUUBUUUUUBBBBUUUUUUUBUBBBUBUBUBUUUUUUUUBUBBUBUUUUUUUBUUUUUUUUUUUUUBBB
UBBBUUUBUBUBUUUUUUBBUUUBUBBUUUBUUUBUBBUBBUUUUBUBUBBUUUUUUBUUUUUUBBUBBUUUUUBUBUUUBUUUUUUUBUUBUUBBUUUUU
UUBUUUBUUUUBUUBUBUBBUUBUUBBUBUBUUUBUUUUBUUUUBUUUUBBUUUBUUUUUUBUUBBUBUBBUUUBBBBUUUBBUUBBUUUBUBBBUUUUBB
BBUUUUUUBUUUUUBBUUUUUUUUBUBUUUUUUBUUUUUUUUUBUUUBUUUUBUUUUBUUUBUBBUBUUUUUBUUBUUUUUUBUBBBUUBBUBUUUUBBUU
UUBUBUUUUBUUUUUBUUUUBUUUUUUBBUBUBUBUUBUBUUUUUUUBUBUUBBBBUUUBBUUUUUBUUUUBUBBBBUUUUUBBBBBBUBUBBBBUUUUUU
UUUUUUUUUUUUUUUUUUUUUUBUBBUUUUUUBUBUUUUBUBBUUBUUUUBUUUUUUUUUUUUUUUBUUUUBUBBUBUUUBUUUBUUUBBUUBUUBBUUUU
UUUUUBUUUUBBUUUUUUUBBUUBBUUUBUBUBBUBBUUBUBBUUUBUBUBUUBBBUUBUUBUUBUBUUUUUUUBUUUUUBUUUUUUBUBUUUBBUUUUUU
UUBUUUUUUBBBUUUUBUUUBUBUBBBUUBUUBUBUUUUBUUUBBUBUUBUUUUBUUBUUUBBUUUUUUUBBUBUBBBUUUUUUUUUUUBUUUUUBUUBUB
UBBBUUUUBUUUBUBUUUUUBUUUBBBUBUBUUUUUBUBUUUBBUBUBUUUUBUBBUBBUBBBUUBBUUUUUBUBBBBBBUUUUUBUBUUUUUUUBUUBUU
BUBUBUBUUUBUUUUBUBUBUUUUUBUUUUUBBUUUUBUBUUUUUUUUUUUUUBUBUUUUBUUBBUUUBUUUBUUUUUUUUBUBUUUBUBUBUUUBUUUUU
UBBUUUUUBBUBBUUUBUBUUUUUUUBUUUUUUUUUUUUBBUUBUUUBUUUBUUUUUUUUBBUBUUBUBUUUUBUBUUBBUUUUUUUBBUUBUBBBUBUUB
UBUUBUUUUBUBBUUUBUUUUBBUUUUUUUUBUBUUUUUBUBUBUUUUUBUBUUUUUBUUUUBBBUBUBUBUUUBUUUUBUUUBBBBUBUBUUUBUUUUUB
UBBUUUUUUUUUUBUBBBUBUUUBUBUUUUBUUUUUUUUUUUUBBUUUUUBBUBUBUBUBBUUBUBUBBBBUUBUBUUUBUUBUUUUBUUBBUUUUUUBUU
UUUBUUUBUUBUBUUBUBUUUUUUUBUUUUUUUUUUUUBUUUUBUBBBBUUUBUBUUUBUUBUBUUBUUUUBUUUBUBUUUBUBBBUUBBUUUBUBUBBUB
UUUBUUUUUUUUBUUBBUUUUBBBUUUUUUUUBUUUUUUBUBUBBUUBUBBUUUUUBUUUUUUUUBUBUUUBBUUUBBUUBBBUUBUUUUBBUBBUBBBUU
BBBBUUBUUUUBUBBBUBUBUBUUUBBUUBUUUUUUBUBUUBUUBBUUUBUBUUUUUUBUBUBUUUUUUUUBBUBUUBBUBUBUUUBBUBUBUUUBUBUUB
UBBUUUBUUBUBUBUUUUUUBUUBBUUBBUUUUUUUUBUUUUUUBUBUUUBBBBUUUUUUUBUBUUUUUUBBUBUUBUUUUBUUBUUBBUUUUUUUUUBBB
UBUUUUUUUUBBUUBUBUUBUUBUUUUUUUBUUUUUUUUBUBUBUUUUUBBBBUBBUUUBUBUUBUUBBUBUBUUUUBUUBUUBUBUUUUUUUUUUUUBUU
UUUUBUUUUUUUUUUBUBBBBUUUUUBUUUBUBUBUUBUUUUBUUBUBUUBBUUUUUUUUUBBBBUUUBUUUBUUUBUUUUUBUBUUUUUUUUUBUUUUBU
UBBUUUUBUUUUBUUUUBUBUUUUBBUUUUUUBBUUUUBUUUBUBUBUBBUBBUBUUBBUBUUUUUUUUBBUBUUBUUUUUUUUUUBBUUUBUBUUUUBUB
BUUBUUBUUUUBUUBBBUUBBUUBUUBBUUUUUUUUBUBUBBUUBBUUUBBUUUUUBUUUUBUUUUUUUBUBUUUUUBUBUBUUBUUBBUUUBUBUUUUBU
BUUBBUUUBUUUUUBBUBUUUUBBUUUUUUUUUUBBUUBUBBBUUUBBUBUUBUBUUUUUUUUUUUUBBBUUBUUUBUUUUBUUUUUUUUUUBBUBUUUBU
UUUBBUBUBBUUUUBUUUBUUUUUUUUUBUBUUUBBBBUUBUUUBUUUBUBUUUUUUUUBUBUUUUUUUBUUUUUBUUUUUUUBUUBUUUBBBBUBBUBUU
UUUBBUBUBUUBUUUUBUBBUUBUUUUUUUUUUBUUUBUUUBUBBUUUUUBBUBUUUUUUBUUUUUUUUUUUUUBUUUBUUUUUBUUBUUBUUUBUBUUUU
UUBBUBUBUUUBUUUUUUUBUUUUBUBUBUUUUBUUBUUBUUUUUUUUUBBBUBUUUUUUUBBUUUUUUUUUUUUUUBUBUUBUUUUUUBBUBBBUUUUUB
UUUUUUBUUUBBUBUUUUBBUBBBUUUUUBUUBUUUUBBBBUUUUBBUBUUUUUBUUUUUUBBUUBUBUUBBBUUUUUUBUUBUBBUBUUUUUBUUUBUUU
UUUUUUUBUUUUUUUUBUUBUUUUBUUUUUUUBBUUBBUUUUUBUUUUUBUBUUBUBUUBUUUBUUBBUUUUUUUUBUUUBBUBUBUUUUBUBUUUBUUUU
UUUBUBBUBBUUBUBUBUUUBBUUUBUUBUUBUUBBUUBUUUUUUUUUUUUUUUBUBBBUUBBBBUUUUUBUUUUUBUBUBUUUUBUUBUUUUBBBUBBUU
BUUBUUBUUUUUUUUUUBUUBUBBBUBUUBUUUUUBUBUUUBUUBUUUUUUBUUUUUUBBUBUBUBUUUUUUUUBBBUBUUUUUBUUUUUUUUUUUBBUUB
UUBUBBUUUUUBBBBUUUUUUBUBUUUUUBBUUUBUUUBUUUUBUUBBUUUBBUUUUUBBUUUUUUUUUUBBUUUUBUUUUBUBUUBUUUUBUUUUBBUBU
UBBUBUUUUUBUUBUUBUUUBUBUBBUBUUBUUUUUUUBUUUUBBBUUUUUUUUUUUUUBBBUBBBUUUUUUUBUUUUUUUUUBUUBUUUUUUUUBUUBUU
UUUBUBBUBBBUUUUUUBBBUUUUBBUUUUUUUUUBUUUUUUBUUUBBUUUUUBBUUBBUUUUBUUUBUBUUUUUUUUBUBBBBBUBUUBUUUUUUUUBUU
UUUBUBUUBUUUUUBUBBUUUBUUUUUUBUUUUUBBBUUUUUBUBBUUUUUUBUBUBUUUUUUUUUUBBUUUUUBBBBUUUUBUBUBUUBBUBUUBUUUUB
UUUUUBBUUUUUUUBUUBBBUBUUUUBUUUUUBUBBUBUBUUUUBBBUBUUUUUUUUBUUUUBUUBUUUUUUBBBUBUBUBBUBBUUUUUUBUUUUUUBUU
UUBUBUUUBUBUUUUUUBUUUUUUUUUUUBBUUUUUUUUUUUBUUUUUBUBUBUUBUUBBUBBUBUUUUUUUUUUUUUUBBUUUUUBUUUUUUBUUUUUBU
BUUUBUBBBUBBUBUBUUBUUUUBUBUBUUUBUUBUBBUUUUUUBUUUBBBUUUUUUUBBBUUBBUBBBBBUBUUUUUUUUUBUBUUUUBUUUUUUUUUUU
UBBUBUUUUBUUUUBUBUUBUUUUUUUBUUUUUUUUUBBUBUUBBUUUBBBBBUBUUUBUUUUUUBBUUUUBBUBUBUUBBUUUUUBUUUBUUUUUUBBUU
BUUUBUBUBUUBBBUUUBUUBUUUUBBUBBUUUBUUUUUBUUUUUUBUUUUUUUUBUUUUUUBUUUUUBUUUUBUBUUBBBBUUBUBUBUUBUUUUUUUUU
UUUBBUBUUUBUBUUBUUUBUUBUUUUUBBBUBUUUBUBUUUUUUUUUUUUBBUUUUUUBUUUUBUBBBUUUUBUUUBBUUBUUUUUUUUUUUUUUUBUBU
UBBUUUBUUUUUUUUUUUBBUUUUUUUBUBUUBUBBBBBBUUUBUBBBUUUUUUUUBBUUBUUUUUUUUUUUUUUUBUUUUUUBUUUUUBBUUUUUUUUBB
UUBUUUUUBBUUUUUUBUUUUBBBUUUBBUUBUUBBBUUBUBUUUBUUBUUUUBUBUBBBBUUBUBBBUBUUBBUUBUUUUUUUBBUBUUBUUUUUBUUUU
UUUUUBUBBUUUBUUUUUUUBUUUUUUUBBUUUUUUUBUUUBBUUBBUUUUUBBUBUUBBUUUUBUUUUBBUBUBBUUUUUUUUUUUBUUUBUBUUUUUUU
UUUBUUUUUUBUUUUBUBBBUBBUUUBUUUBUUBBBUUBUBBBBUBUUBBUUUUUUUUUUUUUBUBUUBBUUUUUUBUUUUUBUBUUUBUBUUUBUUBUUB
UBBUUUUUBUUUUUBUBUUUUBUUUUUBUUUUUBUUUBUUUBUUUBUUUBUUUUUUUUUUBBUBUUUUBUUUBUUBUUUUUBUUUUUBUBBUUUUUUBUBB
BUUBUUBUUUBBUUBBUUUUUUBUUBUUUBUBUUUUUUBUBUUUBUUUBUBBUUUUUUBBBBUUBUUUUBBUUBUUUUUUUBBBUUUUBBBUUUUUUBUBB
BUUUUBBUUBUBUUUUUUUUBBUBUUUUUBUBUUBBUUUUUUUUUUUUUUUBUUUUUUBBUBUUUBBUUBUUBUBUBUUUUUUUBBUUUUUUUUBUBBUUU
BBUUUUBUUUUUUUUUBUBUUUBUUBUUUBBUUBUBUUUBUBUUUBUUUUBUUBUBUBUUUUUUUUUBUUUUUUUUBBBUUUUUUBBUUUUUUUUBUUUBB
UBBUUUUBUUUBUUUUBUUUUBUBBUBBUUUUBUBUUUUUUUBBUUUBBUUBUUBUBUUUBUBBUUUBBUBBUUBBUBUBUBBUUUUUUUUBUBBBBUUBU
UBBUUBUUUBUUUUUUUUUBUBUBUUBBBUBUBUBUBUUBUUBUUUUUUUUBBUUUUUUUUBUUUUBUBUUUUUUUUUUUUUUUBBBUUUUUUUUBBUUBB
UBUUUUUBUUBUUBBUUUUUUUUUBUUUUUBUUUUUUBUUUUUUUUBBBUBUUUUBUUUBBUUUBUUUUUUUBBUUUUBBUBUUUBUUUUUUBUUBUUUBU
UUBBUUUUUBUUUUUUUBUUUBBUUUUBUUBBBUUBUUBBUUUUBUUUUUUUBUUUUBBUUBUUUBUUUBUBUBUUUUBUBBUUUBUUBUUBBUBBUUUUB
BUBUBBUUUUBBUUBBUUUUUUUUBUBUUBUUUUUUUBUBUUUUUUUBBUUBUBBBUBUBUUBUUUUUBUUUUUUUUUBUUUUUUUUUBBUUUUUUBBUUU
UBUUUUBUBBUBUBBUUUUUUBBUUUUBUUUUUUUBBBBUUUUUUUUUUUBUUUUBUUUUBUUUBUUBUUBUUUBBBUUUUUBUUBUBUUUUUUUUBUUUU
UUUUBUUBBUUUUUBUUUBBUBUUUBUBUUBUBUUBUUBBUUUBUUUUUUUUBUUUBUUUUUBUBBUBUUUUUUBUUBUUBUUUUUUUUUBUUUBUUUUUB
BUBUBBUUUUBUUUUUUUUBBUUUUBBUUBUUUUUBUUBUUUUUUBUBBUUUUUUUUUBUUBBUBUUBUUUUUUUUBUUUBUUBBUUBUUUUUUUUUUUUB
BUUUUUUUBUBUBUBUUUUUUUUUBUUBUUUUBUUBBBUUBBBUUBBUUUUUUUUUUBUUUUUUUUUUUUUBUUUUUUBUBUUBBUUBBUUBUUUUUUUUB
UUUUUUBUUBUBUUUUBUUUUUUUBUBBUBBBBUBBBUBUUBUUBBBUBUUUBUUUUBUUBBUUUUBUUBBUBBBBUUBUBUUUUBBUUBUUBUUBBBUBU
UUUBUUUUUUUUUBBUUUBUUUUUUUUBUUUBBBUUBUUUUUUBBBUUUUBUUUUUUUUBUUUUBUBUUBBUBBUUBBBUUBUUBUBUUUUUBUUUUUUBU
UBUBBBUUUUUBBUUUUBUUUUBBUUUUBUUUUUUUBUUBUBUUUBBUBUUUUBBBUUUUUBUUUUUBUBBUUUUUBUUUUBUBBUUUUUBUUUBUUUUBB
UUBUUBBBUUUUUBBUUBBUUUUBUUBUBBUUUBUUBUBUBUBUUUUUBUUUUUUUUUUBUBUUUUUUBUBUUUUUUBBUBUUUBUBUUUUUUUUUUBUUU
UUBUUBUUUBUUBUBBBUBBUBBBUUBUBUUBBBUBUUUUBUBBUBUUBUBBUUBBBBUBUUBBUUUUUUUBUUUUBUBUUUBUBUUBBUUUBBUBUBUUU
UUUBUUBBUUUUBUUUUUBUBBUUUBUBUUUUUUBUUUUUBUUUUBUUUBUBUUUUUUUUBUUBUUUUUUUUUBUBUBUUUUUBUUBUUUUUUBBBUUUUU
UBUUUUBBUUUBBBUUBUUBUUBUBUBBUUBBUUUUUUUUUUUUBUBUUUUBUBUUUUUUUUUUUUUBUUBUUBBUUUBBBUUBUUBBUUUUUUBUBBUUU
UUUBUUBBUUUUBBBUUUBUUUUUUUBBUUUBUBBUBUUUUUUUBBUUBUUUUUUUUUUUBUBBUUBUUUBBUBUUUUBUUUBUBUUUUUUBUBUBUUBUB
UUBUUUUUUUUBUUUUUUUUUUUUUUBBUUUUUUUUUUBBUUUUUUBUUUUUUUUUUUUUUUBBUBUUUUUBBUUUUBUUUUBUUUBUUUUBBBUUUUUUU
UUUUUUUUUUUUBUUUBUBBUUUBBUUUUUUUUUUBUUUUBUUUUUBBBBUUUUUUUUUBBUUBUUUBBBUUUUUUBBUUUUUUUUUBUBUUBUUUUUUUU
UUUUUBUUBBBUBBUBUBBBBUBUUBUUBUBUUBUUUUUBBUUBBBUBUBBBUUUUBBUBUUBUUBUUBUUUUUUBUUBUUUUUBUUUUUUBUUUUUBBUB
BUUUUUUBUBUBUUBUUUUUUBBUUUUUUBUUUBBUUUBBUUUBBUBBUUUBUUUUBUUUUUBUUUUUBUUUUUBUUUUUUUUUBUBBUUUBUUBUUUUUU
UUUUUUBBUUBUUUUUUBUUUUUUUUBBUUUBUBBUUUUBBBBUBBUBUUUBUUUUUUUUUUUUUUUUUUUBUUUBBUUUUBBBUUUUUUUUBUUUUBUUU
BUBUUBUBUUUUUUUUBUUUBBBUUUBUUBUUUUUUBUBUUUBUBUUUUUUUUUUBUUUUUBBUBUBBBUUBUBUUBBBUUUUUUUBUUUUUUUUBUUUUU
UUUBBUUUUUBBBUUUBBUUUBUBUBBUBUBUUUUUUBBUUBUBUUUUUBUUUBBUUUBUBUUUUBUUUBBUUUBUBUBUBUBUUUUUUUBBUBUBBUUUU
UBUUUUUBUUUUUUUUUBUUUUUBUUUUUBUUUUUBUUUUUUUUUBUUUBUBUBUUBUUUBBUBUUUBUBUUBUBUUUUUUUUUUBUUUBUBUBUUBUUBU
UUUUUBUBUUUUBUUBUUBBUUUUUUUUBBUUUBUUUUUUBUUUUBUUUUUUBUUBUUBUBUUUUUBBUUUUBUUUBBUUBUUUUBUUUUBBBUUUUUBBU
BUBUUBUBUUUBUUUUUUUUUBUUUUUUBUUUBBUUUUUBUUBUBUUUUBUUBUUUUUUBUUUBUUUUUUUUBUUBBBUUUUUUUUUBUUUUUBUBUBUBU
BBUBUUUUUUUBUUBUBBUUUBBUUBUBUBBBUBUBUUBBUUBUUUUUUUBBBBUUBUUUBUUUUBBUUUUUUUUUUUUUUBUBUBUBUUBUUUUUUBUUU
BUBUBUUBUUUUUUUUBBUUBUUBUUUUUUBBUUUUBUBUBBBBUUUBUBUBUUUUUBBUUBUBUBUUUUUUBUUBBBUUUBBUUUUBUBUUBUUUBUUBU
UBUUUBBUUUBUBUUBBUUBBUBUBUBBUBBUUUUUUUUUUUBUBUBUUUUUUBUUUBUUUUUBUUUBBUUUUBBUBUBBUBBUBBUBUUUBUUBUUUUUB
UBUUUUUBBBBUUUUBUUBUBUUUUUBBUUBUUUBUUUUUBUBUUUUUUBUUBUUUUBUUUUBUBUUBUUUUBUBBUUUUBUUUUUUBUBBBUUUUBUUUU
