UUUBBUUBUBBUUBBUUUBUBBUBUBUUBBBUBUUUBUUUBUUUUUUBUUUUUUBUUUUUBUBUUUUUUUUBUUUBBUBUBBBUUUUUBUUUUUBBUUBBB
UBBUUUUUUUUBUUBUUUUUUBUUBUUUUUUUUUUBUUBUUBBBUUUBUUBBBBBUUUBBBBUBUUUUUBUUBBBBBUBBBUBUUBUUBBBUUUUUBUUUU
UUUBUUBUBBUUUUUUBBBBUUBBBUUUUUUUUUBBBUUUUUUUUBUUUUUUUUUUUBUBUUUUUBUUBBBUBUUUUBBBUBUUUUUUBUBUUUBBUUBUU
UUBUBUUUUBBUBUBUBUUUUBBUUBBBBUBBUUBBUUBUUUUUUUBUBUUUUUUUUUUBUUUBUBUUBBBBUUUUUBBUUUUUUBUUBUUUUUUUBUBUU
UBUUBUUUUUBUBUBBUUUUUBBUBBUBUUUUUBUUUUUUUUUUUUBUBUBUUUUBUBUUUBUBUUUUUBBUUUUBUUUUUUBUUUUBUUUUUUBBUUUBB
UUUUUUBUUBBBUUUUUBBUUUUUBUBUBUUUUBUBUUUUUUUUUUUUBUUUBUBUUBUUBUBBUBUUUBUBBBUUUUUUUBBUUUUUUBUUUUUBBBUBU
UUUUUUUUUBBUUBUUUBBUUUUUBBUUUUUUUBBUBBUBBUBUBUUUUBUUUUBUUUBUBBUUBUUBBUUBBBBUBUUUUUUUUUUUBUBBBUBUUBBUB
UUUUUUUUBUBUUUUUUUUUUUUBBUBUUUBUBUUUUBUUUBBUBBUUUUUUUUUUUUUUBUBUUUUUUUUBUBUUUUUUUUUUUUUBUBUUUBUUUUBUB
UUUBUUUBBUUUUBUUUUUUUUUUUUUBBUUUUUUUBUBUUUBBUUUUUBUUUUUBUUBUBBUUBBUUUBUBUBUUUUBUBBUUUUBBUUUUBUBBUUUUU
UUUBUUUBUBBUUUBUBBUUUUUUUUUUUUUUUUBBUUUUBBUUBUBUUUUUUUUBUUUBUUUBUBUBUUBBUUBBUUBUUUBBUUUUUUUUBUUUBBUUU
UUUUUUUBUUBUUUBUBUBUBUUUUUUBBUBUBUBUBUUUUUUUUUBUUUBUUBUBBUUBBBUBUBUUBUUUUUUBUUUUBUBUUBUUBUUUUBUBUUUUB
UUUUUUBBUBUUUUBUBUUUUUUUUBBBBUBUUUUUUUUUUBUUUBUUUUUUUUUUUUUBUBBUUUUUUUUUUUUUUUBUUUUBUUUBUUUBUUUUUUUUB
BUUUUUUUUBUBUBUBUUUBUBBUBBUUUBUBUUBUUUUUUUUBBUBUUBBBBUUBUUUUUUUUUUBUBBBUUUUUBUBUUUUUUUUUUBUBUUUUUBUUU
BUUUBBBUUUBBUBUUUUUBBBBUUBUUUUUUUUUBBUUUBBUUUUBUUBUUUUUUBUBBUUUBBBUBUBBUUBUBUUBUBUUUBUUUUUUUUUBBUUBUU
UUUBUUUUBBUBUBBUUUUUUUUUUUUUUBBUUUUBBBUUUBBUUBBBBBUUBUUUUBUUUUUUBBUBBUBUUUUUUBUBBUUUUUUBUUUBUBBBUUUBU
UBBUUUUBBUUUUUUUUUUBUUUBUUUUUUBUBBUBUUUBUUUBUUUUUUBUBBBUUUUUBUUBUBUUUUUUUUBBUUUUUUUBUUUBBBUUUUUUUUUUU
UBBUUBUUUBUUUUUUUUBBUBUUUBUUBUBBUUUUUUBUUUUUBUUUUUUBUUUUUUUUUBUUUBBBUUBUUUUUUBUUBUUUUUUUUUUUUUUUUUBUB
BUUUUBUUUUUUUUBUUUUUUBBUUUUBUUUUUUUUBUUUUBBBUUUBUBUBBUUBUBBUBUUBUUBBUUUBBUUUUBUUBUUUUUUBUBUUBBBUBBUUU
UUBBUUUUUUUUBBUUUUUUBUBBUUUUUUUUUUUUBBBUUBUUBBUBUUUUUUUUUUUBBUBUUUUBUUBUBBBUUUUBBUUUBUUBUUUUUUUUUBUUU
BUUBUBBUUBUUUUBUBBUUBUBBUUUUBBUBUBBUUBUUUUUUUBUUUUBUUBUUBUUBBUUBBUBUBBUUUBUBUUUUUUUUUUUUUUUBUUUUUBUUU
UUUUBUUBBBBUBUUBUUUUUBUUUBUUUUBUBUUUBUUUBUUBUUBBUUBUUBBUUUUUBBUBUUBUBUUUUBBUBUUUBBUBUUUBUBUUUUUUUBUUU
BUUUUBUBUUUUUUBBBUBUUUUUUBUBUBUUUBUBUBUBUBUUUUUBUBUUUBUUUUUUUUUUUUUUUUUUUBBUUUUUBBUUUUUUUUUUBUBUUUBUU
UBBBUUUBUUBBBBUUUBUUUUUBBBUUUUBUUUUUUUBBBUBUBUBBUUUBUUUBUUBUUBUBUUUBUUUBUUUUBBBUUUUUBUUBUUUBUUUBUUBUU
UUUUUUUUUUUBBUUUBUUUBUBUBUUUBUUUUUUBUUBBUUBUUUUUUBBUUUUUBUUUBBUBBUBBUUBBUUUUUUUUUBUBUUBUUUUUUBBUUBUBU
UUUUUUUUBUUBUUUUUUUBUUUUBUUUUUUUBUUUBUUBUUUBBUBBBBUUUBUUUUUBUUUUUUUUBBBUUUBUUBUBBUUBBUBUUUUUUBUBUBBBU
UUUUUUUBUBBBUUBUUBBUBUBUBUBUUBUUUUUUBUUUUUUBBBUUUUUUUBUUBUUBUUUBBUBUUBUUBBBBUBUBUUUUUUUUUUBBBBUUUUUUU
UUUBUUUUUUUUBUUUUUUUUUUUUUBUBUBBUUUUUBUUUUUUUBBUUUBUUUBBUUUUBUUBUUUUUUBBBUUUUBUBUBUUUBUBUBUUUUUBBUUUU
UUBBUUBUUUBUUUUUBBUBUUBBUUUBUUUUUBUUUUUUUBBUUUUUUBBUUUUUBBUBBUUUUUBUUBUBUBUUBUUBBUUUUUUUUUUBUUBUBUUUB
UUBUUBUUUUBUUBUUBBUUUUUUUBUUBUBUUUUUUUUUUUUUUUUBBBUUUUUUUBUUBUBUUBUUUBBUBUUUUBUUBUUUBUBUUUUUBUUBUUBUB
BBUUUBUUUUUUBBBUUUUUUUUUUUUBBBUUUUUUUBUUUBUBUUUUUUBBBUUUUUBUUUBUUUBUUUBUUBUUBUBUUBBUUBBUUUBUUUUUBUUUU
UUUUBUBUUBUBUUUUUUUBUUUUUUBUUBUUUUUUUUUUBUUUUUBUUUUBUBUUUUUBBUUUBUUUUUUBUUUBUUUUBBBUUUUBUBUUUUUUBUUUU
UBUUUBUUBUBBUUUBBBUUUUUBUUUBUBBBBUUBUUBUUUBBBUBBBUBUUBUUUBUBBBBBUBUBUUBUBUBBBBUUUUUUUUUUUUUBBUUUUBUUB
UUBUUUUUUUUUUUUBBUUUUUUUUUBUUUBUUUUUUUUUUBUUUUBBBUUUUUBBUUUUUUBBBUUUBBBUBBUBUBUUUUUUUUUUUUBUUUUUBUUUU
UBUUUBUBUUUBUUBUBUUUUUBUUBUUBUUUUUBBUUUUUUUBUUUUUUUUUUUUBUBBBUUBUBUBUBUUUBUUUUUUUUBUUUUUUBUUBUUUBUUUU
UUUUUUBBUBUUUUBUBUBUBUUUBUUBUBBUUBBUUUUBUUUUUBBBUUUUBBUBUUUUUUUUBUUUUUBUUUBUUBBUUUUUUUUUBUUBUBUUUUUUU
UBUUUUBUUBUUUUUUUUUBUBBBUUBUUUUUUBBUBUBBUUUUBUUUUUUUBBUUBBBUUBUUUUUUBUUBUUBUUUUUUUBUBBUUBBUUUUUUUUUUB
UUUBUUBUUUUUUBUUUBBUBUBBUUUUUBUUUUUBUUBUUUUUUUBUUBUBUUUUUUUBUBUUUUUUUUBUBUUBBUUBUBUBUBUUUUUUUBUUUUBUU
UUUBUUUUBUUBUUBBUUUUUBUUUUUUBUBUUUUUUUUUUUUUUBBBUUUUUBBBUUUBUUUUBUUUBBUUUUUUBUUUUUBUUUUUUUBUUUUUBUUUU
UUBUUBUUUBUUUUUUUBUUBUUUUUUBBUBBUUUUBUBUUBUUBUBUUBUUUUUUUUUUUUUUUBUBUUUUUBUUUUBBBUBUUUUUUUUUUUBUUBBBU
UUBUUUBBUUBBUBBBUUUUBUBBBUUBUUUUUUUUUUUUUBUUUUUUBBUBBUBUUUBBUUUUUBUBUBUUUUUUBUUUUBBUUUBBUUUUUUUUUUUUB
UBUUBUUBUUBUUBUUBUUBUUUUUUBUUBUUUBUUBUUUBBUUUBBUBBUUUUUUUUUBBUUBUUBBUUUBUUUUBBUBUBBBBUBBBUUBUBBBUUUBU
BUBUUUUUUBUUUUBUUUUUBBBBUUBUUUUUUUUBUUUBUUUUUUUBBBUBUUBUBBUUBUUUUBUUUUUUUUUBUUUUUUBBUBUUUBUUBUUBBBBUB
BUUUUUBUUUUUUUBUUBUUBBBUUUBBUUUBUBUUUUBBUBUUUBUUUUBUBUUBUUBUUBUBUBBBUBUUBUUUUUUUUUUBUUUUBUUUUUUUUUUBU
BUUUUBUBBUBUUUBUBUUUUUUUBUBBUBUUBUUUBBUUBUUUBUUBUBBUBUBUUUUUUUUBUBUBUUUUBUUUUUUUBUBUUUBUUBBUBUUUBBUUU
UUUUUBBBUBBUUUUBUUBUUUUUBUBBUUBUUUBBUUBBUUUBUUUUUUUBBUBUUUUBUUUUBUUUUBBBUUUBBBUUUBUUUUBUUBUBUBUUUUUBU
BBUUBUUUUUBUUBUUUUBUBUUUBUUUUBBUUUBUUUUUUUUBBBBUUUBUUUBBUUUUUUUBBBBBUUUUUUUBUUUBUUUUUBBUUUUBUUUUUUUUB
UUBUUUBBUUUUUUBBBUUUUBUUUUUBUUUUUBUBBUUUUUUUUBBUUUUUUUUBUUUUUUUUUUBUBUUUUUBUUUUBUBUBBBUUUUUBBUUUBUUBU
UUUBUBUUUUUBBUUUBBUUUUUBUUBUUUUUUBUUBUUUUUUUUBUUUUUUUBUUUUUUBUUBBBUUBUUUBUUUUUUUUUUUBBUUBBBUUUUUUUUUU
UUUUUUBUUUUUUUUUBBUUBUUUUBBBBUUUBUUBBUUBUBUUBUBUBUUUUBUUUBBUUUUUBUBBUUUUBUBUUBUUBUUUBBBBUUUUUUBUUBUBB
UUUBUUUUUUUUBUBBBUUBUBUUBUUBBUUUUUBUUUUUBUBUUUUUUBUBUBUBBBUUUUUUUUUUUBUUBUBBBUUUBUBUBUUUBUBUBUUBUUBUU
BBUUBBBUBUBUUUUBUUBUUUBBBUUUUUUUUUUUBUBUUUBUBUUUUUUUBUUUUUUUUBUBUUUUUBUUBBUUBBBUUUBUBUBBUBUBUUUUBBBBU
BBUBUUUUUUUUUUUBUUUUBUBBUUBBUBUBUBBUUUUUUBUBUBBUUUUUUUUUUBBUUUUUBUUUBUUUBBBUUUUUUUBUUUBUUUBUUUUUUUUUU
UUUBBUUBUUUUBBUUBUUUUUBBBBBUUUUUUUBUUBUUBBUUUUBUBUUUBUUUBUBBUUUUBUUUUUUBUUBUUUUBUUBBBUUUUBUUBUBUBUUBU
UUBUUBUUBUBBUUBUUUUUUBBUBUUBUUBUUUUUUUUUUBUBUBUUUUBBUUUUBUBUUBUUUUUUUBUBBBUUUUUUBUUUUBUUBBUUUBBUBBBUU
UUUUUUBUUUUUUUUBUUBUBUBBUUBUUBUBBUUBUUUUUUUUUUUUBUBUUUUBUUUUUBUUBBUUBUUUBUBUBUBBBUUUBBUBUUUUUUBUBUBUU
UUUBUUUBUUUBBUUUUUUUUUUBUUUUUUUBUUUBBBUBUUBBUUBUBUUUUUBUUUBUUUUUUBUUUBBUUUUUBBUBUUUUUUBUUUUUUBUUUBBBU
UUUUUUUUUUUUUUUUBBUBUUUUUBUUUUUBUUUBUUUUUBUBBUUBUUUUUBBUUUUUUUBUUBBBUUUUBUUUBUBUUBUUUUUBUUUBBUUUBBBUU
UUBUUUUUUUUBUBBUUUUUUUUUUUUUUBUUUBUUUUUBBUUBUUUUUUUBUUUUUUUUUBUBBUUUUUUUUUBBUBBBUBBUUUUUUBUUUUUUUBUUU
BBUUUUBBUUUUUBBUBBUUBBBBUUBUUBUUUUUUBUUUUUUUBUBUBUUBUUBBUBUBBBUUUUBUBBUUUUUBUUUUUUUUUUUBBUUUUUUUUBUUB
BUBUUUUUUBBBBUUBUUBBUUUUUUUUBUUUUUUUUUBBUUUBUUUUUUUUBUUUUUUUBUUUUUBUBBUUUUUUUUUUUUUUUUBUBBUUUBUUUBBUU
BBUUUUUUBUUUUUBBUUUBUUUUUUUUUUUBBBUBUUUUBBUUUBUUBBBUBUUBUUUUUUBUUBUUBUBUBUUUBUBUBUBBUUBUUBBUBUUUUUBUU
UBBBUBUUUBBBUUUBUUUUUUBUBBBUUUUUUUUUBUUUBUUUBBUBUUUUUUBUBUBUUBUBBBBBUBBUBUUUUUBUBUUUBUUUUUUUUUUUBUUBU
BUUUUUUBUUUUUBBUUUUBBUUBUUBBBUBUUUUUUUUBUUUBUUUUUUBUUBUUBUUUBUBUUUUUUUUUUUUUBBUUUBUUBUBUUUUUBBUUUUBBU
BBUUUUUBUUBBUUUUUBUBBUUUUBBUBUUUUBBUBUUUUUBUUUBUBUBUUBUUUBUBUUBUUUUBBUUBBUUUUBUUUUBUBUUUBUBUBUUBUUUUU
BUBBUUUBBBUUBUUUUUUUUBBUUUUBUUBBUBUUBUUBUUUBUUUUUUUUUUUUUUBBUUUUUUUBUUBBBUUUBUBUBUBBUUUUUUUUUBUBUUBBU
UUUUUUUUBUUUUUUUUBUUBUBUUBBUUUBBUBUBBUUUUUBUUUBUUUBUUUUUUUUUUUBUBUUUBUUUUUBUBUUUBBUUUBUBBBBUUUUBUUUBU
BBBUUBBBBUUBUUUUBBUUBUBBUUBUUUUUUUBUUUBUBUUUBUUBUUUUUBUBUUUUBBBBUUUUUUBBUUUUUUUBUUBUUUBUUUUUUBBBUUUUB
UBUUUUBUBUUUUUUUUUUUUUUUUBBUBBBUUUUBUUUUUBUUUBUUBBUUUUUBUUBBUUUBBUUUUUBBUUUUUUUBUUBUUUBUUBUUBBUUUUBBU
BBUUBBUUUUBBBUUUUUUBUUBUUBUUUBUBUBUUBBUUUBUBUUBUUBBBUBUUBUUUUBUBUUBUUUUBUBUBBUUUUBUBUUUUUUUBBUBUUUUBU
UUUUBUUUUUUUUUBUBBUUUUBUBBUBUBUUBUUBUUUUUUUUBUUUUBUUUUUUBUUBBUUUUUUBBUUUUUBUBBUUBUUBBUUBUUUBUUUUUBUUU
BUUUBBBUBBUUUBUUBUUUUBUBUBUBBBUUUUUUUUUBUUUUBBUUUUUBUBUUUUUUBUUUUUUBUUBUUUBUUUUUUBBUUBUUUUUUBBBUBBUUU
BUUUUBUUUBUUBBUBUBUUBUBUUBUBUUUUUUUUUUBUUUUBUUUUBUUUUUUUUUBUBUUUUUUUUUUBUUUUBUUUUBBUBUUBUBUUBUUUBUUUB
BBBBUUBBBUBUUBBBUUBUUUUUBUBBUUBBUUUUUBUUUUUUUUUBUUUUBUUUBUBBUUUUUUUUBUUUUUUBUUUBBUUBBUUUUUUUBUUBUBUBU
BBUUUUUUUBBBUBUUUUUUBBUBBUUUBBBUUBUUBUBUUBUUUBUUUUUUUBUUBBBBUBUUUBBUUBBUUUUBUUUUUUBUUBUUUBUBBUBUUUUUB
UUUBUUUUUBUUUBBUUBUBUUBUBUUUUBBUUUUBUUBUUUBUBUBUUBBUBBUUUUBUUUUUUBUUUUUUUUBUBBUBUUUUUUUUUBUBUBUUBBUUU
UUBUUUBBUUBUUUUUUBUUUBBUUUUUUUUUUUBBUUUUUUUUUUUBUUUUUUBUUUUUUUUBBUBBUUUBBBUBUUUUUBUUBUBUUUBUUUUUUBUBB
BUUUBBBBUUBUUBBUUUUUUBBUBUBUUUBUBUUUUUBBUUUUBBUUUUUBUUUBUUUUUBUUUUBBUBUBUBBUUUUUUUBBBUUUUUBUUBBBBUUBU
BBBBBUBUUBUBUBBUUUBUUUUUUUUUUUBUUBUUBBUBUUUBUBBUUBUUUUUUBBBUUBUUBUBUUUUUUUUUBUUUBUBUUBBUBBBUBUBUUBBUU
UUUUBUUBUUUUUUBUUBBUUBUBUUUUUBBUBUBUUUBUUUUUUBUUUUUUUUUUUUBUUUBUUUBUBUUBUUBUBBBUBUBUBUBUUUBBBUUBBUUUU
UUUBUUBBUUUUUUUBBUUBUBBUUUUUUUBUUBUUUUUUBUBUUBUUUUUBUUBUUUBUBUBBUUUUBUUUUUBBUBUBUBBUUUUBUUUUUBBUUBUBU
UUBUUUUUUBBUUBBUBBBBBUUBBUBUUUUUUUUUBUUBBBUUUUUUUUUUUUUBUUUUBUUBBUBUUUUUUBUUBUBBUUUUBUBBUUBUUBUUUUUUU
UBUUBUUUUBUUUUBUUBUUUUUUBBUBUUBUUUUBUBBUBUBUUUBUUUUBUUUUUUUUUUUBUBBUUUUUBUUBUUBUUUBUBUUUUUUBUBBUUUUUU
BUBUBBUUUBBUUUBUUBUUUUBUUUBBUUUUBUUUUUBUUBUUBBBUUUUUUBUUUUUUBBBUBUUUBUUUUUUUBBUUUUBBBUUUBBUUUBUUUUBUU
UBUUUBUBBBUUUUUBUUUBUUUUUUUUBUBBUUBUUUUUUUUBBBUBUUUUUUUUUUBBUBBUBUBUBUUUUUUUBUBBUBBUBUBUBUUUUUUBBBUUU
BUBBUUUUUUBUUBUBUUUBBUBUUUUBBBBUUUUUUBBUUUUUUUUUUUBUUUUUUBUUUBUUBBUBUBUUUUBUUUBBBUUUBUUBBUUUUUBBBUUUU
UUUUBUBBBUBUUUBUUUUUBUUBUUBUBBBBUBBUUBUUUUUUUUUUUUBUUUUBBUUBUUUUUBBBBUUUBBUBUUUBUUBUUUUUUUBUBUBUUUBUU
BBUUBUUUBUBUUUUUUBUUUUBUUUUUUUUUUUUUUBBBUUBUUBBBBUBBUUUBUBUBUUBUUUUUUUUUUUUUUBBUUUUUUBUUUBUUBUBBBBUUB
BUUUUUUUUUUUUUUBUBUBBBUUUUBBUUUBBUBUUUBUUBBBUUUUBUBUBUUUUUUUUUBUUUUUBBUUUUUUUUUUUBUBUUUUBUUUUUBUBUUUU
UBUBUUBUUUUUUBUBUUUUBUUBUUBBUUUUBUUUUUUUBUUUBUUUUUBBUBUBUBUBBBUUBUBBUUUUUBUBUUUUUUUUUUUBBUBUBUUUBBBBU
BUUBBUUUUBUBUBUUUUBUUUBUBUUBUBUUUUBBBUBUBBUUUUUUUUUUBUUUUUUUUUUUUUUUBBBBUUUUUUUBUUBUUBBUUBUUUBBUBUUBU
UBBUUUUBUUUUUUUUUBBBUBBUUUBUUUBUUBBBUBUUUUBBUBUUUUBBBUUUUUUUUUUUBBBUBUBUUUUUBUUBUUUBUBUBUUBBUUUUUBBUB
UUUUUUUBUUUBUUUUUBUBUBUUBUUUUBUUUUUUUUUUBBUUUUBUUUBBUUUBBUBUUBUUBUUUBBUUUBBBBUUBBBBUUBBUUUUUBUBBUBBBU
BBUUUUBUBUUBBUUBUUUUUUUBUUBBBUUUUUUBUUUUUUBUUBUBUUUUUUUBUUBBUBBUUUUBBUUUUBUUUUBUBUUBUUUUUUUUUUUBUBUUU
UUUUUUUUUUBUBUUBUBBUBUUBUUUUBUUBUUUUBBUUUUUUUBBUUUUUBUUUBUUBUBUUUUUUBUUBUBUBBBUUUUUUUBBUUUUBUUUUBBUUB
UUUBUUBUBUUUUUBUUBBBUUBUUUUBBUBUUUBUBUBUUUUUUUBUUBUUUBUUBUBUUUUBBUUUUUUUBUUUUUBUBUUUUUUUUUBUUUBUUBUUB
UUUUUUUBBUUUUBUUBUBBUUUBBUBUUUUUUBUUBBBUUBUUBUUBUUUUBBBUUUBBBBBUUUUUBBUBUUUBUBUUUUUUUUBBUUBBUBUUUUUUB
BUUBUBUUUUUUUUUBUBUUUBUBUUUUUUBBUUBBUUBUUUUUBBUUUUBBUUBUUUUUBUBBUUUUUUUBUUBUUUUBBUBUUBBUUUUUUUUUUUBUU
BUBBUUUUUUBUUUUBUBUUBBUUUUUUUUUUUUBBUBUBUUUBUUBUUUUUUUUUUBUUUBUUUBUUUBUUBUUBBBUUUUBUBBUUUUBUUBUBBBUUU
UUUUBUUUUUUUUUUUUUBBBUUUUUUUUUUUUBUBUUBBBUBUUUUBUUUUUUBUUUBBUBUBBUUBBBBUBUUBBUUUUUBUUUUUUUBBBUBUBUUUU
BUBUUUUUBBBBBUUUUUUUUUBBUUUUUUUUUBUBUUUUUUUBBUUUBBUBBBBBUBBUUUUUBUUUUBUBBUBUUUUUBBBUUUUUBUBUBUUUBUUUU
BUUUBUUUUUUUUUBBUUUUBUUUUUUUBUUBUUBBUUUUUUUUUUUUBBBBUUBUUUUUUBBUUUUUUUUUUBUBBBUUUUUUUUUBUUUBBUUBUUUUU
