UBUUUUUUUUUBUBUUUUUUUUUBBUUUBUUUUUUUUUUUUBUUUUUUUUUUUUUUUBUUUBUUUUBUUUUUUUBUBUBBBUBBUUUUUBUUUBUUUBBUU
UUUUUBBUUUUUUUBUUUUUUBUBBBUUBBBBUUUUUUUBUBUUUUBBUUUUUUUUUUBUUBUBUUUBUUUUBUBUBBBUUBUUBUUUBUUBUUUUUUBUB
UBUBUUBUUUUUUUUUUBUUBUUUBBUUUUUUUUUBUUUUBBUUUBUUBUUUBUBUBBUUUUBUUUBUUUUBBBUUBUUUUUUUBUUUUBUUUUUBUUBUB
UUUUBUUUUUUUUBUBUUBUUUBUUUBUUBUUUUUBUUUUBBUBUBUUUUUUUUUUUUUUUBUUBUUUUUUUUUUUUBUBUUBBUBUBUUUBUUUBUUUBB
UUUBBBUBUBUUUBUUBBBUBUUBUBUBBBBBUBBUUUBUUBUUUUUUUUBUUBBBUUBBBUUBUUBUUUUBUBUUUBUBUUBBUUUUUUUBUUBBUUBBU
UUUUUUUUBBUBBBUUBUUUUBUBBBUBUUUUUUUUBUBBUBBUUUBBUBUBUUBUUUBUBBUUBUUBBUBBUUUUBUUBUBUUUBUUBBUBUBUUUUUBB
BUBUUBUUUUUBBUUUBUUBBUUBBBBUUBUUUUBBBUUUUBBUUUUBUUBBBUBUBUBUUUUBUUUUUUBBUUBUUUBUUUUBUUUUBUUUUUUUUBBUU
BUBUUUUBBUBBUUUUUBUUUBBBUUBBUUUUUUUUUBUUUBUBUUUUBUBUUUUUUBBBUUBBUBBUUUBUUUBBUBBUUUUUBUUBUUUBUUUUUUUBU
UBBUUUUUBUUUUUUUUUBUBUBBBBUBUUBUUUUBUBUUUBUBUUBUBUUUBUUBUBBBBUBUUUUUUUBUUUBUUUUBUUUBUUUBUBUBUUUUUBUUU
UUUBUBUUBUUBUUUBUBUUUUUBUUUUUUUBUUBBBBBBUUUUBUUUUUBUBUUBUBUUUUUUUBUBUUUBBUUBUBUUUUUUBUUUUUUBUUUUUBUBU
BUUUUUUBUUUUBUUUBUBBUUBUBBBUUUUBUBUUBBUUUUBBBBUUBUBUUBUUUUBUUBBUUUUBBBUUUUBBBUUUUUUUBUUUBUBUUUUBUUBUU
UUUUUUUUUUUUUBUBUUUUUBBUUUUUUUUUUUUBUUBUBBBBUBUUBBBUBUUBUUUUBUUUUBUUBBUUUUUUUBBUBUBBUUUBBBBUUBUUUUBUU
UUUUBBUUUUUUBUBBUUUUUUUUUUBBUUUUUUUUBUBUUUUBUUUBUBUBBBUUUBBUUUBBUUUBUUUUUUBUBUUUUBUUBUUBUUBUUUUUUUBUB
UUBUBUUUBUUBBUBUUUUUBUBUBUBUBUUUBBUUBUBBUUUUUUUBUUUUUUUBUUBBUUUUUBBBUUUUUUUBUUBUUUUBUUUBUUUBUUUUBUUUU
UUBBBBBBUUBBBUUUUUUUUUBUUUUUUUUUUBUUUUBUUUUBUUBUUUUUUUUUUUUBUUUUUUUBUBUBBUUUUUBUBUUUUUUBUUUUUUUUUUUUU
UUBUBUBBBUBUUUUBUBUBBUUUBUUUUBBBUUUBUUBBBUUUUUUUUUUUUUUBBUUUUUUBUUUUUBUUUUBBUUUUUUUBUUBUUBUBUUUUUUUUU
UBUUBUUBBBUUUUUBUUBUUUBUBUUUUUBBBUUBUUUUUUUBUUBUBUBUBBUBUUBBUBUUUUUUUBBUBUUUUUUUBUUBUUUBBUUUUUUUUUBUU
BBUUUUUUUUUBUUUUUUBBUUUUBUBUUUUUUBUUUBUBUUUUUBBBBUUUUUUBUUUUBUUBUUUUBUUUUUUUUUBBUUBBUUUBUUUUUBUUUUBBU
UUUUUBBUUBUBBUBUUUUUUUUUUUBUUBUUBUBUUUUUBBUBUUBUUUUUUUBBUUUUBBUBUUBUUUUUUUUUUUUUUUUUUBUUUBUUBBBBUBUUU
UUUUBBUUUBBUUUBUBUUBUUBUUUBBUUUUUUUUUUUBUBBUUUUBUUBUBBUBUBBUBUUBUUBUUBUBBBBUUUUUUUUUBUBUUUUBUBUUBBUBB
UUBUUUUUBBBUBUUUBUUUBBUBUBUUBUUUUUUUUUUUUUBUUUBUBUBUUUUUBBUUUUUUUBUBUUUBUUUBUUUUUUUUUUUBBUUBUUUBUUUUU
UBUBUBUBUUBUUUUUBUUUUUBUUUUUBUUBUBBUUUUUUUUUUUUUUUUBUUUBUUUUBBUBUBUBUUUBUBBUUUUBBUUBBUBBUBUUUUUUUUUUU
UUUUUBUUUUBUUUUUBUUBUUUUUUUBUUUUUBUUUBUBUBBBBUUUBUUUBBUUBBBBBUUUUUUUUUBUBBUBUUUUUUUUUUUUUBUUUUUBUUUUU
UUBBBUBUUUUUBUBUUUUBBUBUUUUUUUUUUUUUUUUBUUUUUUUUUUBUUUUUUBBBBUBBUUUBBBUUUUBUUBUBBUUBUUBUBBUUUBUBUBUBU
UUUBUUBUBBUUUBUBBUUUBUUUBBUBBUBUBUBUUUUUBUUUBUUUUUUBUBBBUUUUBUUUUUUUUUUBUUUUUUUUUUUUBBBUUBBUUUUUUUUUU
BBBUBUUUBUUBUUUBUBBBBBUUUUUUBUUUUBUUUBUUUBBUUBUBUUUUUUUUUBBBUUUUBUUBUBBBUUUUUUUBBUUUUUBBUUUUUUUUBUUUU
UUBUBBBBUUUUUUUBUUBBUBUUUUBBBUBUBUBBBBUBUUBUBUUUUUBBUUUUBUBUBUUUUBBUUUBUUUUUUUBBUBBUUUBBBUBBUBUUUUUUB
UBBUUBBUBUUUUUBBUBBUBUUBUBUUBBUUUBUUBBBUUUBBUBUBBUUUUBBBUUUUUBBBBUBUUUUUUUBUUUUUBBUUUUBUUUUBUUBUUUUUB
BUUUBUUUBUUUBUUBUBUUUUBUBBUUBBUUUUUBBUUBUBUUUUUUUUUUUUBBBUUUBUUBUBUBUBUBUBBUUUUUBUBUUUUBUBBUBUUUUUUBU
UUBUBBUBBBUUUBUUUUBUUUUUUBBBUUUUBUUUUUUBUUUUUUBUBUUBUUUBUUUBUUUUUUUUUUUBUUUUUUBUUUBUUUUUUUUUBBUUBUUUU
UUUUBBUBUBUUBBUBBUBUBBUUUUUUUUUUUUUUUUBBUUUBUBBUBBUUUUUUUUUUUBUUBBBUBUUUBBUUUBBBBUUBUUBUUUUUUUUUBUBBU
BUUUBBUUBBBUUUUUUBBBUBUBBUUBBUBUUBBUUUBUUUUUUBUUBUUUUBUUUUUUUUUUBUUUUBUBUBUUUUBUUBUUUBUUUBBUUBUUUUUBU
BUBBBBUUUBUUUUUUUUUUUUUBBUUBUUUBBBUBUUUBUUUBUBUUUBUBBUUUBBBUUUBUUUUUUUUUUBBUUUBUBUUBUBUUBUBUUBBUBUUBU
UUUUBUBBBUBUUUBBUBUBUBBBBUUUBUUBUBUUUUUUUUBUUUUUBBUUUBUUUUBUUBUUUUUBBBUUUUBBUUUUUUUBUUBUUBUUUUUUBUBUB
UUUUUBBUUUUUBBBBBUBUUBUUUUBUUUUBBBBUUBUUUUBUUBUUBUUUUBUUUUBUBUUUUUBUBUUUUUUUUUUBUBUUBUUBBBUBUBBBUUUUU
UUBBUUUUUBBUBUUUUBUUBBUBBBUBUUUUUBUUBBBUUUUUBBUUUBUBBBBUUUUUUUBUBUUUUUUUBUUUUBUBUUUUUUBBBBUUUUUBBBUBB
UUUBUUUBUBUBBBBUUUBBBBUBUUUBUBUBUUUUUUUUUUUUUUUBBUUUBUUUUUUBUUUUBUBUUUUUUUUUBUBUUUUBUUUUUUUBUUUUUBUUB
UUUBBBUBBUBBUUUBUUUUUUUBUBUBUBBUUUBUUUUUUBUUUUBUBBUBUUUBUBBUBUBUUBUUUBUUUUBUBBBUUUUBUUBBUUBUUUUBBBUUB
UUUBUBUUUUUUBUUBUUBBUBBBUUUUUUBUBUUBUUUBUUBUUUUUUBBBUBBUBUUUUUUUUUUUUUUUUUBUUBUUBBBBBUUUUUUUUUBBUUBUB
UUUUBUUUUUUUUBBUBBBUUBUBUUUBUUUBUBUUBUBUBBUBUUUBUUBUBBBUUUUBUBBUUUBBBUUUBUBBUUBUUUBBUBBUUUBUBBBUBBBBU
UBUBUBUBBUUBBUUUUUUUBUUUUBUUUUUUUUUUBBUUUUUUBUBUBUUUUBBUUBUUUBUUBBUUBUBUUUBUUBBUUUBUUUUUUBBBUUUUUBUUU
UBUBUBUBBBUBUUUUUUBUBUUBUUBUUUBUBUUUUUUUUUBUUUUUBUBBUBBBUBUUUUUUUUUUUBUUUUUBUUUBUUBUUUUUUBUUBUBUBUBUU
UUUBBUUUBBUBUBBBUUUBUUUUUBUUBUBUBBUUUUUBBBUBBUBUUBBUBUBUUBBBUBUBBBBBBUUUUUUUUUBBBUUUUBUUUUUUUUBUBUUBU
UUBUBBUBUBUBBUUUUUUBUUUUBUUUUUUUUUUUUUBUUUUUUUUBUUUUUUBUUUUUUBBBUUUBUUUUUUUUUBUUUUBUUUBBUUBUUUUUUUUUB
BUUUBBUUUUUBUBUUBUUUBUUUUUUBBUBUUUUUUUBUBUUUUUUUUUUUUUUBBBUUUUUBBUUUUBBUUUUUBBUUUUUUUBBUUBBUUUBUBUUBU
UBBUUUBUUUBUUUUBUUUUBUUUBBBBUUBUUUUUUUUUUBUUUUUUUBBBUUBUUUBBUUUBUUUUUUBUUUUUUBUBUUUBUBUUUBUUBBUUUUUBB
BUBUUBUUBBUUUUUBBUUUUUUUBUUUUUUUUUBBUUBUUUBBUUBUBUUUUUUUUBBUUUBUUUUUBUUBBUUUUUBUBUBUUUUUUBUUUBUUUUBUU
UUUBUUUUUUUUBBUBUUBUUUBUUBUUUUUBBUBUBUBBUUBBUUUUUUBBUUUUUUUBUUBUUUUUUUUUBUUBUUUUUUBBUBBBBUBUUUUBBUUUU
BUUUUUBUBUUBUUUBBUUUBUUUBUUUBUUUUUUUBBBUUUUUUUUUUUBUUBUUUUUUUUBUUUUBUBUUUUUUBUUUUUUBUUUUUUUUUUUUUUUBU
UUUBUUUUUUUUUUBBBUUUUUUUUBUUUUUUUUBUUUUUBUBUUUUBUBUUBUUUUBUBBUUUUUUUBUUBBBUUUUUUBUUUUBUUUUUBUBUBUBUBB
UBUUUUBUBBBUUUUUBUUUUUUUUBBUUUBUUUUUBBBUBUBUUBUUUUUUUUUUUUUUBBUBUBUBBUUBUBUUBUUUUBUUUUUUUBUUUBBBUBBUU
UUBUUUUBUUUBBUUUBUUUUBUUUUBUBUBBUUBUBUBUUBBBUUBBBUBBBBBUUUBUUUBBUUBUBUUUUUUUUUUUUUUUUUBUBBUBUUBUBUUBU
BBBUBUUBUUUUUBUUBUUUUBUUUUUUBUUUBUUBUUUUUUUUUBUUUBUUUBBUBUUBUUUUUUUUBBUUUBBUBUUUBUUUBUBBBUUBUUBUUBUUU
UUUBUUBBBUUUUUUUUUBUUUUUUUUUBUUUUBUUUUUUUUUUUUBBBUUUUBUUUBUUUUBBUUBUUUUUUUUUBUBUUUUBUUUBUUUUUBUBUBUUU
BUUUUUUUBUUBUUUUBUUUUUUBUUUUBUBBUBUUUBBUBUBUUUUUUUUBBUBUUUUUUUUBUBUUUUUUUBUUUUBUBUUUUUUUUUUUUUUBBBUUU
UUUUBBUUUUUUUBUBUUUBUBUUUBUUUBBBUBUUUUUUUBUBUBBUBUUUUUUUUUUUUBUUUBBUUUUUBBBUBUUUBUUUUUBUBUUUBBUUBUUUU
BBBUUUUUUUBUUBUBUUUUUUUUUUUUBBUUUUUUUBUUUUUUUUUUBUBUBUUUBUUUUUBBUUBUBUUBUUUUBUUUUBUUBUUUBBUUUUUUUUUBU
BUBBBUUUBUUUUUBUUBUBUUUBUUUBUUUBUUBUUBUUUUUUBUUUUUUBBUUUBBBUUUUUUUUUUUBUBBBUUBUUUUUBUUUUUBUUUUUUUUUBU
UUUUUUUBUUUUUUUUUUUBBUBUBUUUUUUUBBUUUUUUUUBUUBBUUUUUBUUBUUUUBUUUUBBUUUUUBBBUUUUUBBUUUUBUUUUBUBBBUBUUU
UBBBBBUBBUUBUUUUBUUUBBUUBUUUUUUUUUUUUUUUUUUUUUUUUUBBUUUUUBBUUUBBBUBBUBUUUUUUBUBUUUUUUUUBBBBBUUUUUBUBU
BUBUUUUUUUUUBUBUUBBUUUUBUUUUUUBUBUUBBBBUUUUUUUUBUBUUUBUUBUUUUUUUUBBUUUUUBUUUUUUBBUUUUUUUUUUUUUBUBUBUB
UBUBUBUBUUUUUUUUUUUBUBUBBBBBUUUUUUUUUUUUUUUUUUUUUBBUUUUUBUUBBUUUBBUBUUBUUUUUUUUUUUUUUUUUUUUUUBUUUUUBB
UUUUUUUBUUUUUUUBUBUUUUBUUBUUUUBBUBUBUUUBUUUBUUUUUBBBUUUBUBBUUUUBUUUBUUBUBUBUBUUUBUBUUBUBUUUUUBUBUBUUU
UUBUUUBUUBBBBBUUUUUUUBBUUUUBUBUUUUUUUBBUUUUBUBBBBUBBBUBUUUBUUUUUBUBUUUUUBUBBUBUUUBUUUUBUUUUBUUUUUBUUU
BUUUBUBUUUUUBBUUUUUUUUBUUUUUUUUUBBUBUBUBUBUUUUUUUUUUUUUBBBBUBUUUUUUUUBUUUUUBUUBBUUUUUUBUUUUUUUUUBBUUB
UUUBBUUBBUUUUBUUUBBUUUUBUUUUBUUUUBUUUUBUUUUUUUUUUUBUUUUUBBUUUUBBUUUUUUBUBUUUUBUUUUUUBUBUUUBUUUBUBUUBU
UUUUBBUBUUUUUBUBUUUUUUUUBUUUUUUUUUBUBUUBBUUBUUUUBUUUUUUBUUUUUUUUUUBBBUUBUUBUBUUBUBUUUUUUBUUBBUUBUUUUB
UUUBBUUUUUBBUUUUUUUUUUUUBUBBUUBUUUUBUBUUUBUUBBUUBUBUUUUBBBUUUBUUUUUUUUBUUUBUBBUUUUUUUUUUUUUBBUBUBUUUB
UBBBUUBUUBUUBBUUBUBUUUUBBBUBBUUUUUBUUUBUUBBUUBBUUBBUUUUBUBUBUUBUUBUUUBUUBUUUUBBUUUUUUUUUBUBUBUUUBUBBU
UUUUUUUBUUBUBBUUUBBBUBUBUBUBUUBUUBUBUBUBUUUUUUUBBBUBUUUBUUBUUUUUUUUUBUBBUUUUBUBBBUUUBUUUUUUUUUUUUBUUB
UBUUBUUBBUBBBUUUUUUUBUUBBBUUUBBBBUUUBUUUUUBUUBBBUUUUBUBUUUBUUBBUBBUUUUBUBUUUUBBUUUUUBBUUUUUBBUUUUBUBU
UUUBBUBUBUUUBUUUUUUUUUUUUUUUUUUUUBUUUUUBBUUBUBUUBBUUBUBUUUUBUBBBUUUUUBUUUBUUUBUUUBUUUUUBUUUUUBBUBBBUU
BUBUUUBUUBUBUUUUUUBUUUBUUUBUUBUUUBBUUUBUUUUUUUUUBBBUUBBUUUUUUBUUUUUUUBBUUUUUUUUUUUUUUUUUUBUUUUBUBUUBU
UUBBUUBBBUUUUUBUUUUUBBUUUUUUUUUUBUUBBBUUUUUBUUBUUBUUUUBBUUUUUUBUUUUUUBBUUUUBBBUUUUBUBUUUUUUBUBUUBBUUU
UUUUUUBBUUUUUBUUUUUUUUBBUUUBUBUUUUUUBUUUUUUUUBUUUUUUUUBUBBUBUBUUBUUUUBUUUUUUUBUBBUUBUUUUBBUUUUUUUBUUB
UUUUUUUUUUUUUUUUBUUUUUUUUUUUUBBBUUUUBBBUUUBUUUBUUBUBBUUBUBBUBUUUUBBUBUBBUUBUUBBUUUUBUUUUBUUUBUUUUUUBU
UBBUBUUUUUUUBBBBUUUBUUUBUUUUUUBUUBUUUUUUBUUUUUUUUBUBUUUUUUBUBUBBBUBUBBBBUUUBBBBUUUUBUUBBBUUUUUUBUUUUB
UBUUUBBUBUUUUBUUUUUBBBBBUBBUUUBBUUUBBBBUUBUUBUBBBBUUBBUUUBUUUUUUBUBUUUUUUUUUBUUUUUBUBBUUUUUBUUUBUBBBU
UBUUUUBUBUUUUBBBUUBUUUUBUBUUUUUBUUUUUUBUUUUBUUUUUUUBUUBUBUUBUUUUBBUUUBUUUUUUBBUBUUBBUUBUBBUUUUUUUBUBU
UUUBUUUUBUUUBUBBUBBUUBUUUUBBBBUUUUUBUUBUBBBUUBUBBBUUUBUBBBBBBUUUUUUUUBUUBBUUUBUUUUBUUBUUBUUUUUBBUUUUB
UUUUUUUBUUBUBUBUBBUUUUUUBUUUUUUBUBUBUUUBUBUBUUUBUBUUUUBBBUBBUUBUUUBUUBUUUUBBUUUUUUUBBBUBUUUUBUUBUUUUU
UUUBUUUUUUBUBBUBBUUBBUBBUBUBUUUUBUUUUBUUUUUUBBUUUUUUUUUBBUUBUBUUUUUUUBUBBUUUUUUBUUUUBBBBBUUUUUBUUUUUU
UUUUUBBBUBUUBUUBUUBUUBUUBUBBBUUUUBUUUBBUUBUUUBBUUUUBBUBUUUUBUUUUUUUUUUUUUUUBUUUUUUUUUBUBUUBBUBUBBUUBB
BUUUBUUUUUUUUUBBUBBBUBUUUUUBUUUBUUUBBBBUBUUUUUUUUUBUUUUBBUUUUBUUUUUBUBUBUUUBBUUUUUBBUUUUUUUUUUUUUUBUU
UUUUUBBBUUUUUBUUBUBUBUUUUBBUUUBBUUUBUUUUBUUBUUBUBUUUUUBUUUUUUBUUBBUBUUUUUUUUBUUBUUUUUBUBUBUUBUBBUUBUU
UUUUUUUUUUBBUUUUUBUBUUUUUBBBUBUUUBUUBUBBUUUBUUUUUUUUUBUUBUUBUUUUBUBBUUUUUBUUUUBUUUUBUUUUUUUUUUBUUUUBU
UUUUUBBUUBUBUUBBBUUUBUBUUBUUUUUBBUUBUUBUUUUUUBUUBUUUUUUUUUUBBBUUBUUBUBBUBUUUUUUUUUUBUBUBUUUUBUUUUBUBU
UUBUBBUUUUUBBUBUUUBUUUUUUUUBUBUUBUUBUUUBUUBUUUUBUBUUBUUUBUUBUUUUBUBUUUUBUUBUBUBUUBUUUBUUUUUUUBUUUUBUU
UUUUUBUUUUBUBBUBUBUUUUBUUUBUUUBBUUUUUBUBUBUUUBUBBUUUUBUUUUUUUBUUUUUBBUBUUUUUBUUUBUUUUBUUUBBUUUBUUBBBU
UUUBUBUUUBBBUUUUUUBUUUUBBUUUBBUBUUUUUUBBUBUUUUUUBUUUBUBUUUUUUUUUUUBUBBUUBUBUBUUBBBUUUBUBBUUBUUBBUUBBU
UBUUBBUUUUUUUUUUUUUUUUUBUUUBBUUBUBUUBUUUBBUUUUUUUUUUUUBBUUUUUBUUUUBUUBUBUBUUBUUUUUBUUBUUUUBUBUUUUUUUB
UUUUUUBUUUUUBUUBUUUUBUUUUBUUBUUUUUBUUBUBUBUUUUBUBUBBUUBUBUBBUBBBUUBUUUUUUUUUUUUUUBBUBUUBUBUBBUUUUBBUU
BUBUUUUUUBBUBUUUUUUUUBBUUBBUUUUBBBBUUBBUUUUBUUBUUUUBUUUBBBUUBBUUUBUBBBUUUBUUBUBBUUBBUUUUUUUUBUBUUUUUB
BUUBBUBBBBBBUUUUUUUUBUUBUUUUUUUBBUUBUUUUUBUUBUUUUUBUUUBUUBUBUBBUBBUUBBBBUUUUBUUUUUUUUUBUBUUUUUBBBBUUB
UUUUUUBUUBBUUUUUUUUUBUBUUBUUUUUUBUUUUBBUBUBUBUBUBBUUBUUUUUUUUBBBBBBUBUUUUUUUBUBUBBBUUUUUUUUBBUUUBUUUU
UUUBUBUUUUUUUUBBUUUUUUUUUUUUUBUUUUUUUBUUUUBUBUUUBUUBBUBBUUBUBUBUBUUUBBUUUUUUUUUUUUUUUUUUBUUUUBUBBUUUB
BUBBBUUBUUUUBBUBUUUBUUUUUUUUBBUUUUBUUUUBBUBBUUBBUUBUBUUUBUBBUUUBBUUUUUUBUUUUBUBBBUBBUUBBUUUUUUUUUBUBU
UUUUBUUUBUBBUUUBUUUUUBUUBUUBUUUBUUUBBBBBUBUUBBUUBBUBUUBBUBBUBUBUBBUUUUBUUUBUBUBUBBUUUUUUBBBUUBUBUUUUU
UUBUBBUUUBUUUUBUBUUBUBUBUUBUUUUUUUBUBUBUBUUBUBUUUUUUBBUUUUUUUUUUUBUUBUUBUUUBBUUUBUUUUBUUUUUBBUBUUUUBU
UUUUBBUUUUBUUBBUUUUUUBUUBUUUUUUUUUUUUUUUUUUUUUUUUUUBUUUUUUUBUUBBUBUUUUUBUUUUUUUUUUUUUUUUUUUUBUUUUUUBU
UBUUUBBUUUUUBBUBUBUUUUUBBBUUUBBBUUBBUUUUUBUUUUUUUUUBUBUUUBBUUBUUUUUBBBUBUUUUBBUUUUUBUUBBUUUUUUBBUUBBU
