UUUBBUUBUBBUUUUBBBBUUUBBBUUBUBBUUBUBUUUUBUUUUUUUUUUBUBBBUBBUBBUBUBUUBUBUUBUUUUBBUUBUUUUUUBUUUUBUBBUBB
UBUUUUUUUBBUUUUUUUUUUUBUUUBUUUBUUUUUUBUUUUUBUBBUUUUUUUUBUBUUUBUBBUUUBBUBUUUUUUUBBBUUBBBUUUUUUUBBUUUUB
UBUUUUUBUBUUUBUUBBUBUUBUUUUUBUUUBUUUUUUUUUBUUBBUUBUUBUUUUBBUBBBBBBBUUUUUUBUUUBUUUUUUUBBUBBUBUBBUUBUUU
UBUBBBBUBUUUUBUUBUBUUUUUBBUUUUUUUBBUBUUBUBUUBUBUUBUBBUUBUUUUUUUUUUUBUBUUUUBUUBUBUBUUUUBUUUUBUUBBUUUUU
UBUUUUUBBUUUUBBBBBUBBBUUBUUBUUUUUBUUUBUUUUUUUUBUUUBUUUUUUUBUUUBUUUUUUBBUBUUUUUUBBUBBBUBUUUUUUUUUBBUBU
UUUUUUUUUUUBUBUUUBBUUBUUUUUUUBUUUBUBUBUUBBUUUUUBUBUUUUUUUUUBUBUUBBUUUBBUUUBBBUUBBUUBUUBUUUUUUBUUBUUUB
UBUBUUBUBUUBUUBUBUUUUUUUUUBUUBUUBUBUUUBUBUBUBUUBUUUBBBUBUUUUBUUUBBBBBUBUBUUUBBBUUUUUBUUUUBUUBUBUUBUUB
BUUUBBBUUUUUUUBUBBUUUBBBBUBUUUUBUUBBUUUUBBUBUBUBUUUUUBUUBUUUBBUUUUBBUUBUUBUBBBBBUUUBBBBUUBUUBBBBUUBBU
UUUBUBUUUBUUUBUUBUBBUUUBUUBUUUUUBUUBUUUBBBUUUBBBBUUBBBUBUUUBUUUBUUUUBUUBUUUUUUUUUUUBUBUUBUBUUBBBUUBUU
UUUUBUUUUUUBUBUBUUBBBBUUUUUUBUBBBBUBUUUUUUUUUUBUUUUUBBUUUBUUUUUUUUUUUUBUUUUBUUUUUUUUUUUUUUBBBBUBUBBUU
UBUBBUUUBUUUUBBUUUBUBUBUBBUBUBUUUUUBUUBBBUUUUUUUBUUBUUUBBBUBUUUBUBBUUBBBUUUUBUBBUBBUUUBUUUUUUBUBUBBUU
BUBUUBBUUUUBUBBBUBUBUBUUUUUBUUUUUBUUBBUBUUBBUUUBUUUUUUUBUUBBBUUUBUBBUUUBBUUBBBUUBUUBBBUUUUUUUUUUUBUUU
UUUUBBUBBBBBUUUBUUUUUUUUBUUBUBUBUUUUBUBBUBBBUUUUBUUUUBUUBUUUUUBBBUUUBBUUUUUBUBUUUBBUUUUUBUUUUUUUUUUBU
UBUUUBUUUUUUUUBUUBUUUBUUBUUUBUUBBUBBBUUUUUUBUUBBUUBUUUBBUUUUBUUUBUUUUBUUBUUUUBBUBBUUUUBUUUBUUBUUBUUUU
UBUBUBUUBUBUUUUBUBBBBUUBUUUUUUUUBUUBUBUUBBBUUUBBBUBUBBBUUUUUUUUUUUUUBUUBUUUUUBUBBUUBUBUBUBBBUUBUUUUUU
BBUUUUUUUUBUUBUUBUUBUBUUBUUBUBUBUUUBUBUUBBBUUBUBUBBUUUUBUUUBBUUBUBUUUBBUUUUUUUUUBBUUUUUBBBUUUUUUUUUUU
UBUUUUUUBUUUUUUUUBUBUBUUUUUUUUBBUBUUUUBUUBUBUBUUUUUUBUBUUUUBBUBBBUBUUBUBUUUUBUUBUUUUUUUBBUBBUBBUBUUUU
BBBUUUUUBUUUUUBUUBUBUUBBUUUUBUUBUUUUUUUUUBBBBBUUUBUUUBUUUBUBUBUBBUUUBBUUUUUUBUUBUUUUUUUUBUUUUUUUUBUBU
UUUUUUUBUBUUUUUUUUBBUBUUUUUBUUUUUUBBBUUUBBUUBUBBUUUBBUUUUBUUUUBBUBBUBUBUUUUUUUUUBBUUUBBUUUBBUUUBUBUUU
UUUUBUUUUUUUUUUUUUUUUUUBUUUUUUUUUBUUBBUUUBUUUBUUUUUBUBUUUUUUUUUUUUBBUUUBUBBUBUBUBUBUBBUUUUBUUUUUUUUUU
BUUUUUUUBUUBUUUUBUBUUUUBUUUUUUUUBUUBUBUUUBUBUUUBUUUUBUUBUUBUUUBUUUBUUBUUUUBUUUUBUUBUUBBUUUBUUUUBUUBUU
UUBUUUUUUUUUUUUUUUUBUUUUBUUUUUUUUUUUUUUUUUBUUBUUUBUUUBUUUBBUUUBBUUBUUUBBUUUBUUUUUUBBBUBUUUBUUUBUUUUBU
UUUBUUUUUUUUUUBBUUBUUBBUBBUUUBBBUUBUUUUUBUUUBUUUBUUUUUBBBBUUUBBUUUBUBBUUUBUUBUUBBUUUBUUUBUUUUUBUUUUUU
BUBUBUUUBUBUUUBUUUBBUUUUUUBBBUUBBBUBUUUUUUUUBUBBUBUUBBUUUUBBBBUUBBBUUUUBUBBUBUUUUUBUUBUUUUUUUBUBUBUUU
UUUUBUUUUUBUUUUBUUUUUUBUBUUUUUBUUBUUUUBBUBUUBBUUUUUBUUUBBBBBUUUUBBBUBUUUUBBUUUUUUUUUBBBUUUBUUUUUUUUUU
UBBUUUUBUBUUUUBUBBBUUUUUUUUUUBBUUBBUUUUBUUUBBUUBUBBUUUUUUUBUUBUUUBUUBUBBUUUUUUUUUUUUUUUBUUUUBUUBUUUUB
UUUUUUUUBUUUUUBUUUUUBUUUBUUUUUUUUBBBUUUUUUUUUUUUUBUBUUBUUBBBUBUUUBBUUUUUBUUUUUUUUUUUUBUBBBBBUUBUUUUUU
UUUUBUUUBBUUUUUBBBBBUUUUUUUBUBBUUUUUUBBUUBUUUUUUUUUUUUUUUBUBUUBUUUUUUUBUUBUBUUUUUUBUUBUUUUUUBUUUBBUBU
UUUBBBUUUUUUBUUUBUUBUUUUUUUUBUUUUUUUUUUUUUUUUUUUUBUUBBBUUBUUUUUUUUUBBBBUUUBBUUUBUUUUUUUUBBUUBBUUUBUBU
BUBUUUUUBBUUUBBBUUUUBUBBBBBUUUUUUUUUBUUUUUUBUBUUBUUUUBBBUBUBUUBUUUUBBUUUBUUUUUUUUBUBBUBBUUUUUBUBUUUUU
UUUUUUUBUBUUUBUUBUBUBBBBUBUBUUUUUUBBUUUBUBBUBUUUBBUBUBBBBUUUBUUUUUUBBUUUUUUUUUUUUUBUUUUUBUBBBUBBUUUBU
UUBUUUUUUBBBUBUUUUBUBUUUUBBUUUUUUBUUBBUBBUUBUUUUBUUUUBUUUUUUUBUBUBUUUUUUBBBUBBBUUUUUUBUUBBUBUUUUBBUUB
UBBUUUUBBUBBUUBUUUUUBUUUUUBUUUUBBUBUUBUUUUBBBUUUUUBBUBUUBBBBUBUBUUBUBUUUUUBBUUUBUUBUBUUUUBBUUUBUBUUBU
BUBUUUUUBBUBBUUUBUUUUUUUUUUBUUBUBUBUUBUUUUBUBUUUBUUBBUUBUBBUUUUUBUBUBUUUUUUUUUBUUUUUUBUUUUUUBUUUUUUUU
UUUUBUUUUBUUUUUBUUUUUUUBUBBUBBUUUUUBUUUBUUUBBUUBBUUUUUUUUUBUUUBUBBUUUUUBUBBUUBUUUUUBBBUUUUUUBUUUUBUUB
UBUUUUUUBUUUBUUUUUBBBBUUBUUBUBUUUUUUUUUBUUUUUBUUUBUUBBBUUBUBBUBBBBBBUUUUUUUUBUUBUBBBUUUUUBBUBUUUUUUUB
BUUUBUUUUUUUBUUUUUBBUBUUUUBUBUUUBBBUUUUUBUUUUBUBBUUBUBUUBUBUUBBUBUUUBUUUUUBUBUUBBBUUUBBUUUBUUUBUUUUUU
UUUUUBUUUBUBUUUUBUUUUUBBBBUUBUBUUUUUBUBUUUUUUUUUBBUUBUUUBUBUUUBBBUUBBBBUBBBUUUBUUUBBUUUUUBUUBBBBUUUUU
UBBBUBUUUBUBBBUBBUBUUUUUUUBBBUUUUUUUBUBBUUUUUUBUUBUUUUBBUUUUUBUBBUUUBBUBBBUUUUBUBUUBUUUUUUUUUUBBUUUUU
UUUBUUUUUBUUUBUUUUBUUBBUUUUUUUBUBUBBBUBUUBBUUBBUUBBUUUUUUUBBBUBBUBUUUUBUUUBUUBUUBUBUUBBBUBUUUBBBUUUUU
UUBUUUUUUBUUBBUUUBBBUUBUUBUUBUUBUUUUUUUUUUUUUBUUBBUUBBUUBUUUUUUUUUUBBUUBUUBUUUBUUUUUUUUUBUUUUUUUBUBUB
BUBBUBUBBUBUUUUBBUUUBUUBUBBUBBUUUUUUUUUUUUUUBUUUUBBBUUUUUBBUBUUBUBUUUUUUUUBUBUUUUUUUUUBUUUBUUBBUUUUBB
UUUUUUBUUBUUUUUUBBUUUUBUBUBUUUBBBUUBUUUBUUUUUUUBBBBUUUUUUBUUUUUUUBBUUUBUUUUUBBUBUUBUUUUUUUBBUUUUBBUBU
BBBUUBBUBUUUUUBUUBUUUUUUUUBUBUUUBUUBBBBBBUUBUUUBBUBUUBUUUUBUBBUUUUUUUUUUUBUBUBUUUBBUUUBUUUUUBUUBBUUUU
UBUUBUBBUBUUUBBUUUBBBBUUUUBBUBUUUUUUBUBUBUUBUUUBUBUUBUUUUUUUUUUUUUUBUBUUBUUUUUUUUUBUBBUBBUUUUUUBUUUUB
UUUUUBBUBBBUUUBBUUUUUBUUBUBBBUUUUUUBUUUUBBUBUUUUUBUUBUBBBUUUBUUUUUBUUUUUUBBUBUBBUBUUBUUUBUUUUBBUUBBBB
UBUUUUUUUUUBBUUUUUBUUUBUBUUUUUUUUUUUUUBBUUUUUUUUBUBBUUUBBUUUUUUBBUUUBUUUBBBUUBUUUUUUBUUUBBUBBUUUUBUBB
UUUUUUBBBUUUUUUBUUUUBUUUUUUUUUBUUUUBUUBBUUBUBUBUUUUBBUUUBBUUUUBUUUBUUBUUUBUUBBUUBBUUUUBUBUBBUUUUUUBUU
UUBBUBUUUUUUUUBBUUBBBUBUBBUUUUUUUBBUUUUBBUUUUUBUUUBUUUUUBUUBUUUUUUBUBUUUUUUUUBUUUUUUBBUBUUUBUUUUUUUUB
BUBUUUUUUUUUUBUUUUBBUBUBUUUUUUUBBUUUBUUUBBBBUUUUUBUUUUUUUUUBUBUBBUUUUUUBUBUBBBUUUUBBBBBUUUUUUUUBUUBUU
UUBUUBUUUUUBBUUUBUBBUUBUUUUBUUUUUUBUUBUUBUUUUUUUUBUBUUUUBUUUBUUUBUUUUUUBUUUUUBUUUUUUUUBBUBBUUUBBBUUUU
UUUBUUUUUUUBUUUUBUUUUUUUBUUUUUBUBBUUUUUUUBUUUUUUBUUUUUUUBUUUBUBUBBBUBUUUUUUBBBUBBUBUUUUUUUBUUUUUBUBUU
UBUUBBBBUUUBBUUBUBBUBUUUUUUUBUUBBUUUUUUBUUBUUUUUBUBUBUUBUBUUUUBUBBUBUBUUBBUUUUUUUBUUUUUUUBBUUBUUUUBUU
UBUUBUUUUUBBUBBBBUUUBUUBUBUBUUUUUUUUBUUUUUBBUBUUBUUBBUUUBUUUUUBBUUBUUUUUUUUUUUUBBUUBBUUUBUBUBUBBBUBUU
BUBBBUUUUBBUUUUUUUUUUBUBUUUBBUUBBUBBBUBUUBBUUUUUUUUBBBUUBUBUUUBBUBUUUUUBBUBUUUBBUUBUUBBBBUUUUBBUUUUUU
UUUUUUUUBUUBUBUUUUUUUUUUUUUUUUUUUUBBUUUBUUBUUUBBUUUBBBBUBUBUUUBUUUUBUUBUUUUUUUUUUUBUUUUUBBBBUUUBUUUUB
UUBUUUUBUBBBUUUBUUUUUUUUUBBBUBUBBUBUUBUUUUUUUUBBBBUBUUBBUUUUBUBUUBBUUBUUUUBUUBUUUBUUUUUUUUBUUUUBUUUUU
UUBBUBBUUUUUBBBBBUBUUUBBUUUUBUBUBBBUUUBBUBUBUBUUUUUUBUUUUUBUUUBUUBUUBBUUBUUUUUUBBBBBUUUUUUUBUUUUUUUUB
BUBBUUUUBUUBUUBUBUUUUUUUBUUUUUUBUBBUUBBUUUUUUBUUUBUUBBUUBUUUBUUBBUUUUUUUUUUUBUUUBUBUUUUBBUUUUBBUBUUBB
UUUUUUUUUBUUUUUBUBUUUUUUBUBUUBUUBUUUBUBBBBBUUUUUUUUUBUBUUUBUBUUUUBUUUUUUUBUBUUUUUBUUBUUUBBBUBBBUUUUBU
UUBBUUBUBUBUUBBUUUUBUUUUUBUUUUUBUBBUUBBBUBUBUUUBBUUUUUUBUUBBBUUUUUBUUUUUUBBUUBUUUUUUBUUBUUUUUUUBUBUUB
BUBUUUUBUBBUUUUUUUBBBUUUUUUUUUUBUBBBBBUUBUUUUBUUUUUBUUBUBUUBUUUBBUUUUUUBUUUUUUUUUBUBUUUBUBUBUUUUUUBBB
UBUBBBUBUUUUUUUUUUUBUBUUUUUUUUBUUUBUUUUUUUBUUUUUUUBBUUUUUUUUUUUUUBUBBUUBUUUBBUUUUUBUBUUUBUBUUUUUUUUUB
UUUUUBUUUUUUUBUBBUBUUUBUUUUBUBBUBUBUBBUBUBBUUUUUUUUUUBBUUBUUUUUUUUUBUUUBUUUUUUUBBUBUUUUUUUUBUUUUUUBUU
BBUBUUUBUUBUBUUUUUUUBUBUUUUBUUUUUBUUUBBUUBBUBUUUUUBUUUUUBBUUUUUUUUBUUBUBUBUUUUUUUBBUBBBBUUUUBBUUBUUUU
BUBUUBBUUUBBUBUUUBUUUBUUBBBBUUBBBUUUUUBUUUUUUUUUUBUUUUUUBUUBBUUUBUUUUUUUUBUUUUBUBUUBUUUUBBUBUUBUUUUBU
UBBUBBBUBUUUUBUUUUBUUUUUBUUUUUBUUUUBUBUUUUBUBUUUUBUBUUBBBUUBUBUUBUUBBBUBUUUUBUUBUBBUUBUBUBBUUUUUUUBUU
UUUUUUUBUUBUUUUUUUBBBBUBUUUUUBBUUUBUUUUUUBUUUUBUUBUBUUUBBUBUUUUBBUBBUUBUUUUUUBUUUBUUUUUUUBUBBUUUUUUBU
UUUUUUUUBBUUUBUUBUBUUUBBBUUUUUUUUUUBBBBUUUBUUUBUUUBBUUUBUUUUUUUUBBUBUBUUUUUBUUUBBBBBUUBUUUUUBUUUUUUBB
BUUUUUBBUUUUBBUUBUBUUBUUUUBBUUBUUUBUUUUUBUBUBUBBUUBUBBUUUBBUBBUUBUUBUBUBUBBBUBBUBUUBUBBBUBUBUUUBUUUUU
UBUUUUBUUUUUUBBBUUUUBBBUUUUUUUBUBBUBUBUUBUUBUUUBUUBBUBUUBBUUUUBUUBUUBUUUUUUUUUUBUBUUUUBUUUBUUUBUUBUUB
UUUUUUUUBUUBUUUUBUUUUBUUUUUUUBUUUUBUBUUUUUUUUUBBBUUUUBUUBUBUBUBUUBUUUBUUUUUUBBUBUUUUBBUUUUBUUUBUBUUUU
UUUUBBUUUBBBUUUUBUUUUUUUUBUBUUUUBUUBBUBUUUUUUBUUUUUUUUUUUUUBUBBUUUUUUUBBUUUUUBUUBBBUBUBUUUBBUBBBUUBUU
BUUBUUBBUUBBUBUUUBUBUUBUUBUBBUBUUBUUBUBUUUBUUBUUUBUUUUUBUUUUUBUUUBUBBUBUUBBBBUUUUUUBUUBUUBUUUBBUUUUUB
BUBBUUUBUBUUUUUBBUUUUUBUUBUBUBBUUBBUUUBBUUUUUUUUBBUUUUUUUBBBUUUUUBUUUBUBUBUUUUUBUUUUUBUUUBUBUUUUUUBBB
UBUUUUUUUUBUUBUUUBUUBUBUUUBBBUUBUUUUUBUUUUUBUUUUUUBUUUUUUBBBUUBBUUBUUUUUBUBUUUUBUBUUUUUUBUUBUUBUBUUBU
UUBBUBUUUUUUUUUUUBBUBBUUBUUBUBBUUUUBUUBBUBUUUUBBUUUUUBUBUUUUUBBBUUBUUUUUBUUUUUUUUUBUUUUBUBBUUUUBUBBUU
UUBUUUBUUUBUUUUUUBUUUBUUBUBUUBUUBBUUUUUBBBBBBUBBBUUUUBUUUBUBUBUUUBBUUUUUUUUUUUUUUBBUBBUUUUUBUUBUUUUUU
BUBUUUBUUUUBUUUBUUBUUUUBUBUBUUUUUUUUBUUBBBBBBBUBBUBBBUUUBBUUUUBBUUUUUUUUUUUBUUBUUUUBUUUUUBBUUBUUUBBUU
BUUUBUUBBUUUUUUUBUBUBUBUUBUUBBUUUBUUBUBBUUUUBUUUUUBUUBUUUBBBUUUUUUUUUUBUUUUUUUUUUUUUUUBUUUUUUUUBBUBUB
UBUUUUUUBUBUUUBUUBUBUBUBUBUBUBUUBUUUUUUBUUBBUBUBUBUBBUUUBUUUUUUUBUUUUUUUUUBUUUUUUBBUBUUBBBBBUBUUUUUBU
UBBUUBBUBUUBUUBUBUUUBUUBUUUBBUUUUUUUUBUUBUUUUUUUBUBBUUUUUUUUUUUBUUUBUUUUUUUBUUUUUUUUUUBUUUBBUUUBUUUUB
UUUBBUUUBUBBUUUUUUBUUBUBUUBUUUUUUUBUUUBUBUUBUUUBUUUBUBUUUUUUBUBUUBUUUBBUBBUBUUBUUUBUUBBUBUUUBUBUUUUUB
UUUBUUUBUUUUBUBUUUBUBBUUBBUBBUUUBBUUUBUBUUUBUBUBBBBUUUUBUUUUBUBBUBUUBBUBUUUBUUBBUBUUUUBUBUUBUUUUUUUBU
UUUUBUUUBBBUUBBUUUUUUUBUBUUUUBUBBUBUUBBBUBBBUUUBUUUBUUUUUUUUBBUBBUBUUUUUUBUUBBUUUUUUUUBUUUBUBBBBUBUUU
BUUUUUUUBUUBUUUUUUUUUBUUBUUUBBUBBBUBUUBUBUBUBUUUUBUUBBUUUUUUBUBBBUUUUUBBBBUUBUBBBUUUBUBBUUUUUUBUUBBBB
UBUUUUUBUUBUBUUUBUUUUUBUUUUUUUUUUUUBBUUUUUUBUUBBUUUBBUBUUUUUBUUBBUUBUBUBUUBBUUUUUUBUUUUUUUUUUUUBUUBBU
UUBUUUUUUUBUUUUUBUBBBUUUUBUUUUUBUUUUUBBUUBUBUUBUUUUUUBBBUUBUBBUUBUUUUUUBBUUUBUBUBUUBBUBUBUBUBUUUBUUBU
UBUBUUUUUUUUUUUUBUUUUUBBBUUUUBUUBUUUUBUUUBBUBBBUUUUUUUUBUUBUUBUUUUUUUUBBBUUUUUBUUUUUUUUUBUUUUBBUUBUUU
UBUUUBBUUBUUBUUUUBUUUBBUUBUBUBBUBUBBUUUBBBBUUUUUBUBUBUBBUBUUUUUBUBUBUUUUBUBBUBUUUUUUBBBUUUBUUUUUUUBUU
UUBBUUUUUUUBBBUUUBUBBUUUUBBUBBUUUBUUUBBUBBBBUUUBUBUUUUBUUBBUUUBUBBUUBBBBBUUUUBUUUUBBBUBBUUUUUUUBUUUUU
UUUUUBUUBBUUBUBUUUBUUUUBBUUUBBBUBUUUBUUUBUUBUBUUUUUBBUUBBBUBUUBUUUUUBUBBUUUUUBUBUUUUUUUUUBUBUBUUUUBUB
BUBUUBBUUUUUUBUBUUUBBUUUUUBUUUUUUBBBUUUUBUUBUBUUUBBUUUUUUBBBUUUUBUUUUUUUBUUUBBBUUUBUUUUBUUUUUUUUUUBUU
UUUBUUUUBUBUUUUUUBUUBBUUBUBUUUUUUUUUUUUBUUUUUUUUUUUUUUBBUUUUUUBUUUUUUUUBUUBUUUUUBUBUUBUUUUUBUBUUBBUBB
BUUUBBUUUUBUBUUUUBUUUUBUUBUBUBBUUUBUUBBUUUBUUBUUBBUUUUUUUUUUBBUBUUUUUBBBUUBUUUBUBBUUUUUUBBUUUUUBUUBUB
UUUUUUUUBUBBUBUUBUUBBBUUUBUBUBUUBUUBUUUUBUUUBBUBUUUBUUUUUBUUUUBUUBBUBUUBBBUUUUUUUUUUUUUUUUBUUBUUBBUBB
UBUUUUUUBUUUBUUBUUUUBUUUBUBUUUUBBUBBUUUBUBBUBBBUUUUUUUUUUUUUUBUBBUUUBBUUBUUUUBUUUBUBBUUBUUUUBBUBBUBUU
UBBUUUUUUBUBUUBUBUUUUUBUUUUUUBUUUBBBBUUUBBUBUUBBUBBBBBUUBUUUBUUBBUBUBUUUUUBUUUUUUUBBUUUUUUUUUUUUUBBUU
UUUBUUUUUUUUBUUUUUUUBUBUUUBUUUBUUBBUBUUUUUUBBUUBUUUBUBUBUUUBBUUUBUUUUUUUUUUUBBUBUBUUBUUBUUBUUBUUUBUUU
UBUBUUUBBBBUUUBBBUBUUUUBUUUUUUUBBUBUUUBUUBUUUBUBUUBUUUUBUUUBUUUBBUUUUUUUUBUBUBUBBUUBBUUUUUBBUUUUUBUUU
BUUBUUBBUBUBBBUBUUUBBUUBBUUUBUUUUUUUBBUUUBUUUBUUBUBBUUUBUUUUUUUUBUUUUUBUUBUUUUBUUUBUUBUBUBUUUUUUUUUBU
