UBBUUUUBBUUUUUUUUUUBUUUBUUUBUBUUUBBUUUUUUBBUUUUUUBBBUBUBUBUUUUUUBUUUUBBBUBBUUUUUBUUUUUUBUBUUUUUUBBBUU
UUUUUUBUUBUBUUUUUBUUUUUUBBUUUUUUBUBBBUBBUBUUUUUBUBUUUBBUUBUBBBUUUUUUUBUBBBBUBUUUUBBUUUUBUBBUBBUUUUBUU
UUBUUUUBUBUBUUBUUUUBUUBUBBBUBBUUUUUUUUUUUUUUUUUUUUUBUBUUUUBBUUUUUUUUUUBBUUUBUBUBBUUUBBUUUUBUUUUUBUUUU
UBUUUUUUUUUUUBUUUUUUUUBUUBUUUUUBBBUUUUUUBUBUUUUUUBUUUUUUUUUUUUUBUBBUUUUUUUUBUUUUUUBUUBUUUUUBUUUUUBBUU
UUBUUUUUUUUUBBUUBUUBUUUUUUUUUUUUBUBUBUUUBUUBUUUBUUBUBUUUUBUUBUUUUUUUUUUUUUUUUUBUBUBUUBUUUUUBUBBUUUUBU
UBBUUBUUUUUUUBBUUUBBBUUUBUUUUUUUUUBUUBBUUUUBBUBUUBUUUBUUUUBBUUUBUBUUBUBUUBUUUUUUUUUUUUBUUUUBBUUBUUUUB
BUBUBBUUUUUUUUUUBUBBUUBBUUUUBUBBBUUUUUUUUUBUBUUBBBBUBUBUUUUBUBBUUBBBUBUUUUBBUBUUUUBBUUUUUBBUBUUUUUUUU
UBUUBUUUUUBBBBUBUUUBBUUUUUUUUUUUUUUBUUUUUBUUBUUUUUUUUUUUUBBBUUBBUUUUBUUUUUUUUUUUUUUUUUUBUUUBUBUUUBUUU
UUUUBBUUUUUUUUBUUBUUUBUBUUBBUUBBUUUBUBUUBUUUBBBUUUBUUUUUUBBUBUBUBBUUUUUUUUBUBBUUBUUBBUBUUBBUBUUUUUUUU
UBUUUUUUUUBUUUBBUBBUUBBBBUUBUUUUUBUUUUUUUBBBBUUBUBBUUBUUUBUBUUUUUUUUBUUUBUBBBUUBUUUUBBUUUUUBBBUUUUUUU
UBUUUBUBBBUBBBUBUUBBUBBUBUBBUBBBBUUUUUBUUUUUUBUUBUBUBUUUUUUUBUBUUUUUBUUBUUUUUUUUBUUUUUUUUBBUUUUUBBUUU
UUUBUUBBUUUBUUUUBUBUUUUUBBUBUBUBUUBBUUUBUBUUUUUBUUBUBBBUUBBUUBUBBUBBUUUBBUUUUUUUBUUUUUUBUBBUUUUUUUBUB
UUUUBBUUUUUUUUBUUBUUUUUUBUUUUUBUUBBBBUUUUBBUUUUBUUUBUBUUUUUUUUUUUUUBBUUUUUUUUUUBUUUUUBUUUUUUBUUUBBBUB
UBUUUUUUUBUBUBUUBBUBBBUBUUUBUUUUBUUUUBBUUUUUUUBUUUUUUUUUBBBUUUUBUBBBUUBUUBBUUUBBUBUBUUBBUUBUUBUBUUUUU
UUUBBBUUUBBBBUUUUUUBBUBUUBUUBUBUUBBUUUUUUUUBUBUUUUUBUUUUUUUUUUUUUBUUUUUUBUUUUBBBUUUBUBBUUUUUBUUUUUBBB
UUUUUBUUUBUUBUUUUUUUUUUUUBUUUBUUUUBBUUUUBUUUUBUBBUUUUUUUUUUUBUBUUUBBUUUUBUUUUUUUUBBUUUUBUUUBUBUUBUUUU
UUUUUBUBBUUUUUBBUUUUUBBBUBUBUUBBUUBBUBUUBUUUUUUUUUUUUBUUUBUUUUUBUBUUBBUUBUUUUUUUUUUUUUBBUUBUUBUUUUUUU
UUBUBBUUBBBUBUBBBBUUUUBUBBBUBUUBUUUUUUUUBUBBBUUBUUUBUUUBUUBUUUUUBUUUBUUUUUUUBBUUBUBUBBBUUUUUUBUUUUBUU
UUBUUUUBUUBUBUBBBUUUUBUBUUUUUBUUBBBUBUBBUUUUUUUBUUUUUUUBUUUUUUBUBUUUUUUUBBBUUBUBUUBUBUBBBUUUUUUUUUUUU
UBUBUUUUUUBUUUBUUBUBBBBUBUBUUUUUUUUBUBUBBBUUBUBUUUBUUUUBUUBUBUUUUUUUBBUUBBUBUUUUBBBBUBUUUBBUUBBBUUUUU
UUUBUBBBUUBUUUBUBBUBUUUBUBBUBUUUUBUUUUBBUUUUUUBUUUUUUUBUUUBUBUBUUBUUBUUBBUBUBBUBBUUBUUUUBUUUUUUBUUUUU
BBUUUBBUBUBBUUBBUBBUBUUUBBUUUBUUBUBUUUBUUUUBBUUBBUBBBBBBUUUUUBBBUUUBUUUUUUBUBUBBUUBBUUUUUBUUUUUUUBUUB
BUUUBBUUBUBUUBUBUBBBUUBBUBBUUUBUBBBUBUBBUUUBUUUUUUUBUUUBUUBUUUUBBUBUUUUUBUUUUBUUUUUUUUUBUUUBBUUBUUBBU
BUBBUBUUUUUUBUUBBBUUBUUBUUUBUUUUUBUUUBBUUBUUBBUUUUUBBUUUUUBBBBUUBBUUUUBUBUBUUUUUUUUUUBUBBUBUUUBUUUUUU
UBBUUBUUUUUBUBUBUUUBBUUUUUUBUUUUBUUUUBBUUUUBUBUUUUBUBUUUUUUUBUUUBBUBUUUBUUBBUBUUUUBUUUBUUBBUBUBBUBBUU
UBUUUUUBUBUUBBUUUUBUBUBUBUBBUUBBUUUUBUUBBBUUUUUBUBUBUUUBUBUUBUUBUBBUBUBUUUUUUUBUUUUUUUUUUUUUUUBUUUBUU
BUBBUUUUUUUUBUBUUUUUUUBUUUUUBUBUUBBUBUUBUUUUBUUUUUUUUBUBUBBUUUUUBBUUBBUUBUUUBBBBUUBBUUUUUUBBUBUBUUUUU
BUBUBBUUUUUUBBUBUUUBUUUUUUUUUBBUUUUUUUUUBBUUUUUBUUUUUUUUBUUBUUUUUBBUUBUBBUUUUUBBBUUUUUBUUUBUBBUUUUUUB
UUUUBUUUUUUBUBBBBUUUBUBUUUBUBUUBUBBUBUUUBUUBUBUBUBBBUBUUUUUUUUBUUUBBUUUUUUBUUUBUBUUUUUBUUUUBUBUUUBUBU
UUBBBBBBUUUUUBUBBUBUBUBBUBUUUBBUUUUUUBUUUUBUBUUUBUBUUBUUBUUUUUBUBUBBUUUBUUBUUUUBBUUUUUBBUBUUUUUUUBUUU
BUUBUUUBUUBBUBBUUUUBUUUUBUUUUUUBUUUBUUBUBBUUUBBUUUUUUBUBBUBUBUBUUBUUBUBUBUUUBUBUBBUUBUBUUUUUUUBBUBUBU
UUUUUUBUBUUBUBUUUBBUUUBUUUUBUUUUUBBUUBBUUUUUUBUUUBBUUBBUBUUUBBBUUUUBUUUUBUUUUUUBBUUUUUUUBBBUUUBBUUBBB
BUBUBUUUBUBUBUBUUUUBUUUUUBUBUBBBBUUUUBBUUUBUUUUUBUUBUUUUBUBUUBBBUUBUUBBUUBUBUUBUUBUUBUUUUBUUBBUUUBUUU
BUBUUBUUUUBBUBUUUUBUUUUBUUBUUUUBUBUUBUUUUUUUUUUUUUUUUUBUUUUUBUUUUUUUUBUUUUUUBUUBUUBBUUUUBBBUUUUBUUUBB
UUBUUBBBUUUBBUUUUUUUUUUUBBUBUUUUUUUUBBUUUUUUBBBBUUUUBUBUUUBUUBUBBBBBBUUBUBUUBUUUUUUUUUUUUUUUBUUUBUUUU
UUUBUUUUBBUUUUUUBBBUUUUBUUUUUUUUUUUUUBUUUUUBUBUBUBUUBUUUUUUBUUUBBBUUUUUBUBUUUBUBUUUUUUBBUBBUBUBBUUUUB
UUUUUUUBUBUUUUUUBUUBUUUUUUUUUUUUBUUUBUUBBBUUBUUUUBUUBUUUUUUBUUUUUUUUUUBUBUUBUUBUUBBUUUUUUUUUUUBUUBUUU
UUUUUBUBUUBUUUUUUUUUUBUBUUBUUBBUBUBUUUUBUUUBUUUUBUUUUUUUUUBUUUUUUUBBUUUUBUUUBUUUUUUUUBUBUBUUUBUBUUBUU
UUUUUUUBBUUUUUUUUUUBUUUUBBBUUBBUUBUUUBUUUBUUBUBBUBUUBBUUBBUUUUBBUBBUUUUBUUUUUBBUBUBUUUUUBBUUUUUUUUUUB
UBUUBUUBUBBUUBUUUUUUUBUUUBUBUUBUBUUBUBBBBUUUBBBUUUBUBUBUUUBUUUUBUBUUUUUUUUUUUBUUUBUUUUUUUUBBUUUUUBUBU
BUBBUBUBBBUUUBUUUUBBUUUUUUUUUUUUBBUUBBUUUUUUUBUBBUUBUBBBUUBBUUUBUBUUUBUUBUUUUBUUUUUUUUUUUUUBUUBUUUBUU
BUUUUUBUUUUUUUUUBUUUUUUUUUUBUUBUUBUUUBUUUUUUBUBUUUUUUUUUUUUBUUUBUUBUUUUUUUUUUBUUBUUUUBUUUBUUUUUBUBUBB
UUUUBUUUUUUUUBUBUUUUUBUBBUUUBUUBUUBUBUUUUUUBUUUBUBUUUBUUUUUUBUUUBUUUBBUUUUUUUBUBUBUUBUUUUUUUBUUUUUUUB
UBBUUUUUBUUUUUBUBUBUUUUBUUUUUUBUBUUUUUUUUUUBBBUUBUUUUUUUUUUBUUUUUBUUBBUBBUUUUBBBUBBBUUUUUUBUBUBBBBUUB
UUUUUUUBUUUUUUUBUUBUUUUBBBUUUUUUBUUBBBUBBUUBUBUUBUUUBUUBUUUUUBUUUUUUUUUBUUBUBUBBUUBBBBUUUBUUUUUBBUUUB
BBUBUUUUBBBBUBUUUUUUBUBBUBUUUUUUUUUBUBUUUUUUUBUBUUUBUUUUBBBUBUUBBUBUUUUBUUUUBUUUBUUUUBUUUUUUUUUUBUBUU
UUUUUBUUUUUBBUUBUBUUBUUBBUUUUUUBUBBUUBUUUBBUUUUUBBUUUUUUBUBBBUBBUUUUUBUUUBUUUBUBBUUBBUBUUBUUBUUUUBUUB
UUUUUBUUUUBUUUUUBUUUBBUUUUBUUUBUUUUUBUBUUUUUUUUBBBBUUBUUUBUUUUBBBUUUUUBUUBBBBUUBUUBBUBUBBUUUUUBUBUUBU
UBUUUUBBUUBBUUBBBBUUUUUUUBUUUUUBUUUBUUBUUUUUUUBUBUBUBUUUBUUBUBUUUUUUUUBUUUUUUUUBUUUUUUUBBUUUBBUUBUBBU
BUUBUUBBUUBBUUUBUUUUUUUUBBUUUBUBUBUUBUUUUBUUUBBUUUUUUUUUBUUUBUUUBUBUBUUUBUUUBBUBBUUBUUBUUUUBUUUUBBUUU
UUUBUUBUUUUUUUBBUUUBUUBUUBUUUBUUBUUUUBUUUUUUBUBUUBBUUUUBUBUUBBBUBBUBBUUUUUBUUBUUUBUUUUUBUUUUUUBBUUUUB
UBUUUUUUBUBUUBUUBUUUUUBBUUBBUBBUUUUBUBUUUBUUBUUUUUUUBUUBBUBUUUBUUUBBUBUUUUUBBUUUUBUBUUUUUUBBUUUUUUBUB
UUUUUUUUUUUUUBUUBBUBUUUUUUUBUBUUBUUUUUUUBBUBUBBBUUBUUUUUUUBUBUUUUUBBBUUUUUUUUUUUUUUUUUUUUUBUUUBBBUUUU
UUBBUUUUUUUUBUBUUUBUUBUBUUUBUUUUBUBUUBUUBBBUUUUBUUUUUUUUUUUUUUUUUBBBBBBBBUUBUUUUUBBUUBUUUUUBBBBBBUBUB
UUUUBUUUBUBUBUUUUUBUBUBBUBBUUUUBBUUUUUUBUUBUUBUBBUUBUUUUUBBUUUUBUUBUUBUUBUUUBUUBUBBUUUUBUBUUBBUBUBBUU
UBUUUUUUUUUUUBUBUUUUUUUUBUUUUUUUUUUUUUUBUUUUUUUUUUBBUBUBUUUUUUUBBUBBUUBUBUUUUBUBUBUUUUUBUUUUUBUUUUBUU
UUBUUBUUUBUUUUUUUBUBUUUBBUUUBUBBUUUBBBBUUBUBUBUBBUUBUUUUUBBUUUUUUUBUUUBBBBBUUUUUBBUUBUUUUUUUBUUBUUUBU
UBUUBBBUUUUUBUBUUUBUUUUUUBBUBBUUUBBUBBUUUUBUBUBUBBUBUUUUUUBUUBUUBUBUBUUUUUUBBBBUUUUUBBUBUUUUUBUUUUUUU
BBBUUUBBBUUBUBUUUUUUUUUUUBBUUUBUUUUUBUUUUUUBBUBBUBUUBUUUUUUUUBUUBUBUUUBUUUBBBBBBUUUUUUBUBBBUUBBUBUUBB
BUUUUBBBBBBUUUUUUUBUUBUBUBUBBUUUUUUUBUUBBUUUUUUUBBBUUUBUBUUUUUUUBUUUBUUUUUUBBUUUUUUUUUUUUBBBUUBUBUBUU
BBUUUUUUBUUBBUUBUUUBUUUBUBBUUUUBUUUUUUUBUUBUUBUUUUBUBBUBUUBUBUBUUUBUUUBBUUUUBUUBUBUUUUBUUBUUUUBUUUUUU
UBUUUBUBBUUUUBUUUBUUBUUBUUBUUUUUUUBUUUUBUUUUUUUUBUBUBUUBBUUBBUBBUUUBUUBBBUBUUBUUUBUUUUBUBBUUUUUUUUUBB
UBUUUUUBBUUUUUUBUUBUBUUBUUBUUUUUBBBUUBUBBUUUUUUUUBUUUUUUUUUUUUUBUUBUUUUUBBUUBBBUBUUUUUBUUUBBBUBUUUBBU
UUUBBBUUBUUUUBUUUBUUUUUUBUUBUBUBUUUBBUUUUUBBUUUUBBUBUUBUUUUUUBBBUBUUUBUBBBBUUUUUBUUBUUBUUUUBUUBUUUBUU
BUBBUUUUUBUUBUUUBBUUUUBUUBUUUBUBBUUUBUUBBBBBUBBBUUUUUUUUBUBUUBUUUBUUBUBUBBBBUUUBUUUUUUBUUUBUBUUBBUUBU
UUUUUUUBUUUBUUUUBUBUUBBUUUUUUUUUBBUUUUUUUUUUBBUUUUBUUUUUUBUBBUUBUUUUUUUUBUUBUUUUUUUUBUUBBUUBBUUUBUBBU
UUUUUUUUUUUUUUUUUUBUUUUUUBUUBUUUUUUUBUBUUUUUUBUUUUUBUUUUUUUUUUUUUUUUUBUUUBUUBUBUUBUUUUUUBBUUUUUUUUBUU
UUUUBUBUUUUUUUUBUUBUBBUUBUUBUUUUUUBBUUUUUBUUUBUUUBUUUUUBBUBUUBBBUBBUUUUUUUBUBUBBUBUUUUUUUUBUBUUUUUBBB
UBUBUUUBUUUBUUUBUUUUUUUUUUUBUUUUUUUUUBUBUBBBUBUBUUUUUBBUBUUUBUBUUBUUUUBUUUUUUBUUBBUUUBUUBBBBUUBUBUBUB
UUUBUUUBUUUUUUUBBUUBUUUBUBBUBBUUBBBUBBUUUUUBBUUBUUUUUUBUUUBBUUUUUBUUUUUUBUUUUUUUBUUUUBUUUBUUUUBUUUUBB
UUUUBBUUBUUUUBBUUBBUUUUUBUUBUBBBBUUBBUBUUUUUBUUUBBBUUUUUUUBUUUUUUBUUUUUUBUUUUUUUUUBUUBUUUUUUBUBUUBBBU
UUUUUBBUBUUUUUUBUUUBBUUUBBBBUUBBBBUUBUUUUBUUUBBBUUBUUUUBUBBBBBUUUUUUUUBBUUUBUUBUUUBBUBUUUUUUBUUUBBUUU
UUBUUUUUUBUBUUUBBUBUBUUUBUUUBUUBUBUUUBBUUUUUBBUUBUUUUUUUBUBBUUBUUUUUUUBUUUBUUUUUUUUUBBUUUUUUUUUUBUUUU
BUBUUUUBBBUBBBUUUUUUUUUUBUUBBUUUBBUUUUBBBUBUUUUUUUUUUUBBUUUBUBUUBUBUUBBUBUUBUUBBUUUUBBUUUBUUBUUUUUUUU
UUUUBUUUUUBUBUBBBUUBUBBBUUBUUUBBUUUUUUUUBUBBUUUUBUUUBUUUBUUBBUBUBUUUBUUUUBUUBUUUUUUBBBUBUBBBBUUUUUUUB
BUBUUBUUUUBUUUUUUUUBUUUUUUUUUBUBUUUBUUUUBBUBUBBUBUBUBUUUUUUBUUBUUUUUUUBUUUUBUBBUUUUUUUUBUBBBBUBBUUBUU
BUBUBBUUUUUUUUBUUUUUBUUBUUUBUBBBUBBUUBUBUUBUUUUUBBUBUUUBBBUUUBUBBUUBUBUUBUUUUUBUBUBUUUBBUUUUUBBBUUUBB
BUUBBUUUUUUBUBUUBBUUUUUBUBBBUUUUBUUUBUUUUBUUUUBBBUBBUBUUUUUBUUBBUBUBBUUUUUUUUUUUUBUUBBUUUBUUBBBUUUUUU
BBBUUUUBUBUUUUUUUUUUBUUBBBUUUUBUBBUUBUUUUUBUUUBUBUUUUUBBBBBBUUUBUBUUUUUBUUUUUUBUUUBUUUUUUUBUUUUBBBUUU
BBUBBUUUUBUUUUUUUUUBUBUUUUBBUBUUBUUUUUUBUUUBUBUUBBUUBUBUBUBUUUUUUUBUUUUUBBUUUUUUUUBBUUBUUBUUUUUBUUUBU
UUUUUUBUUUBBUUUBBUBUUUBUUUUUUBUUBBUBUUUBBBBUBUUUUUBBBBUUUBBUUBUUUUUBUBUBUUUUBUBUUBBBUUUBBUBUBBUUBUUUU
UUBBBUUUUUBUUUUBUUUUBBUUUUBUUUUUUUBUUUUUUUUUUUBBUUBUBUUUUUBUBUUBUUUUBUBUBUUUUUUUBUUUUUUUUBUUBUBBUUUBU
UUUUBUUUUUUUBBUUBUUBBUBBBUBUUBBBUUUUUUUUUUUUUUBUBBUUUUUUUUUUUUUUUBBBUUUBUUUUUBUBUBUUUUBUUUUUUBUBBBUBB
UUBUUBUUUUBBUUUUUBUUUUUUUBUBBUBUBBBUBBBUUBUUUBUBUUUUBUUUUUUUUUBUUUBUUUUUUBBUBBBUUUUUUUUUUUUUUUUUBBBUU
BBUUBUBUUUBUBUBBBUBBUBUUUBUBBBUUUUUBBUBUUUBUUUUBUUUUUUBBBUBBBBUUUBBUBBUBBUUUBUUUUBUUBBBUUUUUUUUUUUUBB
UUUUUBUBUUUUUUUUUUUBUBUBUBUUBUUUBBBBUBUUBUUBUUBBUUUBUBUBBUUUBBUUUUBBUUUUUBBUUUBUBUBBUUUUUUUBUUUUUUUUB
UUUUBBUUUBUUUUUUUBBUUUBUUUUUBBBUUUUUUBUUUUUUUUBBUUUUUUBBUUUUUUBUBBBUBUUUUBBUBUBUUUUUUUBUUUBUUBBUUUUBB
BUBUUUBUUUBUUUUUUUUUUUUUUUUUBUUUUUUUUUUUUUBBUUUBUUUUBUBBUUUBBUBUUUUUUUUUUBUUUUUUBUBUBUUBUBUUUBBUUBUBU
BUBBBUUBUBUUUUUUUBUBUUUBBUUBUBUBBUUUBUUBUBUUUBUUUUUUUBUUUUUUBUUUUBUUUBUUBUUUBUUUBUUUBUUUUUBUUUBUUBBBB
UUBUUUUBUUUUUUUUUUUUUUBUUBUBUUUUUBUUUUUUBUUBUUBUUUUUUUUUUUUUUUBUUUUUBUUBUUUBUUBUBBUUBBUUUBUUBUUUUUBBU
UUBBBBBUBUUUUBBUUBUUUBBUUUBUBUUUUUBBBBBUBUUBUUUBUUBBBBUUBBUUUBBUUBBUUUUUUUUUUUUUUUUUUBUUBUBUBUUUUBUUU
UUBUBUBBUBUUUUUBUUUBUUBUUUBUUUUUUBUBBBBUUUBUBBUUBUUBBUBUUUUBUUBUBUBUUUUUBUUUUBUUUUBBUUUBUUBUBUUBBUUUU
UUBUBBUUBUUUUUBUBBBBBUUUUUBUUBUUUUBBUUUUBUUUBUUUUBUUUBUBUUUUUUUUBUBBUUUUBUUBUUUUBBUUUUUUUBUUUUUBBBUUB
UBUUUUUBUBBUBBUUUBUUBUUUUBUUBUUUUBUBUUUUBUUUBUUUUBUUUUUUUUUUBBUUUUUUBUBUUBUUUBBUUUUBBBUBBUUUUBUUUBUUU
BUUBBUUUBUBUUUBBUUBBBUUUUBUBUUUUUUUUBUUUUBUBUBUUUUUUUBBUBUUUUBUBUUUUUBUUUUBUBBUUBUBUBBUBUUUBUUUBUBUUU
UBUUBUUUBUBUUUUUBUUUBUBUBUBBUUUUUUUUUUUUBUBUUUUUUUUUUUUUUBUUUUBUUBUBBBUBUUBUUUBUUUUUBBUUUUUBBBUBBBUUU
UUUUBBUUBUUUUBBUUUUBBBUBBUUUUUUUUBBBUUUUBUUUBUUUBUUUBUUUUUUUBUUBBUBUUUUUBUUBBBUBUUUBUUBBUUBUUUUBUUUBU
UBBUBUUUUUUBUUUUUUUUUUUUBUUUBUUBUBBUBUUUUUUUUBBUUUUUUUUUUUUUUUUUUBBUUBUUUUUUUUBUBBUUUUUUBUUBUBUUBUUUU
UBBUBBUUUBUUBBUUUBUUBBBUUUUUUBUUUBBUUUBBBUUBBUBUBUUBUUUUUUUUUBBUUUUBBUUBUBUUUUUUBUUUUUBUUUUUUBUBUUBUB
UBBUBUBUBBBBBBUUUBUUUUBUUBUUUUUBUBBUBBBUUUUBBUBUUUBUUUUUUBUUUUBUUBUUUUBUUUUBUUUUUUUBBUUBUUBUBUUUUUUUB
UUBUUBBBBUUBUBUBUUUUUUUUUUBUUUBUUUUBBUUBUBUBUUUUBUUUUBUBUUUBBUUUUUUBUBBUBUUUUUUBUBUUUBUUUUUUBUUBUUUUU
