UBUUBUBUUBBBUBUUUUUBBUBBUUUUBBBBUUUBUBUUUBBUBBBUUUUUUUBUUUBBBUBUUUUUUUBUUUUUUBUUUBUBBUUUBBBUBUUBUBBUU
UBUUUUBUUUUBUBBUBUBUUUUUUUUUUUUBUBUUBUUBUUBBBBBUUUBUUUUBUUUUUUUUUUBUUUBBUUUUBUUUUUUUBUUUUUUBUBUUBBUUU
UBUUBBUUUUUUBUUUBUBUUUBUBUUUUUUUBUUBBUUBUUUBUBUBBBUBUUUUUUBUUBUUBUUUUUBUBUUBUUUBUUUUUUUBUBUUBBUBUUUUB
UUUUUUBUBUUUBBUBUBUUBBUUBUUUUUUUUUUUUBUUBUBUUBBUUUBBUBBUUUUBUUBUUUUUUBBBBUBBUUUBUUBBBUUBUUUBBUBBBUUUB
UUBUUBUUUUUBBUBUBBUUUBUUUUUBUBBBUBBUUUUUBUUUUUBUBUUBBBBUBUUUUUUBUUBUUBBBUBUUUUUBUUUBBUUUUUUUUUUBUUUUB
UBUUBUUUUBUUUUUUUUUUUUUBBUUUUUUBUUUUUUUUUBBUUUUBBBUUUUUBUUUUUUUBUUUUUUUUBUUUUBUBUUUBBBUUBBUUBUBUUBBUU
UUBBUBUUBBUBBUUUBUBUBUBUUBUBBUBUBUUUUUBUUBUUUUBUUUBBUUUUUBUUBUUUBBBUUBUBUUBUBBUBUUUUUBUBUBBUUUUUBUUUB
UBUUUUBUUUBUBBUUUBUUUUUUUUUUUUUUUBUUUUUUUUBUUBUUUBUUBBUBUUUUUBUUUUUUUBBUBUUUUUUBUBUUUUUBUUBUUBBUUBUBU
UUUBBBUBUUBUUUUBUBUBUBUUUUBUUUUBBUUUUUUUBUBUUUUUUUUUUUUUBBUBUUUBBUUUUBBUUUUUUBBUBBBUUUUUUUBUUUUUUUUUB
UUUUUUBUUUUUUUUBBUBUUBUUBUUUBUUUUUUUBUBBUBUUUBUUBUUUUBBUBUBUUBUUBUUUUBUBUBUUUUUUUUUUUUUBBUUUBUUUBBBBU
BUBUBUUBBUUUUUUUUUUUBUUUUUUUBUUUBUBBUUUBUUUUUUUBUBUBUUBUBUBBUBUUUUUUUUUUBBUUUBBUUBUUBUBUUBUUUUUBBUUUU
UBUUUUUUUUUBUBBUBBBUUBUBUUUUUBUBUBUBUUUUBUUUUUBUUUBUUUUBBUUUUUUUBUBUBUUUUUUUUUUUBUUBBBUBBBUBUUUUUUUUU
UUUUUUUUUUUUUUBUBUBUUUBUBUBUBBBBBBBUUUBBUUUUUUUUBUBBBUUUUUUUBUUUUUUUUBBUBBUBUUUUUUUUBUUUUUUUUBBUBUBUB
BBUUBUBUUBUUUBUUBBUBBUUUBUUUUUBUUUUUBUUUUBUUUUBUUUBBBBUUBUUUUBUUUUUUUUUUUBUUUUUUUUUUUUUUUUBUUUBUUUBBU
UUUUUBUBUBBUUUUBUUBUBBUUUUBUUBUBUUUUUUBUUUBBBUUBUUUUUUUUBUUUUBUBUBBBUUUUUUBUBBBBUBUUUBUUUUBUBBBUBUBUB
BUUUUUBBUBUUUBUUUUUUBUUUUUUUUUBBUBUUBBUUUUBBUUUUUUBBUUUUBUBUUUBBBBBBBUBBUUUUUUUBUUUUUUUBUUUUUUBUBBBUB
UBUBBUBUUUUBBUUBUUUBUUUUBBUUBUUBBUUUBUUBUUBBUUUUUUUUUUUUBUUBUUUBBUBUBUBUUBUBUBUUBUUUUBBUUBUUUBUUUBUUU
UUUBUBUUUBUUUBUUUBUUUUBBBUUUUUUUBUBUBUBUUUBUUBBUUUUUUUBUUUBUUBUUUBUUUUBUUUUBBUUBUBUBUUBUUUUUBUUUUUUBB
UUBBUBBBBUBUUUBBUUUUUBBBUUBUUBUUBUUBUBBBUBUBUUUBBUUUUUUUUUUUUUBUUBUBUBBUBUUUBUUBBUUBUUUUBUUUUUUUBUBUB
UBUBUUBUUUUUUUUBUUUUUUUUBBBUUUUUBBUUBUUUUUUUUUUBBUUBUUUUUUBBUBBBUUUUUBBUUUUUUBUUUBUUUUBUUUUUUUBUUUUBU
BUUBUUUUBUUBBUUBBUBBUUUUBBBUUUUUBUBUBBUBUBUUBUBUUUBUUUBUUUUUUUUUUUUUUUBUUUBUBUUUBUBBUUBBBUBUUUUUUBBBU
BBUUUUBUBUUBBBUUBUUUUUUUUUUUUUBBUUBUUUUUUBUUUUBBUUUUUUUUUUBUUUBUUUBUUBUUUBUBUBUUUBUBUBUUUUUUUBUUBUBUU
UBBUBUUUBUBUUUUUUUUBUUUUBBUUUUUUUUUUUUBBUUUUUUUUBUUUUUUBUBUUUUUUUBBUUUUUUBUBUUBUUUUBBUUBBUBBUUUUUUUUU
UUBUUUUUUUBUUUUUUUUUBBUUUBUBBUBUUUUBUUBBUUBUBBBUUUUUBBUUUUUBUUUBUUUBBUUBUUBUUBBUBUBUUUBBBBUBUUUBUUUUU
UUUUUUBBUBUBUUBUBUUUUUUUUBUUUUUUUBUUBUBUBBUUUUUUUUBUBUUUBUUUBUUBUBBBUUUBUUBUBUUUUUBUUUBUBUUBUUUUBUUBU
UUBBBUBUUBBBUUUUUUUUUUUUBBUUUBUBUBUUUBBBBUUUUUUUUBBUUBUUUUUUUUBUBUUBUUBUBBUBUUUUUUBUUUUUBUBUUUBUBUUUU
UUBUUUUBUUUUUBUUUBBBUBBUUUUUUBUBUUUUUBUBUUUUBUUBBBBBBUUUBUUUUUBBUBBUUUUUUUBUUBBUUBBBUBBUUUUBBUBUBUUUU
UUBUUUUBUBUUUUUUUUBUBUUUUBBUUUUUUBBUUUUUUUUBUUUUUUUBBUUUUBUBUBUUUBUUBUBBUUUUUUBUUUBUUBUUUUBUUBBBUUBUB
UUUBUUUUUBBUUBUBUUUUBUUUUUUBUUUBBUBUUUUBUUUBUUUUBUBUUBUBUBUUUUUUBUBBBBUUUUUUUUUBUUBBUUUBBBBUBBBBUBUUU
UUBBBUBUBBBUUUBUUUBBBUBBUUUBUUUUUBUUBUBBUUBBBBBBBUUUUUBBBBBBUUUUUUBBBUUBUUUUUUUUBBUUBUUUUUUBUUUBUUBBU
UUUUUUUBUUUBUUUUBUUBUUUBUBUBUBUUBBUUUBUBUBBBUBBUUUUUUUUUUUUBUUBUUUBUUUUUUBUUUBUUUUUBUUUBBUUUBUUUUUUUB
BUUUBBUUBUUBBBUUUUUBUUBBUUUBUUUBUUBUUUUUBUUUBBBUUBUUUBUBUUUUUUBBBBUBBUBUBUBUUBUUUBUUUUBUUUUBUUUUBUUUB
UUUUUBUUUUBBUUUUUBUUBUUBUUBUBUUUUUBUBBUBUUBUBUUUBUUUUUBUUUUUBBUUUBBUUUUUUUUBUUBUUBBBUUBUUBBBUUUUUUUUB
UUUBBUUUUUUUUBUUUUBBBUUUUBUUUUBBUUUUUUUUUUUBBUBUUBUUBBBUUUUUUUUBUBUUUUBBUUUBBBBUUUUUBUUUBBBUUUBUUBUUU
UBUUUBUBUBUUBUBUUBUBUBUUBUUUUUUUUUUUUUBUUBUUUUBUUUUBBUBUUUUUUUUUUUBBUUUUUUBBUBUUBUUUBBUUBBUBUBUBUBUUB
UUUUBUBUUUBUUUUBUBUUUBBUBUUUUUUBBUUBUUUUUUBUBUUBUBBUUBUUUUUBUBUBUBUUBBBUUBBBUUUBUUUUUUUBBUUBUBUBUUUUU
BUUUUUUUUUBUUUUBUBUUBUBUUUBUBBBUBUUBUUUBUUBUUUBBUBUBUUBUUUUUBUBUUUUUBUUBUUBUUUUBUBBUUUBUUUUBUBBBUUBUU
UUUUUUUUUBUBUBUUUUUUUUBUUUUUUUBUUBUUBBBUUBUBUUBUUUUUUUUUUUBUUBUUBBUUBUUUBUUUBBUUUBBUUUUUBUUUUUBUUUUBU
UUUBUUBUBUUBUUUUUBBBBUUUUUUBUUUUUUUUBUUUUUUUBUUUBUUUUBBUUBUUBBBUBUUBBBUUUBUUUUBUBUUBBUUUBUBUUBUUBUUUB
UUUUBBUUUUUUUBUUUUUUUUUUBUBBUUUUUUBBBUUBUBUBUUUBBBUUUUUUBBUUUBUUUUBBBUUUUUUUBUUUUBBBBUUUBBUBUUUUUBBBU
UUBUUUBUUUUUUUUUUUUUUBUUBUUBBBUUUBUBUUBBBUUBUBUBBUUUBUUUUUUBUUBBUUUUUUUBUUBUBUBBUBBUUUBUBUUBUBUUUUUUU
UUUBUUUUBUBUUUBUUUBUUBUUUUUBBBUUUBUUUBUUUUUBUBBBUUUBUUUUBUUBUUUUBBBUUUUUUUBUUUBUUUUUBUUBBUBUUUBBUUBUU
UBUUBUUUUUBUUUUUBUBUBUBUUBUUBUBBUUUUUUUUUUUBUUUUUUUUUBBUUUUBUBUUUUUBBUUUBBUUUUUUUBUBUUUUUBUUBUUUUBUBU
UUUBBUUUBUUUBUUUUBBUUUBUBBBUUBUBUUBUUUUUUUUUUUUUUUUUUUUUBUBUBUUUUUUUBBUUBUUUUBUUUUUUUUUUUUUUUUUUBUUBB
BUUBBUBBUBBUUBBUUUUBUBUUUBUUUBUBUBBBUUUUUBUUBUUUUUUUBUBUUBUUUUBBBUUUUBUUUUBUUBBBBUBUUBUUUUUUUUUUUUUUB
UUUBBBUUBUUBUUUUUUUUUUUUUUUBBBUUBUBUUUUUBUUUUUUBUUUBBBBUUUUUUUBUUBBUBUUUUUUUUUUBBBBUUBBUUBUUUBBBUUUUU
UUUUUBUUUBUUUBBUUBUUUUUUUUUUUUUUUUUUBUUUUUUUBBBUBUUUUBUUUBUUUUBUUUBBUUUUUUBUUUBBBBUUUUUUUUUUUUUUUBUBU
UUUBUBUUUBBBUBUUBBBUUUUBUBUUUUBBUUUUBBUUUBBBUUUUUUUUBUBBUBUUBUUUUBBBUUUUUUUBUUBUUUUUUUBUUUBUBUUUBUUBB
BUBUBUBUUBUUUBUBBUUUBUUBUBUUBUBUUUBBUUUUBUUBUUBBUUUBUBUUUUBUUUUBUUUUBBUUBUBBBUBUBUUUBUUUUUBUBUUBBUUUU
UUUUUUBUBUBUUUUUUBUBUBUBBBBBBUBBUUBBUUUBUUUBUUUUUUBUUBUBUBUUBBBUUUUUUUUUUBUBUUUUBBUUBBUUBUBBUUUUUUBUU
UUBBUBBUUBUUBUUUUBUBUUBUUBUUBUUBBUBBUUBUBUUBUUBUUBBUUUBUUUUUUBBUUUUBUUBUUBUUUUUUUBUUUBUBUUUUUBBUUUUUB
UBUUBUBBUUUUUBUUUUUBUUBBBUUBUBUBUUUUBUUUUBBUBUUUUUUBUUUUUBUBUUBUUUUUBUUUUUUUBUUUUUBUUUUBUBUUUUBUBUUUU
UBUUUUUUUBBUUUUBBUUUUUBUBUUBUUUUUUBBBUUBBUBUUUUBUBBBBUUUBUUBUBBUBBBBUBUUUBBUUUUUBBBBUUBBUUBUUUUBUUBBU
UBUUBUUUUUUUUBUUUUBUUUUUUUBBUUUBBUUBUUUBUUUUBUUUUUUUBUUUUUBUUBBBUUUUUUUUBUUBBBUUUBBBUUUBBUUUUUUUUUUBB
BUUUBUBUBUUBUUUUUUUUUUUUUUBBUUUBUUUUUUUUBBUBUUUBBBUBBUUBUUUBUBUUBBUUUBBBBUBUUBBUBBBUUUUBBUUUUUUUBBUBB
UUBUUUBBUBBUUBUBUUUUUUBUBUBUUUUUUBBBUBUUUUUUUUUUUUBUUUUUBBUUUUBUUBUBUUUBBUUUUBUBUUUUUUUUUUUUBUUUBUUUU
UBUBBBUUUBUBBUUUBUBBUUUUUUBUUBBUBBUUUUUUUBUUBBUUUUUUUUBBBUUBUUBUUUUBBUUUUBUUUBUBUUBUBBBUUBUUUBUUUUBUU
UUUUUBBUBBUUUUUUUUUUUUBUBUUBUUBUUUBUBUUUUUUUUUUUUUUUUBUBUUUUBBUUUUUUUBBUUUUUUBUUBUUUUUUUUBBBBUUBBUUBU
UBBUUUUBUUBUUUBUUBBUUUBUUUUUUUBUUBUUUUBUUUBUUUUUUUUUUBBBUUUUBUUUBUUBBBBBUUUBUUUUUUUBUUBUUBBBUUBBUUBUB
UUUUUBUUUUBBUBUUUUBBUUUUUUBBUUUUUUUUUUBUUUUUUUUBUUUUUUBBUUBBBUBBUBBUBUUBUUUUBUUBUUBUUUBBUUUBBBBUBBUUU
BUUUUUBBBUUUBUBUBBUUBBUUUBUBUUUUUUUUUUUUUBBUUBBUUUUBBBUUBUUUUUUUBBUUUUBBUUBUUUUUUUUUUBUUUUUUBBUUUUBUU
BUUUBUBUBUBUBUBUBUUBUUUBUUUUUBUUBUBUUUBBUBUUUUUUUUUUBUUUBUUBUUBUBUBBUUBUUUUBBUUUUUUBBUUBBUUUUUBBUBUUB
UBUBUBUUUUUUUUUBBBUBUUUBUUBUUBUUUBUUUUUUUBUBUUUUUUUUUUUUUUBUUUUBUBUUUUBUBUBUBUBBUUBUUUUUUBUUUBUUUUUBU
UUBUUUUBBUBUBUUBUUUBUUBBUBUUUUUUUUBUBUUUBBUBUUUUUUUUBUBBBBUUBUUUBUBUUBUUUBUUUUUUBBUUUBUBUBUUUUUUUBBBU
UBUBUUBBBUUUBBUUBBBUUUUUBUUUUUBUUUBUUBUUUUBBBUUBUUBBUUUUUBUUUUBUBUUUBUUBBBBUUUUBUUUBUUBUUUUUUBUUUUUBB
BBBBUBUUBBUUBBUUBBBUUUUBBUUBUBUUUBUBUUUBUUUBUBBUUUUBBUBUUUUUUUUUBBBUBUUUUUBBUUBBUUUBBBUUUBUUBUUBUUBUB
BUUUUBUUBUUUBUUUBBUUUUUUBUBUUBUUUBUUUUBUUBUUUUUUUUUBUUUBUUBBUUBUUUBUUUUBUUUBBUBBUUUBUUUUUUUBUBUUBBUBU
UBUUUUBUUBUUUBUUUUBBBBBUBUUUBUUUUUUUUUUBBUBUUUUUUUUUBUBUUUBUBUUUUUUBUBUUUBBUBBBUBBUUUBUUBUUBUBBUBUUUU
UUBUBUBUUBBBUUBUUUUBBUUBUUUUUUBUBUUUBUUBBUBUUUBUUBBUUUUUUUUUBUUUUUBBUUUBBUUBBBBUBUBUUUUBBUUUUBBBUUUBU
UUBBUUUUUUUUUBUUUUBBBBUUUUUUUUBBUUUUBUUBUUBUUUUUUUBUUBBUBUBBUUUUUBUBUUUUUUUUBUBBUUUUBUUUUUBUUBUUUUUUU
UBUUUUUUUBUUUUUBBUBUUUBUUBUBUUUBUBUBUBUBUUUBBBUUUUBUBUBUUUBUUUUUUBUBUUUUUBUUBUBBUBUUUUBBUUUBUUBUBUBUU
UBUUUUBUUUUUBBUUUUBUUBUBUBUUUUUBUUBUUUUBUBUBUBUUUUUUUUBUUBBBUUUUBUBUUUBUBBUUBBUUUUUBUUUUUUUUBUUUUUUUB
BUUUUUUUBUUUUBBUBUUBBUUUUUBUBUBUUUBUUBBUUBUUUBUUBBUUUBUBBBUUBUBUUUBUUUUUUUUUBUBUBUBBUUUUUUUUUBUBBUBUU
UUUUUBBBUUUUBUBBUUBUUUBBUBUUUUUUUUUUBUUUUUUUBBBBUUUUBUBUUUUUUUBUUBUUBBUUUUBUUUUUBBBUUBBUUUUUUUUBUUBBB
UUUBUUUUBBUUBBUUUUUUUBUUUUUUBBUUBUUBUBBUBUUUBUUUUBUBBUBUUUUUUUBBBBUUUBUBUUUUBUUUUUUUUBBUUUUBBUUUUUUUU
UUUUUBUUUBUUUUUUBBUBUBUUUUUUUUUUUUUBBBUBUUUUUUBUUUUBBUUUUUBUUUBUUUBBBBUUUBUUBUUUBUUUBUUUBUUUBUBUBUBUU
UUUBUBUUUBUUBBUUUBUUUUBBUUBUUBBUUUUUUBUUUUUUUUUUUBUBBUUBBUUUUUUUUUUUUUUUBUBUBUBUUUBBUBBUUBUUUUUUUBUUB
UUUUUUBBBUUUBUUBUUUBBUBUBBUUUUUUBUUUBUUBBUBUBUUBUUBUUUBUUBBUUBUUUUUBUUUUBUBBBUBUUUUUUBUUUBUUBBUUBUBUU
UBUUUBBBUUUUUUUUUUUUBBUBUUUUUBUUUUUUBUBUUBUUBBUUUUUUUBUUUUUUBUBUBBBUUUUBUUBUUUBUBUUBBUBBBBBUBBBUBUBBU
BBUUBBUUBUUUUBUBBUUBUUUBUUUUUBBBUUBUUUUUBUBUBBUUUUUUBUUUUUUBBBUUBBUBUBBUBUBBUUUBUBUUUUUUUUBBUUUBUUUBB
BUUUUUUUBBUBBUUUBBUUUUUUUBBUUBUBUUUUBBUUUUUUUBBUUUUBUBBUUUUUBUBUBBUBUUUUBUBUBUUBUUUUUBUBUUUUUBBUUUUUB
UUUUUBBUBUUBUBBUUUBUUBUBUUBUBUUUBBUUUBUUBBBBUUUUUUUBUUUUUUUBUUUUUBUUUBUUUUUUUBBBBUBUUBBUUUUUUBUBBUUUB
UUBUUBUBUUUUUUBUUUBUBBBUUUUUUUUUUBBUBUUBBUUUUUUUBUUUUUUUUBUBUUUUUBUBBUBUUUUBBBBUUUUUUUUBUUBUBBUBUUUBU
UBUUBBBUUUBBBBBBUBUUUUUUUUUUBUBBUUUUUUUBBUBUUUUUUUUBUBBUUUUBBUUUBBUUUUBBBUBBUUBUUUBBBUUUUUUBUBUUUUBUB
BBBUUUUBUUUBUUBUUBUBBBBUUBBUUBUBUUUUUUBBUUBBBUUUUUUUUBUUBUUUUUUUUUUUUUUUUUUUBUUUUUUUUUUBUBUUUUUBUUBUB
UBUUUUUUUBBUBUUUUUBUUBUBBBBUBUUUBUUBBUUUUUUUUUUUUBUUUUUBUUUUUUBUUUUUBUUBUBBUUBBUUUUUBBBBUUUBUUBBUUUBU
UBBUBUBBUUBBBUBUUUUBUBUUUBBBUUUUBUUBBUUBUBUBUUUUUUUBUUUUUUUUBBBUBUUUBUBBUUUUBUUUUUUBUUBUUUUUBUUBUUBBU
UUUUUBUUBUUUUBUUUUUUUUUUUUBUUUUUUUBBUBUUBUBBUUUUUBUUUBUUUUUUUBUUUUUBUUUUUUBUUBUUBBUUUUBUBUBUBUBUBBBBB
UUUBUUUUUUUBUUUUUUUBUUBUUUBUBBBUBUBUBBBUUUUUBUUUUUUUUUBUUUBUUUUUUBUBUBUUBUUBBBBUUUUUUUBBUBUUBUBBUBUUB
UBBUUUBUUBUBUBUUUUUBBBBUUBUUUBUBUUBBBBUUUUUUBBUUBBBBUUBBUUBUUUUUUBBUUBUUUUUUUUUUUBBBBUBUUUUUUUUBUUUUB
UBUBUUUUBUBUUUUUUBUUBUBUUUBUUUBUUUBBBUUBBUUBBBUUUUUUUUUUUUBUUUUBUUBBBBUUUUUUBUUUUUUUUUUUUUUUUUBBUUUBB
UBUUBUUUBBBBUBBUUUUUUBBUUBBUUUUUUBUUUUBUUUUBUBUUUUUUUBUUBUUBUUUBUBBBUUUUBUBUUBUUUBBBUBBUUBUUUUUUBUUUU
UBBUUBUBUUUUBUUUBBBUBBUUUUUUUUUUUBUBBUUBBUUUUUBUUUBUBUBUBBBBBUUBUUBUBUUUUUUBUUUUUBUUUUUUUBUUUUUUUUBUU
BBBUBUUUUUUUUBUUUUBUUUUUUUUUBBBUUUBUBUBUUUBUUBBBBUUBBUBUUUUUUUBUUUBBUUUUBBUBUUUBUUUUUBUUBUUUUBBUBUUUU
UUUUUUBUUUUUUUBUUUBUBUUUBBBUBBUUUUBBUUUBUBUUUBUBUUBUUUBUBUUUUBBUBUUUUUUUUUUBUBUUBUBUBUUUBBBUUUUUBUBUU
UBUUBUBUUBUUUBUUBUBUBUBUBBBUUBUBUBUUUUUUUBUUUUUUUBUBUBBUUUUBUUUBBUBUBUBUUUBBBUUBUBUUBBBUUUUUBBUUUBUUU
BBBBUUUUUUUUUUUBUUUBUUUBBUUBUUBBUBUBUBUUUUUBUBUUUBBBUUUBBUBUUUUUUBUBBBBUUBUUUUBUBUBUBUUUBBBUBUUUBBBUU
UUUUBUBUBUUUUUUUUUUBBBUUUUUUUBBUUUUUUUUBBUUBUUUUBUUUUBUUBUUUUBUUBBBBUBUBUBUBBBBBBUBUUBUUUUUUBUUUUBUUB
UUUBUUBBBBBUUUBUUUBBUBUUBUUUUUBUUBUUBUUUUUUUUUBBUUUBUBBUUUUBBUBUBUUBUBUBUUUBUUUUUBBBUUUUUUBUUBBUBUBUU
UUUUUUBBUBBBUUUBUUUUUUUUUUUUBUBUUUBBUUUBBBUUUUUBBBBBBUUUBBBUUUBBBUBBUUUUBUUBUBUUUUUUBBBBUUUUUUUBUBBUU
UBUUBBUUUUBUUUUUUBBUBUUBUUBUUUUUUBBBUUBBBUUUBBBBBBUUUUUBUUUUUUUUUUUBUUUUUUBBUBUUUBBUUUBUUUUUUUUUUUBUU
