UUUUUBUUUUUUUBBUUUUUUBUUBUBUBUUBBUUUUUUBBUUUUBBBUUUUBBBUBUBUBBUUUBBUUUUUBBBUUBUUBBBUUUUBUBUUUUUBUUUUU
UUUUUUUUBUBUUUUBUBBBBUUUBBBBBUUBUUUBUBUUBBUUUUUBUBUBUBUUUUUUUUUUUUUBUUUBBBBUUUBUUUUUUUUUUUUBUUUUBBUBB
UUBUUUBBUBUUBBBUUUBUBUUUUBUBUUUBBBUBUBUUUUUUUUBBUUUUBBUUUUUUUUUUUBUBUUUBUUUBBUUUBUBUBBBUBUUUBUBBUUUUU
BUUUBUUUUUUUBUBBBUUUUUBUUUBBUBUUBUBBUBBBBUUUUUUUBUBBUBUUUUUBBBUBBBUBUUBUUUBBBUUUBUUUUUUBUUBUUUUUUUBUU
BBUUUUUUUUUUUUBUBUUUUBUUUUBUUBBUUUUUBUBBUUUUUUUUUUBUUUUUUBUBBUUUBUUBUUBUBUUBUUBBBUUBUUUUUUUBUUUUUBUUB
BUUBUUBUUUUUUBUBBUUUUUUUUUUUUUUBUUBUUUBUUUUUUBUUUBUUUBBUUBBUBUUBBUUBUUUUBUUBBUUBBUBBUUUUUBBUBBUBBUUUU
UUUBBUUUBUUBBUUUUUBUUBUBUUBBBUBUUUUBUUUBUUBUUBUUUBUUBUBUBUUBUUUBUUUUBUUBUBUUUUBUUUUUUUBUUUBUUUUBUBBUB
UBUUUUUUBUBUBUBUUUUBUUBUUUUUUUBUUUUUBBBUUBBUUUUBBBUBBUUUUUBUUUBBUUBUBUBUUUUUUBUUUUUUUBUUUUBBBUUBBBBBB
BUUUUUUBBUBUBUBUBUUUUBUUBBUUUBUUUBUUBUUBUUBUBUBUUUBBBBUUUBBUUBBBUBUBUUUUUUBUBUUUBUUBUUUBUUUUUBUUUUUBU
BUUUUUBUUBBUUUUBUUBUBBUUUUBBUUUUBUBUUUUBUUBUBBUUBUUUUBUUUUUUUBUUBBBUBUUUBUBUBBUBUUBUUUUUUUUUUBUBUBUUU
UUUUUUUUUUBUUBUUUBUBUBUBUBUBUUUBBUUUUUUBUBUUUUUUBUUUBUUBUUUBBUUUUUBBUBUBUUBBUUUBUBBBUUBBUUBBBBBUBBUUU
UUBBUUBUBUBBBUBBUUUUUUUUBUBBUUUBBUBUUUBUUUUBUUUUUUUUUUUUUUBUBUBUUUUBUBBUBUBUUBBUUUUBUBUUUBUUUBUUUUUBB
UUUUUUUBUUUUBUUBUUUBUUUUUBBBBUUUUUUUUUUUUUBUBUBUUUUUUUUUUUUUUBBUUUUUUBUUBUUUUUUBBUUUBUUUBUUUUBBUUUUUU
UUUBUBUUUBUUUUUBUBUBUUUUUUUUBBBBUBBUBUUBUUUUUBUUUUUUUUUUUBUUBUUUUBBUUUUBBUUUBUBUUUBUUBBUBUUUUUBUUUUUU
BBUUBUUUUUBUUBUBUBUUUBUBUUBUUBUUUUUUUUUUUBBBUUBUBBUUBUUUUUUUUUUUUUUUBUUUUBUUBUUBUUUUUBUUUUUUBBUUUUUUB
UUUUBUBBUUUUUUUUBUUBUBBBUUUBBUBUUBUUBUBBUBUUBUUUUUUUUUUUUUUBUBUBBBUUUBUBUUBBUUUUUUBBBUUBBBUBUUBUUUUBB
BUUUUBUBUUUUBUBBUUUUUUUUUBUBBUBBUBUUBBUUUUBBBUBBUUUUUUUUUBUUUUUUUBUUBUUUUUUUUBBUUUBUUUUUBUUBBBBBUUBUU
BUUBUBUBUUUUUBUUUBUBUBUBUBUBUBBUBUUUUUUUUUUUUUBUUUUUUBBUUUUUBBUUBUUUUBUUUUUBBUUBBUUBUBUBUBBBBBUBUUUBU
UUUUBBBBBUUUUBUUBBUBUUUUUBUBUUUBUUUUUUUUBUBUBUBUUUUUUUUUUUUUUUUUUUUUUUUUBUUUUUUUUUBUUUUUBUUUUUUBUUUUU
BBUUUBUBBUUUBBUUBBUUBUUUUUUUBUUUBUBBBBBUUUBBBBUUBBUUUUUUBUUBUUUUBUUUBBBUBUUUUBUUUUUUBUUUUBUUBBUBUUBBU
BUUUUBUUUBUUUUBUBUUUUUUUBUUUBUUUUUBUUUBUUUBUUUUBUUUUUUBUUUBUUUUUBUUUUUUUUUUUUUUUBUUUUUUUBUBUUBUUUUBUB
UUUUUBUBBBUUBBUBUBUUBUBUUUUUBBUUUBUUUUUBBBUUUUBUUBUBBBUUBUBBUUUUUUUUUUUUBUUBUUUBUUUUUUBUUBBUUUUUUUUBB
UUUBBUBUUUUBUBUBUUUUBUBUUBBUBBBUBUUUBUUUUUUBUUBUUUBUBUUUUUUUUUUUBUBUUUBUBBUUUUUUUUUUUBBBUUBBBUBBUUBUU
UBUUUUUUUUUUUUUUUUUUUBBUUBBUUUUBBUUUUUUUBBUUBUBUBUBBUUBUUUUBUBUBUUUBUUUUUUUUUBUUUBUUUBUUBBUUUBBUUBUUB
UBUUUUUUUBUUUUBUUBUUUUUUUUUUBBUBUUBUUUUBUUUBBUUUBUBUUUUUUUUUUUUUBUUUBUUUUUUUUUBUBBUUBUUUUUUUBUUUUUUUU
UUBBUUBUBBUBUUUBBUUUUUUUUUUUUUBUUUBUUBBBBBUBUUUBUUUUUUUUUUUUUUBUUUBUUUUBUUUBBUBBUBUUUBBUUBBBBUUBBUUUB
UUBUBUBBUUUBUUUBUBUUUUUBBUUUBUBUUUUBUUUUUBBUUBUUUUUUBBUUBUUBUUUUUUUUUUBBUUBUBUUBUUUBUUUUUBBBUUUUUBBUU
BUUBUBBUBUUBUUUUUUUUBUUUUBUUUBUUBBBUUUBBUUUBBUUUUUUUUBBBUUUUUUUBUBUUBBUUUUUUUBUUBUUUUUUUUUBUUUUBUUUBB
UUUUUBUUUUUUUBBBUBUBBUBUUUUUUUUUUUUUBUUUUBUUUUBUUBBUUUBUUBUBBUUBUBUUUUUBUBBUUUUUUUUUUBBUUUUBUBUUUUUBU
BBUBUUUUBBUUBUBBUUUBUUUUUBUUUBBBUBUBBBUUUUUUUBBUBUUUBUUUUBBUUBBBUBBBBBUBUUUBUBUBUUBUUBUUUBUUUUUUUBUUB
BUUUBUUBUUUUUUUBUUUUBUBUUUUUUUUUUUBUBUBBUUBBUUUUUUUBUUUBUBUUUUUUUUBUUUUUUBUUUBUUUUBUUUUUUUBUUUBUUUBUU
UUUUBUUUBUUUBUUUUUBBBUBUUUBUUBBUBUUUUUUUBBUUUBBUUUUUUBBBUUUBUUBUUBUUBUUBUBUUUUUUUUUBUBUUUBUUBBUUUUUUU
UUUUUBUUBUUBUUUUUUBBUUUUBUUBUBBBBBUBBBUUUUUUUUUBUUUUUUBBUUUUBBUUUBBBUUUUUBBBUUUUBBBUBUUUUBBUUBUUUBUUU
UUBUUBBBUUUUUUUUUUBBUBUUBUUUUBBBBUUUBBUBUUUBUUUUUBBUUUBUUUUBBUUBBBUUUUUUBUUBUUBUBUUUUUUUBUBBUBBUBUBUU
UBUUUUUBUBUUBUUUUUUUUUBUUUUBUUUUUBUUUUUBBUUUUUBUUBBBUUUUBUUBUUUUUUUUUUUUUBUBBUUUUUBUUUUUBUBUBUBUUUUBU
UUBUUUBBUUBBUUUUUUBBBUBUUUUBUUUBUUUUUUUBUUUBUUBUUUUUUUBUUBUBUBUUUBUBBUBBBUUUUUBUUUUBUUUUUBUUBUUUUUBUU
BUBBUUUUUBUUBUUUUBUUBBUUUUUUUUUUUUUUBBUUBUUUUUUUUUBBBBUUUBUUUUUUUUUBUUBBUUBUUUBBUBUUUBBBUUBBUUUUUUUUU
UBUUUUBUUUUBUUUUUBBUUUBUBUUUUUUUBUUUUBBBUUBUBUUBBUUUUUUUUUBBUBBBUUUBUUBUUUUUUBUBUBBBUUUBUBUBUUBBBUBUU
UBBBUBUUBBUBUUUUUBUUUBBUBUUUUUBBBBUUUBUBUUUUUUUUUBUBBBUUUUUUBUUUUUUUUBUUUBUBBBBUUUUUBBUBUUUUUUUUBUBBU
BBUBBBBUUUUUUUUBUUUBUUUUBUUUBUUBBBBUUUBBUUUUUUUUBUUUUUUUUUBUBUUUUUUUUBUUUBUUUUUUUUUBUBUUBBUBUBUUBUBBU
BUUBUBUBUBUUUUUUUBUUUBUUBBBUUBUBUUUUUUBUBUUUUUUUBUBBBBBUBBUUBUUBUUUUUBUUBUBUBUUUUUUUUUUBUBBUUBUUBUUUU
UUBBUBBUUBUUUUBUBUBUUUBUUBUUBUUUBBUBUUUUBBUUBBUUBUUUUUUBUUBBBUBUUBUBUUUUBUUBUUBUUUUUBUUUUUUBUBUBUUBBB
UBUUBBBUUBUUUUUBUUBUUBBBUUBUUUBUUUBUUUUBBUBUUBUBBUUBUUUUBBUUUUUBBBBUUUBUUUBUUBUUUUBBUUBUUUUUUBUBBUUUU
UBUUUBBBUBBBBUUUBUBUBUUUUBBUUBUBUBUUBBBUUBBUUBUBUUUBUBUUUUUUBUUUBBUUBUBBBUUUUUUUUUUUBUUUUUUUUUUUUUUUB
UUBUUBUUUUUUBBUUBBUUBUUUBUBUUUBUUUUUUUUUBUUUUUUUUUUUUUBBBUUBUUUUUBUUUUBUUUBUUUUBUUBUUUBBBUBBUBUUUUUUU
BUUUUUUUBUUUUUBUBUBBUUUUBUUBUUUUBUBUUUBUBUUUBUUUUUBBUBUUUUBUUUUUUBUUUUUBUUUBUUUUUUBBUUUUBBUBUUBUUUBUB
BBBUBUUUBUUBBBBBBUUUUUBBUUUUUUUBUBUUUUUUBBBUUUBUUBUBBUUBUBUUUUBUUBUUUBBUBBUUUBUUUUUUBBUBUBBUUUUUBBUUB
BUBUUUUBUBUUBUUUBUBUUUUUBUBUUBUUBBUUUBUBUUUBUUUBUBUBUBUUUUUUUUUUUUUUBUUUUBBUBUUUBUUUUUUUUBUBUUUUUUUUU
BBBUUBUUBUUBBBUBBUUUUUUUBUUUUUBUUBBUUUUBBBBUUBBBUUUBUBUUBUUUBBUUBUUBUUBUUBUBBUUUUUUUBBUUBUBUUUUUUUBBU
UUUUUUUUUBBUUBUUUBUBUBUUUUUUBUBBUUBUBBUUUUUUUUUUUUUUBBBUBBBUBUUBUUBBUUBUBUBUBUUBUBUUUUUUUUBBUUUUUUUUU
UUBBUUUBBUBUBBUUUUUUUUUUBUUUBUUUUUBUUUUUUUUBUUUUBUUUUUUBBBUUUBUUUUBUBUUBBUBUUUUUUUUUBBUUUUUUUUBUUUBUU
UUUUBUUUUUUUUUUBUUBBBBUUUUUUUBUUUBBUUUBBBUUBBBUUBUUUUUUUBBBBUUUUUUUUUBUUUUUUBUUUBBUUBUBBUBUUUUBUBUBUU
UUUUUUUBUBUUUBUUBUUUUUUBUBBUUUBBUBBUBBUUUUUBBUBBUBUUUBUUBUBUUUUUBBUBBBBUUBUBUUBUBBBUUBUBBUUUUUBBUUUUU
UBUUUUBUBUBUBBUUBUBUUBUUUBBUUUBUUUUUUUUUUUBBUBBUBBUUBUUBUUUUUUUUUUUUUBBUUUBUBBUBUBUBUBBUBUUBUBBUUUBUB
UUUUUUBBUBUUUUUUUUUUUUUBUBUUBUBBUUUUBUBBBUUBUUBUUBUUUBBUUBUUBBBUUBUUBUUBBUBUBUUUUUUBUUUUUUUUBUBUUBBUU
UBUUBUUBBUUBBUUUUUUBUUUBUUBUUUUUBUUBUUUBUBBUUUUUUUUUUUUBBUBBBUUUUBBBUUUUUBBBBBBBUBUUUUUBBUUBUUUUUUBUU
UBUUBBUUBBUUBBUBUBBUUUBUUUUUBBUUUUUUBUBUBUUBUUUUUUBUUUBBBUUUUBBUUUBUUBUBUBUUBUUUBUUUUUBBUBUBUBUUUUUUU
UUUBBUUUUUUUUUBUBUUUBUBUBUUUUUUBBBUUUUUUBBUUUUUBBUUBUUUUUUUUUUUUUUUUUBBUUUUBBBBUUUUUUUUUBUBUUBUUUBUUU
UBBUUUUUUUUUUBUBUUBUBBUBUUBBBUBUBBBBUBUBBUBBBUUBBBUUBUBUUUBUUUUUBBBUUUUUBUUUUBBUBUUBUUUUUUUUBUUBUUUUU
UBUUBUUUUUUUUUUUUUUUUBBBBBBBUUUUUUUBBUBUUBBBUUUUUUUUUUUBUUUUUUUUUBUUUBUBUUBUUUUBUBUUUUUBUUUBUBUUBBBBU
UBUUBUBUUUUUUUUUUUBUUUUUBUUUUBBBBBUBUUUUUBUBUBUUBUUUBUBUUBBUUUBBUBUUUUUUUUUUBUUUUBUUUUUUUUBUBUBUBUUBU
BUUUUUUBUBBBUUUBUUUUBUBBUUUUBUBBUUBUBBBBBUUUBUBUUUUUUUBBUUUBUUUUBUUUUUBUUBUUUUUUUUBUUBBUUUUUBUBUUUUBU
UUUUUBBUUUUUUBBUBUBBBBBUUBUUUUUUUBBBBUUUUUUBUUUUUBBUBBUUUUUUUUUBUBUUUBUUUUUBUUBBUUUBUUUUUBUBUUBUBUBBB
UUUBUUUUUUUUBUUUUUBUBUBUUUUBUUUUUBUBUUUBUUUBUUUUUUBUUUUUUUUBUUUUUUBUBBUUBUBUBBUUUUUUUUUUBUUUUUBUUBBUU
UUBBUUUUUUUBUBUUUBBBUUUUUBUUUBUBUUBBUUUUUUUUUBBUUUUBUUBUUBUUUBBUBUUUUUBUUUUUUBUUUUBUBBUBUBBUBUUUUUUBB
BUUUBUUBUUUBUUUBUUUUUUUBBBUUUUBUUUBBBUBUUBBUUBBBUBBBUUUBUUUUBUBUUBBUBUBUBUUBUUUUBUUUUUBUUUUUUUBUUBUBB
UBUUUUUBUUUUBUUBBUBUUBBBUBUBBUUUUUUUUUBUUUUUBUUBUBBUUBUUUBUUUUUUUUUBUUUUUBUBBUUUUBBUUUUBUUBBBUBUUUBUB
UBBUBBUUBBBUUUBBUUUUUUUUUBUUUBUUBUBBUUUUUUUUBUUUUUUBUUUUBBUBUUBUBUBBUUUBBBUUUUUUUBBUBUUUUUUUBUUUUUUBU
BBUBUBUUUUBUUUUUBUUUUBUUUUUBUUUBUUBBUBBBUBUBUUBUUUBUUUUUUUUUBUUUUBUBBUUUBUUBUUUUUUUUUUUUBUBBUUUBUUBUU
UUBUUUUUUUBBUBUUUUUUUBUBUBUUUUUUUBUUUUUBUBUUBBUUUUUBUUUBBBUBUUUUUUUUUBUUUUUUUUUBUBBUUBUUBUUBUUUUUUUUU
UUUBBUBBBUUUBUUBBBBUBUBUBUUUBUBUBUUBUUUUUBUUUBUUUUUBUUBUBUUBUUUBUUBUUBUUUUUUUUBUBUUUUBUUUUUUBUUUBUUUB
UUUUUUBUUUBUBUUUBUUUUUUUUBBBUUUUBUUBBUUUUUUUBUBUUUUUUUUBUUUUBUUUBUUUUUBUUBUUUBUUUUUUBUUBBUUUUUUBUBBUU
UUUBUBUUUBUUUBUUUUUBUBBUUUUUBUBUUUBUUUUBBUBUBUBBUUBBUUBUUBBBBUBUBUUUUBUBBUUUBUUUBUBUUUUUBUBUUUUUBUUUU
UBUUBBUUUUBUUUUBUUUUUUBBBUUUUUBBUUBBBUBBUBBUUBUUUUUUUUBBUUUUBUBUBUBBUUUBUBUUUUUUUUBUUUUBBUUBUUUBUUUBU
BUBUBUUBUUUUUUUBUUUUBBUUUUBUUUUUUBUBUUBUBUUUUBUUBUUUUUUBUUUUUUUUBUUUUUUUBBUUUBBUUUBBUUUUUBUBBUBUUUUBU
BBBUBBUUUUUUUUUUUBUBUBUBUUBBUBBUBUBBUBUUUUBBUBUUUUUUBBUUUUUUUUUUUUUUUUBBUBUUBBBUUUUUBUUUUUBUUUUUBUUUB
UUUUBUBUUBBUUBUBUUUUUUUUUBUBUUUUUUBUBUBBBUBBBBBUUUUUBUBUUUUBBBUUUBUBUUUUBBUUUBUUBBUUBUUUBUBUUUUUBBUUB
BUUUUUBUUUBUUBUUBBBUBUUBUUBUUBUUBUUBUUUUUUUBUUUBBUBUUBUUUUUUUUUUBBBBUUBBUUUUUUUUBBBBBBUUUBUUUUUBBUBUU
UBBBBBUBUUUUBBBUUUUUUUUUBUUUUUBBBUUBBUBUUBBUUUUUUUUUUBUUBUBUBUUUUUUUUBUUUUUUUUUUUUUUBUBUUUUUBUUUUUUUU
UUUBBUUUUUBUUBUBBUUUUUUUUUUUUBUBBUUUUUUUUBUUUUBUBUBUBUUBBBUBBBUBUUBUUUBUUUUUBUBUUUUUUUUUUUUUUBUUBBUUU
UUUUUUUBUBBUUBUBUUBBUUBUUBBUUBUUUUBUBUBUUBUUBUUUUUBBBUUUUUUBUBBUUUUUBUUBUBUBUUUUUUUUBUUUBUUUBUUUUBBBU
UUUUBUUUBUUBBBBUUBBUBUUUBUUUUUUUUBUBUUUBUBUUUBBUUBUUUBUUUUUUUUUUUUUBUBBUUUUUUBUUUUUUBUUBUUBUUUBUUUUUB
UUUBUBUUUUUUUUUUBUBBBUUUUUUBUUUUUBUBUUBBUUUBBUUBUUUBUUUUUUUUUBUUBUUUUUUUBUUUUBUUUUBBUUUUUUUUUUBUUBBUB
UBBUBUUUBUUUUBUUUBBUUUUUUBUUUUUUUBUUUUUBUBUUUUUUUUUUUBBUUUBBUUUUUBUUUUUUUUUBUUUUBUUBUBBUUUUUBBUUUUUBB
UUBUBUUUUBUUUUUUUUBUUUUUUUUUUBUUBUUBBUUUUUUBUBUUUUUBUBUUBUUUBUUBUUBBUUUBBUUUBUUBBUUBUUUBBBUBUUUUUUBUU
UUUUUUBUUBUBUBUUBBUUUBUUUUBUUUBUUUUBUUUUUUBUBUUBUBBBBUBUUUUUUUUBUUBBBUBBUBBUUBUUBUBUUUUUUBUUBUBUUBUUU
UBUUUUUUUUBBUBUUBUUBBUUUBBUUBUUUUUUUUBUUBUUUUUUBBUUUUUUUBBUBUUUBBUUUBUUBUBUUUBUUUBUBUUUBBUUBUUBBUUUBB
BUUUUBUUUUUBUUUUBBUUUBUUUUBUUUUUBBUUBUUUUUUBUUUBUUUBUUUUUUUBUBUUUUBBBUUBBUUUUUBUUUUUUBUUUUUUUUUBUBUBU
UBUBUUBUUUUUUUUUBUBBUUUUUBUUUUUBUBUUBUUUUUUBBBBBBBBUUUBUUUBBUUBUBUUUUUUUUBBBUUBUUUUUUUUBUUUUUBUUUBBUU
UUUUUBBUUUUBUUUUBBUUUBBBUUUBBUUBBUUUUUUBBUBUUBUUBUUUUUUUBUUUBUUUUBUUUUUBUUUUBBBBUUUBUBUUUUBUUUUUUUUUU
UBUUUUUBBBUUBUBBUBBUBUUBBUUBUUUBBUBUUUUUUUBUBBUBUUUUUUUUUBBBBUBUUUUBUUUUUUUUUUBBBUUBBBUUUUUBUUUUUUUUU
UUUUBUUUUUBBUUBUUUUUBUBUUBUUUUBBBUBUUUBBBBBUUUUUUBUUUUUUUBUUUBUBBUUUUUUUUBUUUBBUUUUBBUUUBUBUUUUUUUBBB
BUUUUUUBUUBUUUUUUBUUUBUBUUBBUUBBUBUUBBUBUBUUUBUUUUUBUBUUUUBUUUUUUBUUUBUBBUUUBUBUUBUUUUUUUUUUBBUUUUUUU
UUBUUUUUBUBUUUUUUUUUUBUUUUUUUUBUUUBUUBUBUUUUBUUUUUUBBBUUUUUUUUUUUUUUUUUUBBUBBUUUUBUBBUUUBUBUUUUUBBBUU
UUUUUUBBBUUUUUUUUUUUUBUUUBUUUBBBUUUUUBUBBUUUUBUUUBBUBBBUBBUUUUUBUUBUUUBUBUUBUUUBUUBUUUUBUUUBBUUUBBBBU
UBBUUBBUBUBBUUBUBUUBBUBUBBUUUUBUBUBUUUUUUBUUUUUBBUUBBUUUUUUUUBBUUUUUUUBBUBUUUUUBBBBUBUUBUBUUBUUUUUUUU
BBBUUBUUUUBUUUUUUUUUUBUUBBUUUBUUUBUUUBUBUBUUUUUUUUUBUUUBUUUUUUUUBUBUBUBUUBBBBBBBBBUBUUBUBBUUUUUBUUBUB
UBBBUUUBBUUUUUUBBUUBUBUUUBBUUUUBBUUUUUBUBUUUUUUUBUBUUUUBUUBUBUBBUBUUBUUBUUUUUUBUBUUUUUBBBBUBUBUUBBUUU
UBBUUUUUUUUUBBBUUBUUBUUUUUUBUUUUUBUUBUUBUUUBUUBBUUUUUUBBUBBUUBBUBUBUUUUUBUUUUBUUBUBUBUUBBBUUUUUUUUBUU
UBBUBUBUUUBBBBUUBUUBUUBUUUUUUUUUUBUUUBUBUBUUUUBUBUUBUUUUUUBUUUUUBUUUUUUUUBUBUUUUUUUBUUUUBUBUUUUUUUBUU
BBUUBUUBUBBUUUUUUUUUUUBUBUUBUUUUUUBBUUBBBUUBUUUUUBUUUUUUUBBUUBUUUUBUUUBUUUBUUUUUBUBBUBUUBBUUBUUUBBUUU
