UBBUUUUUUUBBBUBBUUBUBBUBBBUUBUUBUUUUBUBUUBUBUUBBUUUBUUBUBUUBUUUBUBUUUBBBUUUUUUUBUUUUUUUUBUUUUBUUUUUUB
UUUUUBUUUUUBBUUUUBUUUUUUUBBUBUUUUBBUUUBUUBUUBBBUBUUUUUUBUUUUUBUUBUUUUBUUUUUUUBBBUUUBUUBUBBUUUUUUUUUUB
BBBUBUUUBUUBBUUUUUUUUUUBUBUBBUBUUUUBUBUUUUBUUBUBBUUUUUUUUUUBUUBUBBUBUUBUUBUUUUUUUUUUUBUBUUUUUUUUUBUBB
BUUUBUUUBBBUUBUBUUUUUUUUUUUBBUUUUUUBBUUUUBUUBUUUBUUUBBBBBUBBUUBBBBUBUUUUBBUUUUUUBUBUUUUUUUUBUUUBBUBUU
UUUBBUUUBBUUUUUUUUUUBUUUUUBBBUUUUBUBUBUBUUUUBUUUUBUUUUUBBUUBUBUUUUUBUUUBUUUUBUUBUUBBUUBUUUUBUUUUUUUUB
BUUBBUUBUUUUUUUUUUUUUUUBBUUUUBUUUUBUUUUUBBBUUUUBUUBUUUUUUUUBUBBUBUUUUBBUUUBUUBUUUUUBUUUUUUUUUUUUBUUBB
UUUBUUUUUUUUBUBUUBUUUUUUUUBBBUUUBUUBUUUUBUUUUUUUUUUUBUUUBUBUBUUBBUUUUUUUUUBBUUBBUBUBBUBUUBUUUUUUUUBUU
UUUBUUUBUBBUUBUUBBBBBUUUBBUBUUUUUUUUUUBUUUUUUUUUUUUBUBUUBBUUUUUUUUUUUBUUBBUBBUUBUUUUUUUUUUUUUUUUBBUBU
UUBUBBBBUUBUUUUUUBUUUBBBUUUBBBUUBUUUBUBUUUBBBUUUUUBUUBUUBUUUUBUBUUBBUBUUBUBUUUUBUUBUUUUBBUUBUBUBBUBUB
UBUUUUUUUUBUBBBBUBUUUUUUBUUBUBBUUBBUUUUBUBUUUBBUUUBUBUBBUUBBUBUBUBUBUBUUUUBUBUUUUUUUUUBUUUUUUUUUUUBUU
UUUUUUBUUUUUUUUUUUUUUBUBUUBUBUUBBUBBUBUUUUUUUUUUUBUUBBBBUBUUUUUBBBUUUUBUBUUUUUUUBUUUUUUUUUUUUUUBUUBBU
UUUUBUUBUUUUBUUUBUBUUUBUUUBUUBUUUBBUBUUUBUBBBUUBUUUUUUUBUUUUUUBBUUUUUUUUUUBUUUUBUUUUUUBUUBBUUBUUBUUUU
BBBBBUUUUUUUUUUUUUUUBBUUBBUUUUUUUUUUBBUUUUUUUUUUUUUUUBUBUUUBBUUUUUUUBUUBUUUBUUUUBUUUUUUUUBUBUUUBUUUUB
BUUUUUBUUBBUBUUBUUUUUUUUUUUUUUBUUUUBUUUUUUBUUUUUBUUBBUUUUUUBBUUBBUUUUBUUBUBUUUUUBUUBBUUUUUUUBUUUBUUBU
UUUUBBUUUBUUBUUUBBUUUBUUUUUUUUBUUUBUUUUUUUUUBBUUBUBUUUUUUBBUBBBUUUUBBUUBBUUBUUBUUUUUBUUUUUBBUUBUUBUUU
BBUUUUUBUUBBUUUBBBUUUUUBBUBBBUBUBBUUUUBBUBUUUUUUUUUUUBBUUBUUUUBUUUUUUBBUUUUUUUBBBBUUUUUUUUUBBUBUUUUBU
UBUUBBUUUBBUBUUUBBUUUUUBBUBBUUBUUBBUUUUBUUUUBUUBUBUBUUUUUUBUUUBUBUBBUUUBUUUBBUUBBUUUBUBUUUUBUBUUUUUUU
BBUUUUBBUBBBUUUUUUBUUUUUUUBUUBUUUUBUUUUUUBBUUUUUUUUUUUUUBUBUUBBUUUUUBBUUUUUUUUUBUUUUUUUBUBUUBBUBUBUUB
UUBBUUUBUBUBBBUUUBUUBBBUUUUUUUUBUUUUUUUUUUBUUUBBUBBUUUUBUUUUUUUUUUUUBUUUUUBUUUUUBBUUUUUUUBUUUUUBUBBUU
UUBBUUUBUUBBUUBUBUUUUUBUUUUUUUUUUBUUBUUUUUBUUUUUUUUUUUUUUUUUUUBBBUBUUBUUUBBUUUBUUBUBBUUBBUUUUUUBUUUUU
BBUBUBBUBUBBUUUUUUBBBBUBUUUUBUBUBBBUUBUUUUBBUUUBUBUUBUUUUBUUUUUUUUUUUUUUUUUBBUUBBBUBUUUUBUBUBUBUUBUBU
UUUUUUBUUUUUBBBBBUUUBUUUUUUUUUUBBUBUUBUUUUBUUUBUUUUUUUUUUUUUBUUUUUBUUUUBUBUBBUBUUBBUUUUUUUUBUUUUBUUUB
UBUUBUUUUUUUBBBUUUUBUUBUUUUUBUBUUBUUUUUBBBBUUBUUUUBUUUUBBUUBBUUUUBBBBUBUUUUUUUUUUUBUUBUUBUUBBUBBBBUBU
BBUUUUBUUUUBUBBUUBUBUBUUBUUUBUUBUUUUBUUUBBBUUBBUUBUUBUUUUUUBUBUUUUUUUUBUBUBUUUUUBUUUUUUUBUBUUUUBUBUBB
UUUUUBBBUBUUUUUBUBBBBBUBUBBUUUBUUBUUUBBUUUUUUUUUUUBBUUUUUUBUBBUUBBUUUUUBUBUUUBUUUUUBUBUUBUBUUUBBBBBUB
UUBUUUUUUUBUBBUUBUUUUUUUUUBUBUUBUUBBUUUUBBUBUBUBBUUUBBUBBUUBBBUUBUBUBUBUUUUUUUUUUUUBUBBBUUUUUBUUBUUBU
BUUUUUUUBUBUUUUUUBBUUUUUBUBUUUBUUUBBBUBBBUBUUBUBUUUBBBUUBBUUUBUUUUUUUUUUBBUUUBBBUUUUBUUUBUUUUBBBUUUBU
BBBUUUUBUUUUUUUUBUUUUBBUUUUUUUUUUUUUBUUUUBBUUUUUUUUUUBUBUUBBBBUUUUUUBUBBBUUUBUBBUBUUUUUUBBBUUUUUBUUBU
BUBUUUBUBUUUUBUUUUBUBUBUUBUBBBBUUBUBUBUUUUUUUUUUUUUBBUUUBUUBBUUBBUBUUUBUUBBBUBUBUUUBUBUUUUUUBUUUBBUUU
UBBUBBUBBUUUUUUUUUUUUUUUBUBUUUUUUBUUBUUUUBUUUBUBBUBUBBUBUUUUUBUBBUUUUUUUUUUUUUUUUBBUUUUBUUBUUUUBUUUUU
BBBBBBUUUUUUBUBUUUBUUBUUUBUUUUBBUUUBUUUUUBUUUBBUUUUBUUUUUUUBUUBUBBBUBUUUUUUUUUUUUBUBBBUUBBUUBUUBUUUUU
UBUUUUBUBUUUBUBBUUUUUUUBBUUUBUBUUUUUUBBUUUUBUUUBBBUUBBUBBUUBBUBBUBBBBBUUUUUUUBUUUUBUUUUUBUUBBUUBBUBUB
UUUUUUUUBUUUBBUBUUBUBUUUBBBUUUBUUUUUUBUUUUUBUUUUUBUUUBBUUBUUUBUUBUUUBBUUBUBBUUUUUBUBUUBUBUBBBUUUUUUUU
UUUBUUUUBBUUUUUBUBBUUUUUUBUUUBUUBUUUUUUUUBUUUUBUUBUBUUUUUBUBUUBUBUUUBUUUBUUBBBBUBBUUUUUUUBUBBUUBUUUUB
UUUUUUUUBUBUBBUBUUBUUUBBBUUUUBBUUBBBBUUUBUBUBBBBUUUBUBUBUBUBUUUBBUUUUUUBBUBUUUUUUUBUUUUBBUUUBBUBUUUBB
UBUUBBUUUUUUUUUUUUUBUUUUUBBUUUUUUBUUUBUBUUBUUUUUBBUUUBBUBUUBBUBUUBBBUBUUUBBUUUBUUBUUUUBUUBUUBBUUUUUUB
BUUBUUUUBUBBUUUUUUBUUUUUBUUUUUBBUUUBUUUBUUBUUUUUUBBUUBUUBUUBUBUUUUUBUBUUUUUBBUUUUBBBBUBBUUBUUBUBUBUUU
UUBUBUUBUBUBBUUBUUUUUUUBUUUUBUUUUUUBUUUUUUUUUUUUBUUUUBUBBUUUBUBBBUUUUUUUBUUUUUBBUUBBBUBBBUUBUBUUUUBUU
UUUUUBBBUBUUBBBUBUUBBUBUUBUUUUBBBBBUUBUUUUBBUBUUUUUUUBUUUUUUBBUBBUUUUUUUUUUUBUUBUUUUUUBUBBUBUUUUBBBBU
UUUUBBUUUBUUUUUBUUUUUUUUUBBUUBUBBBUUUBUBUUBUUUUUUBBBUUUUBUBUBUUUBUBUBBUUUUUUUUUUUBBUBUBUUUUUUUUUUUBBU
UUBUBUUBUUUUUUBBBUUUBBUUUBUUBBUUUUUUUUUBBBUUUUUBUUUUBBUUUUBBBUBBBBUUUUUUBUUUUUUUUUUUBUUUUBBUUUUBBUUUU
BUUUUBUUUUUUUUBUUUBUBUUUUUUUUUUBUBUUBUBBUBUUUUUUUBBUUBUUUBBBUBUUBBBUUUUBUUBBUBUBUUBUUBUBUBUUUBUBUUUUB
UBUBUUUUBUUUUBBUBUUBUUUUUUUUUUUUUUBUUBUBUUUBBUBUUUUUUUBUBBBUBUBUBUUUBBBBUUBUBUUBUBBUBUUBUUUUUUUUUUBUU
UUUUUUUUUBBUUUUBUUBUUUUBUUUUUUUUBUUUBBBUUUUUUUUUUUUUBUUUUUUUUUUUBUBBUUUBBUUUUUBUBBBUUUUUUUUUUUUUUBUUB
BUUBBUUBBBUUUUUUUUUUUUBUUBUBBUUUBUBUUUUUUUUUUUUUUUUUUUUUUBUUBUUBUBUUBUUUBUUUUUUUUUUUUBBUUUBUBUUBUUUUU
UBUBBUUBUBUBBUUUBUBBUUUUUUBBUBUUBUBBUUUUUBBUUBBUUUUUBBBBUUBUUUBUUUUUUBUUBUUUUUBUUBUUUUUUUUUUBUUUUUBUB
UBBBUUUUBUBUUUUBBBUUUBBUBUBBUUUUBUUBBUUUUBUUUUUUBUUUUUUBUBBUBUBUUUUBUUBUUUBBUBUUBUBBBUUBUUUBUUUUUUUBU
UUUBUBUBBUUUBBUUUUBUBBUBUBUBUUUUUUUUBBUUUUUUUUUUUUUUUUUUBUUUBUUUUUUUBBUBUUUBUUUUUUUBUUBUUBUBUUUUBUBUU
BUBBUUUBUBUBBBUBBUUBUBUUUBUUUUBUBBBUUBUUUBBUUBUUBUUUBBBUUUUUUUUUBUBUUUBUUUUUBUUBUBBUUUUUUUUUUUUUBBUUU
UUUBUUUBUBUUUUBUUBUUBUUBUUUBUBUUUBUUUUUUUUUUUBUBUUUBBUUBUBUBUBUUUUBUUBUUUUUUUBBUBUBUUUUUUUUUBUUUBUUUB
UUUUBBBUUUUBUUUUBUUUUUUBUUUBBUBUUBBBBUUUBUUUBBUUUUUUUUUUBUUUUBUBUBUUUUUUBBUUBBBBUUUBBBUUUBUUBUUUBBUBU
UUUUBUUUUUBUBUUUUUUUUBUBUUUBUUBUBBUBUBBUUUUBUUUBUUUBUUUBUUUUUUBUUUBUUUBUUUUBUUUUUUUUBUBUBBBUUUBUUUUBU
UUUUUBUUUUUUUUBBUUUUUUBUBUUUUBUUUUBUUUUUBUBBBUBUUUUBUUBUUUUBUUUUUUUUUBUBBUUUUBUUUBUUUUBBBBBUUBUUUBUBU
UUBUBUUBUUBUUUBUUUUBUUUBUUUUBBBUUUUUUBUUUUBUUUUUUUBUBUBBUUUUUUUBUUUBUUBUUUUUUBUUUUBBUUBUUBUUBBUBUBUUU
BUUUBBUBUUBUUUBBUBUUBUBUUUUBUUUUUUUUUUUUUUUUUUUUBUBUUBUUBUUUUUUUUBBUUUUUUUUUBUUUBUUUUUBBUUUUUUUUUUBUU
UUUUUBBUUBBUUBBBUBUUUUBUUUUUBUUUUUUBUUUBUUBUUUBUBBUBUUUUBUUUBUUUBBUUUUBUBUUUUUUUUUBUUUUBUBUBUUUUUUUBU
UBUBBUUUUUUUUUUUUUBBUUBUUUUUUBBBBUUUUBBBUUUBUUUBUBUUUUUUUUUBBUBUUUUUBUUUUUUUBUBBUBUUUUUUBBUUUUUUBBBUU
UUUUUUUUBUBBBUUUUUUBUBBBUBUBUUUUBUUBUUBUBBUUUBUBBUUUUUUBUUUUBUUUUUBUBUBBUUUUUBBUUBUBBBBUUUUUUUUUUUUUU
UUBBUBUUUUUBBUUBUBUUUUUUBBUUBUUUUUUUUUBUUBUUUUUBBUUUBBUUUUBUUUUBUUUUUUUUBUUBBUUBUUUUBBUUUBBBUUBUUUBUU
UBBUUUUUUUUBUUUBUBUBUUUUUUUUUBUBUUUUBBUUUUUUBUBUUUUUUBBUUBUBBUUUUUUUUUUUUUUUUBUBUBBUBUUUBBUBUBUUUUUUU
UUUBUBUUUBBUUBUUBUUBUBBBBUUUUUUUUBBUUBUUUUUUUBBUUUUBBUBUUUUUUUUUUUBUUUBBUUUUUUBUUUBBBBUBBUBBUUUUUUUUU
UBBUBUBBUUUUBUUUUUUUUUBBBUUUUUUUUUUUBBBBUUBBBBBBBUUBUUUUUBBUBBBBUUBUUUUBUUUBUBBUBUBUUBUUUUUUUBUBBBUUB
UUUUBUBUUUUUBUBUUUBUBBUBBUUUUBUUUBBUUUUUBUUUBUUBUBUBUUUUUUUUBUBBUUUUBUUBUUUBUUUBUUUBUBBUUBBUBUUUBUBBU
BBBUBUUUUBBBBUUBUUBUBUUBUUBUBBUUUBBBUUUBUUUUUBUBUUUBBBBUUUBUBBUBUUBUUBUUUUUUBUUUUUUUUUUBUUUUUUUBBUUUU
BUUUBUUBBUUUUBUUBUUBUBUUUBUUUBBUUUUBBBUUUUUBUBUUUUUUUUUUUUUUUUBUUUUUBUUUUBUUUUBBBUUBUUUUBUUUBUUUBBUUU
BBBUUBUUUBBUUUBUUUBUUUUUBUUUBUUUBUUUUBUUBUBUBBBUUUUUUBUUUUUUUBUUBBUUBUUUBUUBBBUUBBBBUUBUUUUBUBUUUUUUB
UUUUUBUBUUUUUUUBUUUUUUUUUUBBUBUUBUUBUUUUUUBBBUUUBUUUBUUUUUUUUUUUUBBUUUBUBUUUBUUUUUUUUUUBUUUUUUBUUBUBU
UBUBUUBUBUUUUUUUUUUUUUBBBUBUBBUBUUUBUBUUUUUUUUUBUUBUUBUUUBUBUUBUUUUBUBUBUUBUUUUUUUBUBUUUBUBBUBUBBUUBU
UUUUBUUUBUUUUUBUUUUUUUUBUUBUBBBUUUUUUBUUBBBUUUBBBUUUUUUUUBUUUBUUBUBUBBBBBBUUUUUUBUUUUBBUBUBUUUUUUUBUU
BUBUUBUUUUUUUBBUBUBBUBUBUUUUUUUUUUUUUUUBUUBBBBUUUUUUBUBUBBUBUUUUUUUUBUBUUUUBUBUUBUBUUBUUUBUUBBUUUBUBB
UUUUBUBBBUUUUBUBUUUBUUBUUUUBUUUUUBBUBBBUUUBUUBUUUBUUUBUUUUBUUBUUUUUBUUUBUUBUBUUBUUUUBBBBUBUUUBBUBBBUU
UUUUUUBUUUBBUUUBUUUBUBUBBUUUUUUBBUBBBUUBUUUUBBUUBBUBUUBUUUBUBUBUUUUBUBUUBUUBUBBUUUUUUUUUUUUUUUUUUUUUU
UUUUUUBUUUBUUUBUBUUUUUUUUUUUBBUUBUUBBUBBBUUUBUUUBUUUUBUUUUUBUUUUBUUUBBUUUBUUUUBUUUUBBUUBBUUUUBUUUUUUU
UBUUUBBBUBUUBUUUBUBUUBBBUBUUUBUBBUUBUUUUUUUUUUBUUBUUBUBUUUUUUUUBUUBBUUUUUUUUUUUUBUUUBUUBUUBBUUUBUUUUU
UUBUUBUBUUUUBUUBUBUUUUBBUUBBUUUUUUUUBUUUUUUUUBUUBBUBUUUBBUUUUUUUBBUBBUBUUUUUUUBUUUUUUBUBBUUBUUUUUUUUU
UUBBUBUBBUBUUUUUUUUUUBUUBBBUUBUUUUUBBUUUUBUUUUBBUUBBUUUUBBUUUUUBUBUBBUUUUUUBBUUUUUUUBUUUUUUUUUUBUBBBB
UBUUBUBUUBUUUUUUUUBUUBUBUUUUUUUUBUUUBBBBUUBUBUBUUUUUBUBUUBBUUBBUUUBUBUUUBUUBUUUUUUUUBUUUUUUUBUBUUBUUB
UUUUUUUUBUBUBUUUUBUUUUUUUBUUUUUBBBUBBUUUUUBUUBBBUUBUUUUUUBUBUUBUUUUUUUUUBBUBUUUUBUUUUUBUBUUUUUUUUUUUU
BUUUUUUUUUUUUBUUBBBUUBUUUUBBUBUUUUUUUUUUUBBUUUUUBUUUBUBUUBUUUUBUBUBUBUUUBBBUUUUUUBUUUUUUUBUBUUBBUUUUU
BBBUBBBBBUUBUBBUBUUUUUUUUUUUUUBUUUUUBUBBUUUUBBUUBBUUUUUUBBUUUUUUUUUUUBUUUBUUUUUUBBUUBUUUBUUUUBBBUUBBU
UUBUUBUUUBBBUUBUUBUUUBUBUBUUUUUBUBUBUUUBUUUUBUUUUUUUUUUUUUBBBUBUBUUBUBBUUUUUBUUBUUUBBUUUUUBBBUUBUBBUU
UUUBUBUBUUBBUBUBUUUUUBUUUUUBBUUUUBBUBBUUUUUUUBBUUUUUUUBUUUUUBUUUBUBUUBBUUUBUUUUUBUUUUUBBUUBUUUUUUUBBU
UUUUBUBUUBUBUBUUUUBUUUUBUBUUUUUUUUUUUUUUBUUUBUUUUUUUUUUUBUUUUUUUUBUUUUBUBBUUUBBUUUUUUUBBUBBUUUUUBBUUU
UBBUUBBUUUUUUUUBBUUBUUUUUBBUUUUUUUUUBUUUBUUBUBUBUBUUBUBUBUUUUUUUUUBBUUUUUUBBBUBUUUUUUBUUUUBUBUBUUUUUB
UBBBUBBUBUUUUUUBBUUUUBUBUBUBBBUBUBUBUUUUBUUBUBUUUUBUBBUUUUUUUBUUBUBUUUUUUBBUBBUUBBUUUUBUUUUUBUUBBUUBB
UUUUUBUBUUUBUUUBUBUUUUUUUUUUUUUBUBUBBBBUBUUUUUBUBUUUBUUUUBBUBUUBUBUBUUBUBBBUBUUUBUUUBBBUBUUUBBUUUUUBU
UUUUUBUUBUBUUUUBUUUBUUUUUUUBUUBUBUUUBUUUUBUBBUUBUUUBBBUBBUUUUBUUUUUUBUUBBBUUBUUUUBUUUUUUUUUUUUUUUUUUU
UUBBUBUBBUBUUUBUUUUBUUUUBUUUUUUUBUUUUUUUUUUBUUUBUBUUUUBUBUUUUUUUUUBUUUBBUUUUUUUUUUUUUBUUBBUBUBUUBUUUB
BUUUBBUUBUUUUUUUUUUBUBUUBUUUBBBUUUUUUBUUUUUUUBUUUBBBUUUBUUBUBUUUUBUUUUUUUUUBUBBUBUUUUUBUUBUUBBUUUUUUB
UUUUUBBUUUUUUUUBBUUBUBBBBUUUUUUUBUUUBUUUBUUUUBUUBUBBUUUUUUUUUUUUBUUBBUUUUBBBBUUBUUUUUUBUBUUUUUBUUBUUU
UUUUUBUBBBBUUUUUUBUBBUUUUUUUUBUUUBBUUUUUUBUUUUUUUUUUUBUBUUUUBUBBUUUUUUUBUBUBUUUBBBUUUBUBUUBBUUUUUBBUU
UUBUUBBUBBBUUUUBBUUUUUUUBBUUBUBUUBBUUUBBUUBUUUUBUUBUUUUUUUUUUUUUUUUUUUUUBUUBUUUUBUUUUUUUUUUBUBBUUBUBU
BUUUUUUBBUBBUBUUUBUUBUBBUUUBUUUBUUUUUUUUUUUBBBUUUUUBUBBBUUUUBUUUBUBUUUBUUBUUUUUUUBBUUBUUUUUBUBBUBUBUU
BUBBUUUBBUUUUUUUUUBUUUBUUBBUUUUUBUBUUUBBUUUUUUUUUUBUUUUUUUBBBBUUUUUUBUUUUBUUUUUUBUUUBUUBBUUUUUUUUBUUU
UUUBUBUUUUBBBBBUUUBUUUBUUBUUUUBUUUUBUUUUBUUUUBUUBBUBUUUUBUUUUBBBUUUUUUUBBUUUUUUBUUUBBUUBUUUBUBUUBBUUB
UUUUBUBUUUUUBUBUUUUBBUUBUUBBUBBBUUUUUUBBUUUUBBUUBUUBUBUBUUUBBBBUUBUUBUUUBBBBBUUUUUUBUUUUBUUUBUBUUBUUU
UUUUUUUBUUUBUUUUUUUBUBBUUBUUBUUUUUUBBUUUBUUBUUUBUUUUUUUUUUBUUBBUUUUUUUUBUUUUUUBBUUUUUUUBUBUBUUBUUUBBU
BUUBUUUUUUUBUBBBUUUUUUUUUUBBUUUUUUUUUBBBUBBUUUUUUUUBBUUUUUUBUUBUBUUUUUUUUUUUUBBBBUBUUUUBUBUBUUBBUBBBU
UUBUUBUUUBUUBUUUUUUBUUBUUBBUUUUUBBUUUBBBBUUUBBUUBBUUUUBUUUBUUUBUUUUUUUUUUBUBUBBUUUBUUUUUUUUUUUUUUBUUU
UUBBBUBUUUUUBBUUBUUBUUUBUUBBUUBUBUBUUUUUUBBUUUBUUUBUUUBUUUUBUBUUUUBUUBUBUUBUUBUUBBUUUUBUBUUUUBUUUBUUU
UUUUBBBUBUUBBUUBBUUBBUBBUUUUUUUUBUBUBUUBUBBBUUUUBUUUUUBUUUUUUUBUUBUBBBUBUBUUUUUBBUUBBUUUUBBUBBUUUUUBU
