UBUUUBUBUUBUUUBUUUBUBUUUBUUBUUUUBBUUUUUBBBUUBUUUUUUBBUUUBUBBBUUUUUBUBUUBUBUUUBUBBUUUUUBUUBUBUBUUUUBBU
UUUUUUUUUUBUBBBUUUBUBBBUUUUUUUUUBBUUUUBBBUUBBUBUUUUBBUBUUUUUUBUUUUBUBUBBBBBBUUUUUUUBUBBBBUBBUBUUUUBUB
BUUBUUUUBBUBUUUUBUUUUUBUUBUUUUBUUUUUUUBBUBBUUUBUBUUBUBUBUBUUUUUBUBBUUBUUBUBBBBUUUBBBBUBBBUUUBUBUUUBUU
UBUUUBUUUBUUUUUUBBUBUBBUUBUBUUUUUUUUUUBUBBBUBUUUBUUUBBBUUUUBUUUUUUBBUUUBUBUUUUUBBBUUBUUBUUBUUUUUBUUUU
UBUUUUUUUUBUUBUBBUUBUUUUBBUBUUBUUBUUBUUUUUUUUUUBBUUBUUBBUBUUUUBUUUBUUUUUUBUUUBUBBBBBBUBBBUUUUUBUUUUUU
BUUUUBUUUUUUUUUUUUBUBBBUUUBUUBUUBUUUUBUBUUBBUUUUUUUBBBUUUUUUUUBUBBBUUBUBUUUBUUUBUBUUUBBUUUBUUUBUUUUUB
UBBUUBUUUUUUBUUBUBUUUUUUUUUUUUBUBUUUBUUUUUBUUUBBUUUBUUBUUUBUUUUBUUUUUUBUUBUUUUUBBBUUBUUUUUUUBUUBBUUUU
BUUUUUUUUUUUUBBBUBBUBBUBBUUUUUUUUBBBBUBUUBUBBBBBBUUBUUUUBBUBUBBUBUUBBUBUUUBUBUBUUBBBBBUUUBUUBUUUUBUBU
BUUUBBUUUUBUUBUBBUUUUUUBUUUBUBUUUBUUUUBBUUBBBBBBUUUBBBBUUBUUBUUUUUUUUUBUUBBBUBUUUBBBUUUUBUUUBUUBUUUUB
UBUUBBUUUUUBUUUUBUUBBUBUUUUBUUUUUUBUUBUUBUUBUUBUUBUBBUUUUBUUUBUUUUUUUUUUUBBUUBUBBUUUUBUUUUBUBBBUBUUUU
UBUBUBUUBUUUUUUBUUUUBBUUUUBUUUBUUUUUUBUUUUBUUBUUUUUUBBBBUUUUBUUBUBUUBUBUBUBUUBBUBUUUUUBUUUBBBUUUUUUUU
UUUBUUUUUUUUUBUUBUUBUUUUUBBUUBUBUUBUUUUUBUUUBUUUUUUUBBUUUUUUBUBUUUUUUUUBUUUBBUUBUUUUBUUUUBUUUBUUUBUBU
BUUUUBUUUUBBUUUBUUUUBUUUUBUUBUUUUUUUUUBUUUUUUUUUUUUUUUBBBUUUBBUUBUUBBBUUUBBBUBBBBBBUUUUUUUUUUUUUUUBBU
UUUBUUBUUUUUUUUBUUUUUUUUBUBUUUUUUUBBBUBUUUUBUUUBBUUUUUBUUUUUUBUBUUUBBUBUUUUUUBUUBBBBUBUUUUUUUUUBUUUUU
UUUUUUUUBUBUBUBUBUBBUUUUUUBUUBUUBBUUBBBBUUBUBUUBUUUUUBUUUBBUUBUUBUUUUUUBUBBBUUUUBUBUBUUUUBUUUUUBUBUUU
UUBUBBUUUUUUBUUUUUUBUUUUUUUBBUUUBUUUBUBUBUUUUUUUUUUUUBUUUUUUUBUBUBBUUUUUUBUUUBUUUBBBBUUBUUUUUUBUBBUUU
UBUUUUUBBUUUUBBBUBUUUBBUUUBBUBBBBBUUUUBUUUUUBUUUUUBUUUUUUUUUBUUUBUUBUBUBUUUUUUBUUUUBUUBUBUUUUUUUBBUUU
UUBBUUUUUBUUBUBUUUBBUUUBBUUBUBUUBUBUBUUUBUBUUBUUUUUUUUBUUBUUUUBUUUUUUBBUUUBBUUBBUBUUUUUUUUUUUUUUUUUUB
UUBBUUUUBBUUBBUUUUBBUUBUUUUUBBUUUUUUUBUUUUUUBUBUUUUUBUBUUUUUUBBUBBBUUBUUUUBUBBUUUUUUBUBBBUUUUUBUUUUBB
UUUUUUUBUUBUUBUUBUBUUUBBUUUUUUUUUBUUBUUBBUUBBUUUUBUBBBUUUUBUBUUBUUUUBUBBBBUUUUBBUBBUBUUUBBUUUUUUUUUUB
BUUUUUBUUUUBUUUBUBUUUUBUUUBUBBUBBBBBUUUBBUUBBUBUBUBUUUUUUUUUBBBUBBBUUBBBUUUUUUUBUBUBUUUUUUBUBUBBUUUUB
UUBUUUUBUUUUUBUUBUUUUBUBBUUBUUBUUUBUUUBUUBUBUUUBUUUUBUBUUBUUUBUBUBUUUUUUBUUBUUBBUBUUUUUUUUBUBUUUUBUUB
UUBUUUUUBUBBUUUUUUUUBUUUBBBUBUUUUUUUUUUUBUBUUUUUBUBUUUUUUBUBUBUBUUBBBBBUUUUUUBUBUBBUUUBUUUUUBBUBBUBBU
UUUBBUUUUUUUUUUUUBBBUUUUUUBUUUUUUUBUUUBUBUBUUUUUBUUBUUBUBUUUUUBUBUUUUUBUBBUBBUUUBUBUBUUUUUUUBUUUUBBUB
UUUUBUUUUUUBUUBBUUBUUUUBUUUUUUUUUUBUBUBUUUUUBUUUUUUUUUUUUUUUUUUBUUUUUUUUUUBBUUUUBUBUUUUUUUBUUBBUUUUBU
BBUUUUBUUBUBUUBBUUUUUUBUBBUUUUUBUBBUUUBUUBBBUUBBUUUUUUBUUUUUBUUBUBUUUUBUUBBUUBUUBUBUBUUUUUUBUUUUUUBUU
UUUUUUBBBBUUUUUBUUUUUUUUBUUUBUBBBBBUUBUUUUUUBBBUBBUBUUUBUUUBUUBUBBBBUUUBUBUBUBUUUUUUUUBUUBUUUUBUUUUUU
UUBUBUUUUBUUUBUBUUUBUUUBBUUUUUUUUUBUUUUUUUUUUBUBBBUUUUBUUUUBUUUUBBUBUUUBUUUUUUUUBUUUUUUUUBBUUBUUUBUUB
UUUUBUUUBBBUBUUUUUUBUUUUUUBBUUUBUUBUBBBBUUUUUUUUBUBUUBUUUUUUUUUBUUUUUBUUUUUUUUBUUUUUUBUUUUBUBBUUUUUUB
UUBUBUUUUUUUBBUBUBUUUUBUBBUBBUUUBUBUUUUUUUBUUUUUBBUUUUUBUUBUBUBUUUBUUBBUBUUBBUUUBUUBUUUUUBBUBUUBUBUUU
UUUUUBBUUUUUUBUUBUUUBUBBBUBBUUUUUBBUUUUUBUUUUUUUUUUUBUBUBUUBUUUUBUUUBBUBUUUBBBUUUUUBBBUBUBUUUBBUBBBUU
BUUUUUBUBUUUUBBUBUUUUBUUUUUUUUUUUUUUUUBBBUUUUBBBBUBUUUBBUBBUUBBUUUBBUBUBBUUBUUUUUBUUUUUBUBUBUUUUUBUUB
BBUBUUUUBUUUBUBUUUBBUUUUUUUBBBUUBUUUUBBUBUUUUUUUUUBUUBUBUUBUUBUUUUBUUUBUBUUBUUUUBUBBUUBBUUUUBUUUUUUUU
BUBBUUUUBBUUUBBUBBBBBUUUUUUUUUBBBUUUBUUBUUUUUBUBUUUBUUUUUUUBBUUBUUUUBUUUBUBUBUUBUUUUUBUUUUUUUUUUUUUUU
UBUUBUUUBUBUUUUUUUBUUUUBBBUBUUBUUBBUUUUBUBBUUUBBUUBUUBUUUUUUUBUBUUUBBBBBUUUUUBUUUUUUUBUUUUUBUUUBUBUUU
UUUUUBBUBBUUUUUBBUBUBUBBUUUUBBUBUUBUBUUUUUUUUUUUUUBBBUUUUUUUUUUUUUUUUUUUBUUUUUUUUBUUBUUUBBUBUBBBBBBUU
BUUUUUUUBUUUUUUUUUBUUUUUUBUUUUUUUUUUUUUUUBUUUUUUUUUBBUUUUUUUUBUUUBBUBUUUUUUUUUBBUBUBBBUBBUUUUUUUUUUUU
UUUBBBUBBUUBUBUUUBUUUUBUUUBUUUUUBBUBUBBUBBUBBBBUUBUBUBUUUBUUUBBUUBBBUUBBUUBUUUUUUUUUUUUBBUUUUUUUBUUUB
UUUUUUUUUBUUUUUUBUBBUBUBBUBUUBUBUUUBUUUUUBUUBUUUBUUBUBBBUBUUBBBUUUBBUUUBBBBUUBBUUUUUUUUBBUUUUBBUUUUUU
UUUUUUUBUUUUUUBUBUUUUUBUUBUBUBUBUUUUBUUUUBUUUUUBBUUUBUUUBBBUUBUUBUUUUBUUUUBUUUUBBUUUUUUUUUUUUUUBUBBUU
UUUBUUUUBUBUBUBUUUUUUUUBUUUUBUUUUUUUBUUUUUBBUBBUUUBBUUUBBBBUBUUBBBUUUBUUUBUBUUBUUUUUUUUUUBBUUUUUBUUBU
UUUBBUBUUUUBBUUUUUBBBBUBBUBUUUUUBUUBBUBUUUUUUUUUBUUUUUUUBUUBBUUUUUUBUBUUUUUBUBUUUUUUBUUBUBUUUBUUUUUUB
BUUUBUUBUUUUUUUUUUUUUBUUUBUUUBUBUUBUBUBUBUUUUUUUBUUBBUUBUUBUBUUBBUUUUUUBUUBUBBUBBBUBUUUBUUBBUUUUUBUUU
UUUUUUUBUUBUUUBUUUBUUUUBBBUUBUBBBBUUBUUUBUUUUUUUBBUUUUUUUUBBUBUBBUUBUBBUUUUBUUUUUBUUUUUUUUUBUUUBBUBUB
BUUUUUBUBUBUBBUUUUUUUBUUBUUBBUUBBBUBUUBBUUBUBUBUBBBUUBBUUUBUUUUUUUBUUUBBUUUBUBUUBBUBUUUBBUUUUBUBUUUUB
UUUUUBBUUBBBUUUBUUUUUBUUUUUUBUBBUUBUUBUUUUUUUUUUBUUBUUUBUUBBBBUUUUUBBUBUUUBUBBUUUUBUUUUBBUUUBUUBUUUBU
UBUUBUBBUUUBUUUUUUBUBUUUBBUBUUUUBUUBBBUUBBBUUUUUUBUUBBUUUUBBUUBUUUBUUUUBUUUUUUUUUUUUUUBUUUUBBUUUUUUBU
UUUUUUBUUBUUUUUBBUUBUUUBUUUBUUUUUBBUBUBUUBBBUBUBUUBUUUUUBUUUUBUUUUUUBUUUUBUUUBBBUUUBUUBUUUUUUBUUBUBBU
BBUBUUUUUBUBUUUUBUUBUUUBUUUBUUBUUBBUUUBUUUUBBUUUUUUUBUUUUUBUBUBUUUUBUUUUUUUUUUUUUUUUUUBBBBUUUUUBBUUBU
BUBUUUUUUUUUBBUUUBUUUUBUUBUUBUUUBUBBUBBUUBBUUUUUUBUBBUUUBBBUUBUUUUBUUUUUUUUUUUUUUBUUUBUBUUUBBUBUUUUUU
UUUUUUBUBUUUBUUUUUUUBUUUBBBUUBUUUUUBUUUUUBUUUUUUUBBBUUUUUUBUUBBUUBUUUBUUUBUUUUBBUBUUUUUBUUUBBUUUBUUBU
UUUBUUUUUBUUBBUBUUUUUBUUBUUUUUUBUUUBBUBBBBBUUBUUUUUBUUUBUUUUUUUBUUUUBUBUBBBBUUUUUBUUUBUBBUBUUUUUUUBUU
BUBUUUUUBUUUUBUBUBUBUBBUBUBUBBBUUUUUBBUBUUUUUBUBBBUBUBUUUUBUBUBUBUUUUUUUUUUBUUUBUBUBBUUUUUUUBUUBUBUUU
UUBUBUUUBUUUUUBUUUUBUUUBUUUBBUUUUUBUUUUUBUUBUBUBUUUUUUBBUUUUUBUBUBUUUUUBUUBUBBUUUUUUUBUUUBBBUUUUUUUBU
UUUUUUUUUUBUUUBUUUUUUUBBUUBBUUUUBBUBUUUBUBUBUUUBBBUBUUBUUUBUBBUUBUUUBUUBBUUUBBBBBUUUUUUUUUBUUUUUUUUUB
BUBUUBUUUUUUUBUBUBBBUBUBUUUUBBUUUUUUUUUUUUBUUBUBUUUUBBUUBUUBUBBUBBBUBBUBBBBBBBBUUUBUBUBUUBBUUUBBUBUUU
UUUUUUUUUUUUUUBBBUUUUBBBUUUUBUUUUUBBBBBUBBBBUBUUUUUUUUUUUUUUUUUUUUBUBUUUUBUUUBUUUBUUBBBUUBBUUUBBUUUUU
BUUBUUUUBBUUUBUBUBUBUBUBUUBUUUBUBUUBUBBUUUBBUBUUUUUBBBBBUUUBUUUUUUUBUUUBUUUUUUBUUUUUUBUUUUBBBBUUBUUUB
BUBBUUBUUUUUBUUBUUBUUUUBUUUUBUUUBUUUUBBBUBUBUUUBBUBUUUUUBUBUUUBBBUUUUUUBBUUBUUUBUUUUUUUBBBUUUUBUBUUUU
BUBUBUUUUBUUBUUUBBUUUUUBBUUUUBUBUBUBBBUBUBUUBUUUUUUUBUUUUBUUBUUUUBBUBUUUUBUBBUUUBUUBBBUUBBUBUBUUUUUUB
UUUUBUBBUUUUBUUUUUUBUBUUUUUUUUUUUBBUBUBUUBUUBUUBBUUUUUUUUUUBBUBBBBUUUBBBBBBUBUUUBBUUUUUBUUUBUUUUUUBUU
BBUUUBBUUUUUUUUBUBUUUUBUBBUUUUBUUUUUUUBUUUUUUUBUUUUBUBUBUBBUUUUUBUBUUUUUUUUBUUUUUUUUBBUBUUUUUUBUUBUBB
UUUUUBUUBBBBUUUBUUUUBBBUUUUBBBBUUUUUUUUBUBUBBUUBUBUUBUUUUUUUUUUUUBUBBUBUUUBUUUBUUUBUUUUBBUUUBUUUUUBUB
UBUUUUUUUUBUUBUUUBUBUBUBUBUUBBUUUBBUUUBUBBUUUUBUBUBUUUUBBBUUUUUBUBUUUUBUUUUUBUBUUUUUBUUBUUBUUBUBBUUBU
BUUBUUBBUUUUUUUBBBUUUBBUUUUUUUUUUUUUUUUBUUUBBUBUUUBBUUUBBUBBUUBUUUUBUUBUUBUBBUBBUUUBUUBBUUBBBBUUUUUBB
UUBUUUBBBUUUBUUUUBUUUUBUUUUUUUUBBUBUBUUUUUUUBUBBUUBBBUUUUUUUUBUBUBUUBUUBUBUBBUUUBUUUBUUUUUUUBUBBUBBBB
UUUUBBUUBUUBUUBUUUUBUBBUUBUUUUUUUUBUUBBUBBUBUBUUUUUUUBUBUBUUUBUUUUUBUUUUUBUUUUUUUUUUUUBUUUUUUBUUUBUUB
UUUUUUUBBBUUUUUUUBUUBBUUUUBUUBUUUUUUUBUBBBUBUUUUUUBUUUUBUUUBUUBBUUUUBBUUUUUUUUUUBBUBBUUUUUUUUUUUUUUBU
UBUUBUUBUBUBUUBBUUUUBUUUUBBUUUUBUUUUUUBUBBBUBUUUBUUUUUUUBUUUUUUUUUBBBUUUUUUUUUBBUUBUUBUUUUUUUUBUUBUUU
UUUBUBUBUBUUUUUUUBUUUBUUBUBUBUUBUUUUUUUUUUUBUBUUUBUUBUUBUBBUBUUBUUUUUBUUUUUUUUUUUUUUUUBUUBUUUUUUUBUBU
UUUBBUUUUBUBUBUUUUBUUUUUUUUUUUUUBUUUUUBUBBUBUUUUUBUUUBBUUBUUUUUBBBUUUUUUUBBUBBBBUBBBUBUUUUUUUBUBUBUUU
BUUBUUUBUUUUUUUBUUUUUUBBUUBUUUBBBUUUUUUUUUUBUUUUBUUBUUBUUUUUBUUUUUUUUBUBUUUBUBUUUBUBBBBUUBUUBUUUUUUUB
UUUUUBUUUUUBUBUBUUUUUUBUUUUUUUUBUBUUUBBBBUBUUUUUUBUUBBUBUBUUBBUUUBBUUUUBBBBUBUBUUBUUBUUBBBUBUBUUBBUUB
UUUBUUUBBUUBBBUBBUUUUUBUUUUBUUUUBUUUUBBUUUUUUUUUUUUBUUUBUUBUUUBBUUBUUUUUUUUBBBUBBBUBUBUBUUBUUUUBUUBUB
UUUUBUUBUUBUUUUUUUBBUUUBUUUUUBUUUUUUBUUBUUUUUUBUUUUUBUBUBBUUUBBUUUUUUUBUUBUUUBUBBUUBUBUBBUUUUUUUUUBBU
BUBBBUUBUUUBUBBUUBUUUUUUUUUBUUBUBBBUUUBUBUUUBBBUUUUUBBBUBUUUBBUUUUUUUUUUBUUUBUUUUUBBUUUUBUUUUUUUUUUUU
UUUUUUUBUBUUUBUUUUUBBUUUBBUUUUUUUUUUUUBBUBBUBUUBBUBBUBUBUUBUUUUUUUBUUUBBBUBBUBUBUBUUUBUBUUUUUUUUBUBUU
UUUBUUBUUBBBUBBBUUUBUBUBUUUBBUUUUUUUUUUUUBUBBUBUBUUBBUUUUUBUBBBUUUUUUUUUUUBBUUBBUUUUUUUUUUUUBUBUUUUUB
UBUUUUUUUBUBBUUUUBUUUUBBUUBUUUUUUUUBUUUUUUBBUBUUUUUBUUUUUUUBUUUUBBUBBBBBUBUBUUBUUUBUBUBBBBUBBUBUUUBBU
UBUUUUUUUUUUUBBUUUUBUBUUBBUUUUBUBBUUUBBUUUUUUUBUBBBUUUUUUUUUUUUUBUUBUBUUUBUUUUBUUBBUUUBBBUUBUBBUBBUBU
UUUUUUUBUUBBBUBUUUBUUUUUUBUBUUBUUUBUUUUBUUBUBBUBUBUUBUBUUUUUBUUUUUBBUUBBUUBBUBBUUUUBBUBBBUUUUUUUBUUBU
UUBUUUBUUUUUBUUBBUBUBUUUUBUUBBUBUBUUUBUUUUUUUUBUBUBBUUBBBBUUUUUUBUUUBBUUUBUUUUUUUUUUUUUBBBUUUUBUUUUBB
UBUBBUBUBUBUBBUBBBBUUUUUUBBUUUUUBBUUUUBBUBUBUUUBUUUBUUUUBUUUUUUUUBUUUUUUUUBUBUUUBUUUUUBUBBBUUUUUUUBUU
UUUUUBUUBUUUUUUBUUUBUUBBUBBUBUUUUUUUBUUBUUBBBBUUBUUBUUBUUUBUUUBUUUBUUUUBBUBUUBUUBBUUUUUBUUUBBUUBUBUUU
UUUBUUUUUBUUUBBUBUUUBUUUUUUUUBUUUBUUBBBUUUUBUBBUBUBUUBBUUUBBUBBUBUUUBUUBBBUUBBUUUUBUUUUUUUBUBUUUUUUUU
UBUUBUBBUBUUUUUUBBUBBUBUUUBBUUUUUBBUUUUUBUUBUUUBUUBUUUUBUBBUUUBBUUUUBBUUBUBUBBUUBUUUUBUUBUUUBUBUUUUUU
UBBBUBUBUUUUBBBUBUUUBUBBUBUUBUUUUUBUBUBUBUUUUBUUUBBBUUUUUBBBBUUUUUBUUUBUUUUBUUUUUBUUUUBUBUBUUBUBUUBUU
UBUUUUUBUBUUUUUBBUUUBUUUBBBUBBUUBBBUUBUUUUUUUUUBBUUUUUUUBUUUUBUBUUUBUBBUUBBUUBUBBUUUUBUUUUUBBBUUBBUBU
BUUUUUBUBBUUUUUUBUUBUUUUUUUBUUBUUUUUUUBUUBUBBBBBUUUUUBUUUUUUUUBUBUUUUUUUUUUUBBUUUUUBUBUUUBBUBUUUUUUUU
UBUUBUUUUBUUUUUUUUUBUUUBUBUUBUUBBBBBUUBUUUUUUBUUBUUUUUUUUUBBBUUUBUUBUUBUBUUUUUUUUUUUUBUBUUUUUUUUUUUUU
UUBUBUBBUUUBUUBUUUUUBBUUUBUUUUUUUBUUBUBUUBUUUUBBUBUBUUUUBUUUBBUUUUUBUUUUBUUUUBUUUUUUUUBUBUUUUUBUBUBBU
BBUUUBUBBBUBUUUUBUUUUUUUUUUUUUUBUUUUUUUUBBUBUUUUUBBBUBBUUUBBUUBBUUUBUUUUBUUUUBUUBBBBUUUUUUBUUUUBUUBUU
UUUBUUBBUUUUBUUBBUUUBUBUUUUUUUUBBBBUUUUBUUUBUUUUUBUBUBBUUUBUUBUBUUBUUUUUBUBUUBUUBUUBUBUUUUUBUUUBUUUUU
UUUUUUBBUUUBBBUUBUUUUUBBUUUUUBBBBBUUUBUUUUBUUUBBUBUUUUUBUBUBUUUUBUUBUUBUUUUUUUBUUBUUUUUBUUUUUBUUBUBUU
UUBUBBUUBUUBUUUBUUUUBBUUBUBUUUBUUBUUUUUUUUBUUUBUUUUUBBUBUUUBUBUUUBUBUBBUUUUUUBUUUUBUUBBBBUBUUUUUUBUBU
UUUBBUUUUUUUUBUUBUBUBUBUBUBUUUUBBUUUUBBUUUUUUBUUUUUUBBUBBBBBBBUUUUUUUBUUUUBBBUUBUUUUUUUBUBBUUUBBUUBUU
BUUBUUUUUBBBBUBUUUBUUUUUUUUBBUUUUUBUUUUUUUUUUUUUUUBUUUBUUBBUUUUUBUBUBBBUUBUUBBUUUBBUBBUUUBUBUUUUUUUBB
UUUUUBUBBUUUUBUUBUBUUUUUUUUBUUUUBUUUBBUUUUUUUBBUUUUUUUBUUUBBUUBUUBUBBBBBUUUUUUUUUUUBUUBUUUBBUUUUUUBBU
BBUUUUBUUUUBUUUUBUUBUUUBBUUUBUUBUBBUUBUBUBUUBUUUUUBBUBBUBUUBUBBBUBBBUUUUUUUUUUUBBUUUBBUUUUUBUUBUUUUBU
UUUUUUBBUUUBUUUUBUUBBUBBUBUUBUBUBUUUUBUUUUUBUBBUBUUUBUUUUUUBUUUUUUUUUBUUBUUBUUUBUUUBUUUUUUBUUUUBBUUBU
BUUUUUUUUUUUBUUUUUBUUUUBUUUUBUUUUUBUUUUUBUUBBUUBBUUUUUUUUBUBBBUBUBBUUBUBBUBUUBUUUUUUUUBBUUUUUUUBUBUUU
