UUBUUUBUUUUUUUBUUBBUBUUUUBUUUBUUUUBUUUUUBBUBUUUUUBUUUUUBUUUUBUBBUBUUBBUUUUUUUBBBUBUUBUUBUUUUBUUUBBBUB
UUBUUUBUUUBUBBUUBUUUBUUUUUBUUUBBUUUUUBUBUUBUUBBBBUUUBBUUBUBBBBBUUBUUUUUUUUUUUBUUUUUBBUUBUBBUUUUUBUBBU
UUUUUBUUUUBUUUUUBUBBBBUBUUUUBBUUBBBUUBBUUUUUUUBUBBUUUUUBUUBUUBBUUUBUUUUUBBUUUBBBUUUUUBUBBUUBUBBUUBUUU
UUBUBUUUUUBUBBBUUUUUUUUBUUUUBUUUUUUUBBBBBUUUBUUUUBBBBUUBUUUUUUUBUUUBUUBUUUUUUUUBUUUUBUUBUUUUBUUUUUBUU
UUUUUBUBUUBUUUUBUUBBUUUUBUUBBUUUUUBUUBUUUBUUBBBUUBUBBUUUUUUBBUUUUUUUUUUUUBBUUUBUUUUUUBUBUUUBUBUUUUUBB
BBUUUUUBBUUUUUBBUUUBUUUBUUUBBUUUUUUBUUUUUUBUUUUUBUBBUUUBUBBBUBBUUUBUUUUUBUUUUBUUUUUBUUUBBUUUUUUUUUUUB
UUBUUUUBUUUBUUBUBBUUUBUUUUUUUUBUBBUBUUBUUUBUUUUUUUUUUUUUUBUUBUBUUBUUUBUUUUBBUBBBUBBUUUUUUUBBUBUUUBUBU
UUUBUUUUBUUUUUUUUUUUUBUUBUBUUUUBUUUBBUUUUUUBBUUUUUUUUUUUBUUUBBUUUUUUUBUBUUUUUBUUUBBUBUUBUUBUUBUUBUBUU
BUUUUBUBBUBUUBUUBUUUBUUUUBUUUBBUUBUBUUUBUUUUUUUUUBUBUUBBUBUUUBBUUUUBUUUUUUBBUUBUUBBUUUUUUBUUBUUUUUUBU
UUUUUUBUBBUBUUUBBBUBUUUUBUUUBUBUUUUBUUUBUUUUUUUUUUBUUUUUUBUUUBBUUUBUUUUUUBUBBBUUUUUUUBBBUUUBUBUUUUUUU
BUUUBUUUBUUUBUUUUUUUUUUUUUUUUBUUBUUUBBBUBUUBBUUUBBUUUBUUUUUUBUUBBBUUUUUUUUBBBUUUBBBBBUUUUUUBUUBBUUUBB
BUBUBBUBUUUUUUUUBBBUUUBUUUUBUBBUUUUBUUBUBUUUBUUBUUBUBBBUUUUBUUUBUUUUUUUUUUUUUUUBUBUBUUUUUBBUBUBUUUUBB
BUUBUUUBUBUUUUUUBBUBUUUBBBUUBBUBUUUUUUUBUBUUUUUUUUBUUUBUUBUBUUUBUUUBUUUUUUBBUBUUBUBUBUBUBBUUBUUUUUUBB
BUUUUBUBBBBUBUUUUBUBUBBUUUBUUUUUUBUBUUUBBUBBBUUUUBUBUUUBBUUUUBBBUUUUBUBUUUUUUUUBBBUUUUUUUBBBBBUBUUUBU
UUBBUBBBUBUBUUUUBUBUUUBUUUBUUBUBUUUUUUUUUUUBBUUUBUUUUUUUBUUUUBUBBUUUBBBUBBUUUBBUUUUUUBBUUBUUBUUBUUUBU
UUBUUUBUUUUUBUUUUUUUUUUUUBBUUBUUUBBUUBUUUUBBBUUUBUUUUUUBUUUUUUUBBUBUBUUUUUUUUBUUUUBUUBBBUBUUUUUUUUUUU
BUUUUUUUUBBBUUUUBUUUUUUUBUUUBBBUBUUBBUUUUBUUUUBUUUUUUUUUUUUUUBUUBUUBUUUBUUUUUUUUUBUBUUUBUUBUUUUUBBBUU
UUUUBBUBUUUBUBUUUUUUUUUUUUUUUUUUUBUBUUUUUBBUBUUBUUUBBUUUBBBUUBUBUBUUUBUUUBUUBUUUUUBUUUBUUUUUUBUUUUUBU
UUUUBUBUUBUBUBUBUUUBUBBBUBUUUBBUUUUUBUUUUUUBUUUBUUUUUUUBUUUUUBBBUUUUUUUUBBUBBBUUUUBUBBUUBUBUBBBUBUBUU
UUBUUBUUUBUBBUUUUBUUUUBUBBUUBBUUUUUBBUUBUUUBUUUBUBUUUUUBUUBUBUUBBBUBUUUBUBBBUUUUBBUBUUBUUUUUBUUUBUUUU
BUUUUUBUUUBUUBUBBBBUBUUUUBUUUUUUUBUUUBUUBUUUBUUBUBUUUBBUBBUUBBUUBUBBUUUUUUUBUBUUUUUBBBBUBUUUUBUBUBUUU
BBUUUUUUUUUUUUUUBUUUUUUBUUUUBUUUUBBUUBBUUBUUUUUBUUUUUUUUUUBBUBBBBBUUBBBUUBUUUBBUUUUUBUBUBUUBUBUUBUUUB
UUBUUUBUUBBUUUUUUBUUUUUUBUUUUUBUBUUUUBUUBUBUUBUUUUUUBUUUUUUBUBUBBBUUBBUUUBUBUUBUBUUUBBBBUUUUUUUBBBBBU
BUBUUUUUBBUUBBUBUBUBUBUUBUUUUBUUUUUUUBUBUUBUUBBUBUBBUUUBUUBBBUUBUBBUUBUUUBBUUUBUUUUUUUBBUUUBUUUBUUUUB
UUUUUUUBBBUBUUUBUUUUUUUBUUUBBUUBBUUUUUUUBBUUUBUUUUUUUBUUUUBUUUUBBBUUUBUBUBBBUUBBUUBUUUUBUUUUUUUUUUUBU
UUUBBUUUBUBBUUBBUBUUBUBBUBBUUUBUBUUUBBUBUUUBUBBBUBUBUUUUUUUUUUUUUUUUBBBBUUBBBUUUUBUUBUUUUUBBUUUUUUUUU
BUUUUUUUUUUUBUUUUBUUUUBBBUUUUUBUUUUUBUBBUBUUBUUUUUBUUBUBUBUUUUBBBUBUBBBUBUUBUUUUUUBUUBBBUUUBUBUUUBUBU
UUUUUUBBUBUUBUUBUUBBUBUUBUUUUBUUUUUBUUBUBUBBUUUBUUUUBUBBUBUUBBBUUUUUUUBUUUBBUBUBUUUUBUBUUUBUUUUUUBUUU
UUUUBUUUUUBBUBUBUUUUUBUBUBBUUBUBUUUUUUUUUUBUBUBBUUUUUUUUUUUBUUUUUBUUBUUBUUUBUUUBBUBUBUUBUBUUUUBUUBBUU
UUUUUUUBUUUBUUUUUUUBUUUUUBUBUUUUUUBBUUUBUBUUUUUUUBBUBUUUUBBBBBUBUUBBUBUBUUUUBBUUBUUUUUUUUUUBUUUUBUUUB
UBBBBUUBBUUUUBUUUUBUUUUUUBUUUBUUUUUUUUUUUBUUUUUUUUUUUUUBUUUUUBUUUUUUUBUUBBUUUUUBUBUUUUUUBUUUUBUUUUUBU
UUBBUUUUUUBUUUUUUBBUUUUUBUUUBUUBUUUUUUUUUBUBUUUUBUUUBUUUBUUBUUUBUUUUBBUUUUUUUUUBBUUBUUUUUBBUBUUUUUUUU
BUUUUUUUUUUUUBUBUUUUUUUBUBUBUBUUBUBUBUUUUUUUUBUUUUBBUUUUBBUUUUUUBBUBBUBUUUBUUUUUUBUBUUUUBBUBBUBUUUUBB
BBUUUUUUBUUUUUUUUBUBBUUUBUUBUBUBBUBUUBBUUUBBBBUBUBUBUUUUBBUUUUUBUUUBUBUUUUUUUUBBBBBUUBUUUUUUUUUUUUBUU
UUUUUUUUBUUUUBUBUUBUUBBBUUUUBUUUUBUBUUBBUUUUUUUBBUBBBUUUUUUUBUBUBUBUUUUUUUUUUUUUBUUUUUUBUUUUUUUUUUUUB
UBBUUUUUBUUUUUUBUBUBUBUBBUBUUUUUBUBUUUUUUUUUUUUUUUUUUUUUUBUBUBUBUUBBUBUBBUBBUUUUBUUUUUUUUUUUBUUUBUBUU
UBUUUBBUUUUUUBUUBBBUUUUBUUBUUUUUUBUUUUUUUBUUUUUUUBUBUBUBUBUUBUBBUBUUUBUBBUUBUUUUUUUUUUBBBBBBUUUUBUUUU
UUUUUBUUUUUBUUUBUUUUBUUUUUUBBUUUBUBUBUUUBUUUUUUBUBUUUBUBUUBBUUUUUBUUUUUUBBUBUUUBUBUUUUUUBUUUUUUUUBUBU
UBUBUBUUUBUBBBUBBUBUUBBBBUUUUUUUUUBBUBBBBUUUUUBUUUUUUUUUUUUBUUUBBUUUBBUUBBUBUUUUBUUUUUUUUUUUUUUUUBBBU
BBUBUBBBBUBUUBBUUUBBUUUUBUUUUUUUUUBUUBUBUBBUUUUUUUUBUUUUUUBUUBUUUBBBUUUUBUBBUUBUBUUUUUUUUBUUUBBBUUBUB
BUUUBUUBBUUBUBUUBUUUUUUUBBUUUUUUUBUUBUUUUUUUBUUUUUUBBUUBUUBUUBUUBBBUUUUUBBUBUUBUUBUBUBUBUUBUUUUBBUUUU
UUUUUBBBBUUUBBUBBBUBUUBBUBUUUBUUBUUUUUUUUUUUBUUUUBUUUUUUBUBUUBUUUUUUUUUBUBBBBBBUUUUBUUBUUUUUUUBUUBUBU
BUUUBUUUUUBUUBBUBUBBUBBBUUBBUUUUUUUUUUUUBBBUUUUUUBUUUUUUUBUUUBUUUUUUUUBUUUBBBUBBBUBBBBUUUUBUUUUBUBUUU
UUUUBUBUUUBUUUBUUUBUBBUBBUBBUBUUUUUUUUUBBUBUUBUBUUUBUUUUUUUUUUUUUBUBUUUUBUUUUUBBUUUUUUUUBUUUUBBUUUUUU
UBBUBBUUUUUUBUUUBBUUUUUBUUUUBUUUBUUBUBUUUUUUBUUUUUUBUUUUUUUBUUUUUUUUUUBBUUBBUUUUUUUUUUBUBUUUBBBUUBUUU
BUUUBUUBBUUUUBUUBUUBUUUBBBUUBUUUUUBUUUUUUUUUUUUBUBUBUUBUBUUUUUUBBUUUUUUBUBUUUUBUBUUBBUUUUBBUUUBUUBUUU
UBUUUBUBUUBUUUBBUBBUUUBBUBUBBUBUUBBUUUUUUUBUUUUUUBUBUUUUBBBUUUBUUUUUUBUUUUUBUUUUUUUBUBUBBBBBBUUUUUUUU
UBUUBBBBBBBUUUUUUUUUUUUUUBUUUUUUUUUBUUUUUBUUUUUUUUUUUBUBBBBUBUUBUBBUUUUBUBBUUBUUUBBBUBUUBBUUUBUUBUUBU
UUBBUUUUUUUUBBUUBUUBBUUUBBBBUUUUBBUUBUBUUUBUUBUUBUUUUUBUUUBUBBUUUUBUBUUUUUUUUUBUUUBBBBUUUUUUBUBUBUUUU
BBBBUBBUUUUUBUUBBUUBUUUUUBUUUUUUBUUBUUBBBUBBBUUUUUBUUUBBUBUBUUUUUUUBUUUUUUUUUUUBUUBUBUUUBBUBUUUUUUUUU
BBUBUUBBUBUUBUBBUUUUBUUBBUBUUUUBUBUBBUBUUUBBBUUUUBBUBBUUUUUUUUBUUUBBUBUUUBUUUUBBUBUUUUUUBUBUUBUUBUBBU
UUBBUUBBUBUBBBBBUUUUBBUUBUUUUBUUUUUUUBUUUUUBBUUUBUUBUBUUUBUBBUBUBBUUBUUBBBBUUBUUUUUBBUUUUUBBUUUUBBUBU
BUUUUBUUUUUUUUUUBBUBUUUUUUBUUUBBUUUUUUBBBUUBUUBUUBBUBBBBUBUBBBUBUBUUBBBUUUUUUBUUUUBUBBBBUBBUUUBBUBUBB
UUBUUUBBUBUUBUUUUUBUUUBUBUBUUUUUBUUUUUUBUUUUBBUUUUUUBBBUBUBBUUUUBUUBUUUBBBBBUUUUUUUBUUUUUUUUBUUUBBBUU
BUBUUUBBBUUUUUUUUBBUUUBUUBUUBUBBUUBBBUUUUUUUUUUUUUUUBUUUBBUBUUUUBBUBUUUBUUUUUBBUUBUUBUUUBUUUUUUUBUBUU
UBUUUBBUUUBUUUUBUUUBUBBBBUUUUBUUUBUUBUUUBUUUBBUUUBBUBUBUUUUBBUBBUBBBUBBBUUUUUUBBUUUUUUUUUUUUUUBBUUUUU
UUBBUUBUUUBBBBUBUBUUUBBBBUBBUBBUUUUBUBBUUUUUUUUUBUUUUBBUBBUUUUBUBUUUBUUBUUUUUBUUUUUUUUUUUBUBBUUUUUUBU
BUUUUUUUUUBUUBUUBUUUBBBUUBUUBBBUBUUUBUUUUUUUUUUUUUUBBUUUUUUUUUUUBUUUBUUUBUUUUUUUUBBUUBUBUUBUBUUUUBUUU
UUUUBBUUUUUBUBBUBUUUBBUUBUBUUUUBUBUBBUUBBUUUUUUUUUBUUUUUUUBBUUUBUUBUBUUUUBUBBUUUUUUBUUUUUBUUUUUUUUUBU
UUUUBBUUUUUUBUBUBUBBBBUUUUUUUBUUUBUBBBUUBUUUBBUUBUUUUBBUUUBUUUUBBUUUBUBUBBUUBUUUUBUBUBUUUUUBUUUUUUUUU
UUBUUUBUUUUUUUUBUBBBBUUBUBUUUUUBUUUUUBUUBUUBUUUUUUUUUUUBUBUBUBUUUUUBUUUBBUBUUUUUBUUBBUUBUUUUUBBUUUUUU
UBBUUUUUBBUUBUUBUUUUBUUBUBUBUBBUBBBBUUBUUBUBUUBUUUUUBUUUUUBUBUUBUUUUUBUUBUUBUUUBUBUUUUUBUUUUUBUUBUUUB
UUUUBUUUUUBUUBBUUUUBUUUBBUUUUUBUUUUUBBUUUUBBUUUBUUUBUUUUUUUUUBBUUUBUUUBBUUBBBUUUUBUUUBUUBUBUUUUBBUUUU
BUUUUBBUUUBUUBBUUUUBUBUBUUUUBUBUUBBBUUUBUBUBBUUUBUBUBUUUBUUBUUUBUBBBUBUUUUBUUUUUUBUUUUUUBUBUUUBBBBUUU
UUUUBUUBBUBUUBBUUUUBUUUBUUUBBBUUUUBBBUBUUBUBUBUUUBUUUUUUUUBUUBUUUUBUBUUUBUUBBBUUUBBUBBUUBBBBUUUUUUUUU
BBUUUUUUUUBBUBUBUUBUUUUBUBUUUUBBUUUUUUUBUBBUUUUUBBUUBUUBBUUUUUUBBBUUUUUBBBUUUUBUUUUUUUBUBBBUBBUUUBUUU
UUUUBUUUUUBUUUUUBBUUUBUBUBBBUBUUUUBUBBUUUUUUUUBUUUUUUUUBBBBBUBBUUUUUUUUUUUUBUUBUUUUUUUUUUUUBUUBUUUUUU
BUUBUUUUUUUBUUUUUUUUBUUUUUUUUBUUUUBUUBBUUBUUBUUUUUUUUUUUUUUBUBUUUUUUUUUUUUUBBUUUUUUUUUUUUUBUUUBUUUUUU
UBBBUUUUUUUBUUBBBUBUBBUUUUUUUUUUUUUUUUUUUUUUUUUUBUUUBBUBUUUUUBUUUBUUUUUUUBBBUUUBUBBUBUUUBUUUUUUUUUBUU
UUBUUBBUUBUUBBUBBUUUUBUUUUUUBBBUUBUBUBUUUUUUUBUBUBUBUBUBUUUUBUBBBUUUBUUBBUUUBUUUBUUUBBUUBUBBUUUUBUUBU
UUBUUUUUUUUUBUUBUUBBUUUUUUUUUUUUUBUUUBBBBUUBUUUBBUBUUUBBUBUBUUUUUBUBUUUBBUUUUBBUUUUUBUUBBUBUUUUUUBUUU
BUUBBUBBBUUUUBUBUUBUUUUBUUUBUUBUUBBBUUUUUUUUUUUUBUUUUUUUBUUUBUUUUUUUBUUUUUBBBUBBBUUBUUUBBUUUUUUBUUUBB
BUBUUUBUBBBUUUUBUUUUUUUUBUBUBUUUBUUBBBUUUBUUBUUUUUUUUBUUUBBUUBBUUBUBBUUBBBUBUUBBBUUUUUUUBUUUUUUUUUUUU
UUUBUBUUUUUUUUUBBUBBBUUBUUUUUUUUBUBUUUUBUUUUUUUUUUBUBUUUUUUBBUUBBBUUUUUBUUBBBUUUBUUUUUUUUUUBBUBUUUBUB
UBUBBUUBUUBBBUBBBUUBUBUBUUUBUBBUBUUUBUUUUUUUUUUUBUBUBUBUBUUBUBUUUUUUBUUUUUBUUUUUUUUUBUBUUBUUBUBUUUBUU
UUUUUBUUUBBUBUUUBUBUBUUBBUUUUUUBBBUBUUUUBBUUUUUUUBBUUBBBUBUBUBUBUUUUBUUUUUUUUUUUBUUUUUBBUUUBUUUUUUBBB
UUBUBUBUUUBUUUUUUBUBBBUUBBBUBUUUUUUBUUUUUUUUUUBUBUUUUUBBUBUUUBUBBUBUUBUUBUUUUUUUBUBUUUUUBBUBBBBUUUUBU
UBUUBBUUUUUUUUUBBUUUUUBUUBUBUBBBUBUBUUUUUUUUBUUBBUUBUUBBUUBBBUUUBBUUUUUUBUUUUBUUUUBUBUUBUUBUUUUUBBBBU
UBUBUUUUUUBUUUUBBUUUUUUUBUUUUUUUUUUBUUUUUUUUBUBUUUUUUBUUBUBBUUBUUUUUBBUUUBBUUUUUUBBUBBUBBBUBUBUUUUUBU
UUBUBUUUUUUUUBUUBBUUUUBBUBUUUUUBBUUBUUUUUUBUUUBBUUUBUBUBUUUUUBBUBUUUBUUBBUUBUUUUUUBUBUUUBUUUUBBUUUUBB
BUUUBUBUBUUUUUBBBUUBUUUUUBUUUBUUUUBBUUUUUUUBUBUBUUUUUUUUBUBUUBBUBUUUUUBUUUUBBUUBUBUBUUUUUBBBUUUUUUUUB
UBUBBBUUUUBUUBUBUBUBBUBBUUUUBBUBUUBBUUUUUUBUBUUBBUUUUUUUUBUUUUUUBUBUBUUBUBUUUUBBUUUUUBUBUBUUUBUUUBUBU
UUUUBUBUBUUBBUUUUUUBBBBUUUUUUUBBUBUUBUUUUUUBBUUUBBUUUUUUBUUUBBUUUUBUBBUUBBUUUBUBUBUBBUUUUUUUUUUUUUUBB
UUUUBUUUUUUUUUUUUUUUUUUUUBUUUUUUBUBBBUUUUUUBUBUUUUBUUBUBUUUUBUUUUUUUUUBBUUUUUUUBUUUUUUUUUBUBUUUUBUUUU
UUUUUUBBUBBUBUBBUBUBUUUUUBUUBBUUUUBUBBBBUUUUUBBUUUUUUBBUBBUBUUBBUUUUUUUUUUUUUBBUBBUBBBBBUUUUBUUBUUBUB
UUUBUUUUBBUUBUBBUUUUBUUUUUUUUBUBBUUBUUUUBUUUUBUUUUBUUBUUUUBBUUBUUUUUUUUUUBBBBBUUBBUBUUBUUUUUUUUUBBUBU
UBUUBUBUUBUUUUBUUUUUUUUUBUBUBUUBUUUUUUUUBUBUUBBBUBUBBBUUUBBBUUBBUUBBUUUUUUBUUUUUUUBUBUBUUUUUUUUUUBBBU
UUUUUUUBUBUBUUUUUUUUUUUUUBUUUUBUUUUUUUUUUUUBUUUBUUBBUUBUUUUUBBUBUUUUUUUBBUUUUUUUBUUUUUUUUUBUUUUUUUUUU
BUUUUUUBUUUUBUUBUUUUBBBBUUUBUUUUUBUUUBUBUBBUUBUUUUBUUUUBBUBUUUUBBBBUUBUBUUUBUUBUUBUBUUUUBUUBBUUUUBUUU
UUUUUBUUBBUUUUUBUUUBBUUUUUBUBBUUUUUBUUBUUUUBUUUUBUUUBBUUBUUUUUUUBBBUBUUUBBUBBBUUBUUBUUUUUUUBUUUUBBBBU
UBUBUUUUBUUUUUUBUUUBBUUUUBUUUBUUUUBUUUUUUUUUBBUUBUBUUBBBUUUBUUBUBBUUUUBBBUBUUUUUBUUBBUUUUBUUBUBUUBBBB
BBBUUBUUBUUUUUUBUBBUUBUUUBUBUUBUUBUUBUUUUBUUUBUBUBUBBUBUUBUBBBUUBUUUUUUBBUBBBUUUUUUUBUBUBUUBUBUUUUUUB
UUUUBUUUUUUUUUUBUBUBUUUBUBUUUUBUBBBUUUUUUBUUBUBUBUBUUUBUBBUUBUUUUUUUUUUUUUUUUUBUUUUUBUUUUBBBUUBUBUUUU
BUBBBBUBUUUUBUBBUUUUUUUUUUUBUUUUUBUUBUUUUUUBUUUUBUUBUBUUUUUBUUUUUUUBUUUUUBUUUBUUUUUUUUUBUUBUUBBBBUUBU
BBUBBUUUUUUBBBUUUUBUUUUUUBBBUUUUBUUUBUBUUUBUUBBUUUBUUUUUUUUBBUBUUUUUUUUUUUUUBUUUUBUUUUBBUUUUBUBBBBUBB
UUBBUUUUUUBUUUUUUBBUUBUBUUUUUBBUUUUBUUUUUUUUUBBBBUUUUBUUUUUBUBUUUUUUUUUBUBBBUBUBUBBUUUUBUUUUUBUUUUUUU
UUUUUUUBUBBUUUUUBBUUUBUUBBBUUBUUUUUBBUUBUUBUUUUBBBUUBUBUBBBUBUUBUUUUUUUUUUUUBBUUBUBUUUUUBUBBBUBUBUUBU
UBBBUBUUUBBUUBUUBUBBUUUUUUUBUUUUBBBUBUBUBUBUUBUUUUUUUUBUBUUUUBBBUUUUUBBUUUBUBBBUBBUUUBUUUBUUBBUUUUUUU
BUUUUUUBUBBUUUUUBUUUBUUUBBUBUUUUUUUUBBBUUBUUUUBUBUUUUBUUUUUBBUUUUUUUBUBBUUUUUBUUUUUBUUBBUUUUBBUUBUBUU
BUBBUBBUUUUUUUBUUBBUUBUBUUBUBUUUUUUUBBUUBBUBBUBBUUUBUUUBBUUUUBBBUUUBBUUUUBUUUBBUUUUBUUUUBUUBBUBUUUUUU
UUBUBBUUUUBUUUUUUBBBBUUUUBUUBUUUBBUBUBUUUBBUUUUUUUUUUBUUUUUUUUUUUUUUBUBBUBUUBUUUBUUUUUUUUUUUBUBUUUBUU
