UUBUUUUUBUUUBUUUBUBUBUBBBUBUUBBUBUBUBUUBUUUUUUBUUUUUUUUUBUUUBUUUUUUUUUUBBUUBUUUUUBBBBUUUUUUUUUBUUBUBB
UUUUBUUUBBBUBUBUUUUUUUUUUUUBUBBBBUUUUUUUUUUUBUUUUUUBUBUUUBUBBBBUUUUUUBUBUUUUUUUUUUUUUUUUBUBUUBUUUBUUB
UBUUUBBUUUBUBUBBUUUUUUUUUUUBUBUUBUUUUBUBUBBUUUUBBUBUUUUUUUUUUUUBUUUUUUBBUBUBUUUUUUUBUUUUBBUUUBBBBUUBU
UBBUUUBBUUBUBUBBBUUUBUUBBUUUUUUUUUUUUUUUUUUUUBUUBUUBBUUUBUUUBBUBUUUUUUUUUUUUBBUUUBUUUUUUBUUUBBUUBBBUU
UBUUBUUUUBUUBUBUUUBUUUUUUUBBUUUUBBUUBUBUUUUUUBUUBBUUBUUUUUBBUUUBUBUUUUUBUBUUUBUUUBUUUBUUUUBUUBUUBUUUU
UBBUBBBUUUUUBUUUUUUBBUUUUUBUUBBBUUBUUBUBUUBUBBUUUUBUBUBUUUBUUUUUUBBUBUUUUUUUUBUBBUUBUUBBUUUBUUUBUUBUU
UUBUBBBUUUUUBUUUBUUUUUUBUUUBUBUUUUUUBUUBUBUUBBUUUUUBBBUBUUUBUUUUUUUBUUUUUUUUUUUUUUBUBUUUUUUUBUUUBBUUU
BBUUUUUBUUUUUUBUBUBUUUUUUUUUUUBBBBBBUUUBBUUUUUBUUBUUUUUUUBUUBUUUUUBUUUUUUBUUUUUUUUBUUUUUUUUBUUUUUUUUU
UBUUBUUUBUUUUUUUUUUUBUUBBBUBUBBBUUUUBBUUBBUUBUUBUUUUUUUBBUUUBUBBUUUUUUUUUUBBUBUUUBUUUBBUUUUUBBUUUUUUB
UUUBUUBUBUUBUBUUUBUBUUUBBUUUBUUUBUBUUUBUUUUUUUUUUUUBUUBBUBBUBBUBUBUBUUBUBBUBUUUUBBUUBBBBBUBUUUUUUBUUU
UUUUBUUBUUUUUUBUUBUUUUUBBBBUUUUUUUUUBBBBUUUBUBUBBUUUBUBUUBUUBUBUUBBUUUUUBUUBUBBUBUUBUUUBBBUUUUBUBUUUB
UUUUUUUUUBUBUUUUUBUUUBUBBUUBBUUBUUUUUUBUBBBUUBBUUUUUUUBUUUUUBUUUUUBUUUUUUUBUBBUUBUBUBUUUUUUUBBUUBBBBB
UBUUUUUUUUUBUUUUBUUUUUUUUUUBUUBUBUUUUUBUBUUUBUUUUUUUUUUBUUUBUUUBUBUBBUBBUBUBBBUUBBUBUUUUBUUUUUBUBUBUU
BUBBUUUUUUBUUUUUUUUUUUUBUUUUBUBUUUUUUBBBBUBUUUUBUUUUUUBUUUUUUBBUUUUBBBUUUUBUUBBUUUUUUBUUBUBUUUUUUUUUU
UUUBUBUUBUBUBUBUUUUUBUUUUUBBBUUBUUBUBUUUUUUUUBUUBUUUUUBUUUBUUBUUUUUUUBBUUUUUUBUUBBBUUUUUUUUUBBUUUBBUU
UUBBUUUUUUUBUUBBBUUUBBBUBUBUUUUBUBUUUBUBUBUUUUBUUBUBUUBUUBUUBBBUUUUUUUBBBBUUUBUBUBUUUUUUUBUUUUUBUBUBB
BBUBUBUUUUBBBUUBUUUUUBUBUUUBUBBBBBUUBBBUUUUUUUUBUUBUUUUUUUBUUUUUBUUUBUUUUUUUUUUUBUUUUUUUUUUUUUBUBUBUU
UBUUBBUUBUBBUUUUUBUBUUBUBBUUBUUUUUUBUUBBUUUUUUBUBUBUUBUUBBUUUBBBUBUUUBUUUUUUUUUUUUUBBUUUUUBBUUUUUBBUU
BBUBBUUUUBUUBUUUUUUUBUUBUUBUUUUUUUUUUUUBUUBUUUUUUUUUUUUBBUUUBUUUUUUUUUUUUBUBUUUUUUUBBUUUUUBUUUUUBUUBU
UUUBUBBBUUBUUUBUUUUUUUUUUUUUUBUUUBUUUUUUBUUUUUBBUUBBBUUBBUBUUUUBUUUBUUUBUUUUUBUUBBBUUUBUUBUBUUBBUBUBU
UUUBBBBUUBUUBUUBUUUUUUUBUUUUUUUUUUBUUUBBUBUBUUBUBUUBUUUUBUUBBBUUUUUUUUBUUUUUUUUUUBUUUUUUUUUUBUUUBUUBU
UBBBBUBUUUBUUUUBBBBUUUUBUUUUUUBUBBUBUUUUUUBBUUBUBBUUBUBUUUBUUUBUUUBBBUBUBBBUBUBUUUBUBBUUUBUBBUBUBUUBU
UUUUBUUUUUUUUUUUUBBBUUUUUUUUBUUBUUUUUUBUUBUUUUBUBUUUBUBUUUBBUUBUUUUBUBUBUUBUUUUUUUUUUUBUUUUUBBBUUUBBU
BUUUBUUUUBBUUUBUUUUBUBUUBUUBUBUUUUBUUUUUBBBBUBBBBUUUBUBUUUBUUUBUUBBUBUUUUUUBBUBUUUUUUUUUBBBBBUUBUUBUU
UUUBUUUBUUBUUBBBUUBUUUUUBUUUUBUBUUUBBUBBUBUBBUUUBUUUUUUBBUBUUUBBUUUUUUUUUUUUUBBBUBBUUUUUBUUUUUBUUBUUU
UBUBUBUBBUBUBBUUBBUBBUUBUBUUUUUUUUBUUUUUBUUUBBUUUBBUUBUUUUUBUUUUBBUUUUUUUBUUUUUUBUUBBUUUUUBBUBUUUUUUB
UUBUUBUUUUUUBBBUUUUBUUBBUBUBBUUUBBUUBUUBBBUUUUUUUUUUUBUBBUBUBBUBUUUUUBBUUUUBUBUBUUUUBUBUUUUUBUUUUBUBU
UUBBUBUUUUUUUUUUUBUUUUUUBBUBUUBBBBBUBUUUBUUBUBUUBUBUUUUUUUUBBUUUUUUUBUUUUUBBBUUUUUUUUUBUUUUBBBUBUUUUB
UBBUUUBUUUUUUUUUUUBUUUBBUUUBBUBBUUBUUUBUBUUUBBUUUUBBBUUBUBBUUUBBUBBUBUUUBUUUUUUUUUUUUUBUBUUUBUBUUBUUB
UBBBUUUBBBUBUUUUBUBBUUUUBUBUUUBUUBUBBUBUUUUUBUBBUUBUUUBBUUUBBUBBUBUUUUUBUUBBUBUUBUBBUUUBBUUBBBUUBBUUU
UBUUUUUUUBUBUUBUUUUBUBBUUBUUUBUUBBUBUUUUBBBUUBUUBBUBBBUBBBUUUUBUUBUBUUUUUUBBBBBBUUUUBUUBUBUUUUUUUUUUB
UBUUBUBUUBUBUUUUBUBUUBUUBBUUUBUUUUUUBUUUBUUBUBUUUUUUUBBBUUUBUUUUBBUUBBBUUUUBBUUBUBUUUUUBUBUBUUBUUUUUU
BUUUUUUUBBUBBUUUBBUUBBUBUUUUBUBBUUUUBBUUBUBUUUBBBBUBUBUUBUBUBUBUBUUUUUBUUUUUUUBUUUUUUBUBUUUUUUBUUBBBU
UUUUUUUBUBUUUBUUBUUUBBUUUUBUUUUBUUUUUBUUUBUUBBUUUUBUBUBBBUUUUUUUUUUUUUBBUUUBUUUUBUUUBUUBUUUBUUUUBUBUB
UBUUUUUUUUUUBBUUBUBBUUBBBUUBBBBBBUUUUUUBBBBUBUBUUUBUBBUBUUUUBBUUUUUBUBUUUUUUBUBUBBUUBBUUUBUUUUBUUBUUU
UUUUUBBBUBUUBUUUBUUUUUUUBBBUBUBBBBBUUUBUBBUUUUBBUBUBUUUUBBUBBUUBUBUUBUUUUBUUUUUBUBUUUUBUBUBBUBUUUUUUU
BBBBUUUUBUUUUUBUBUUUBUUUBUUBUBBBBUBUUUBUUUUUBUBUUUUUBUUUBUUUUUBUBUUUUBBBUUUUBUUBUUBUUBUUUBBBUBUUUUUBU
BBUUBBUUUUUBUUUBUBUUUBUBUUUUUBUBUUBUUUUUUUUUUUBUBUUBUBBBUUUUUUUBBUUUUUBUUUBBBUUBUUUUBUBUUUBUUUBUBBUUB
UUUBUUUBBBUBUUUBBBUBBUUBBUBUUBUUBUUBUUUBBUBUUBUBBBUUUUUUUUUUUUBUUUUUUBUBUUUUUBBBBUUBUUBUBBUBUBUUUUBBU
UBUUUUBUBUUUUUUUUUUUUUUUBUUUUUBUUUUUUUUBUUUUUUUUUUUUUUBUBUUBUUBUUUBUUUUUBUUUUUUUUBBUUBUBUUUUUUUBUUUUB
UBBUBUBBUUUUBUUUUUBUUUBUBUUUUUUUUUUBBUUUUBBBUUUUUUBUUUBUBUUBUUUUBBBBUUUUBBBUUBUUBUUUUUUBUUBUUBUUUUBBU
UBUUUUUBUUUUBBUUBBUUUBUUUBUBUUBUUUBUBUUUUUBUUUUUBUUBBBUUUUBUUUUBBUBUBUUUUUBUUUUBBBUBUUBUBUUBBUBUUUUUU
UUBUBBBUUBUBUUUUUUUBBUUUUUUUBBUBUBUUUBBBUBUUUUUBBBBUUUUBUUUUUUUBUBBBBUUUBUBBUBBUUUUBUBBUUUUUUUUBBBUBU
UBUUUUBUUUBUUUBUUUUUUUUUUBUUUUBBUBBUUBUUUUUUBUUBUUUBUUUUUUUUUUUBBBUUBUUUUBUUUUUBBBUUBUBUUUBUBBUBUUUBB
BUUBUUUBUBUBUUUUUUBUUUBUBUUUUBBUUBUUUUBUUUUUUUBUUUUUUUBUUUUUBUBBUBUBUUBUUUBUUUUBUUUUUBUUUBUUUUUUUUBUU
UBUBUUUUBUUUBBBBUUUUUUUBBBUUUBUBBUUUBUBUUUUUUUUUBBBBUUUUBUUUBUBUUUUUUUUUUUUUBBUUBUUUUUUBUUUUUBUBUUBBU
UUUUUUUUUUUBBUBBBBUUUUBUBUUBUUBBUUBUUUBBUUBUBUUUBBUUUUUUBUUUUUUUUBUUUUUBUBUUUUBUUBUUUUBBUUUUBUUUBBUUU
UUBUBUBUUUUUUUBUUUUBUUUUUUBUUUUBUUBUUUUUUBUUUBUUUUBUUUBBUUUBUBUUUUBUUUBUUBBUUUUUBUBUBUUBUBUBUUBBBUUBU
BUBBUUBUBUBUUUUUUUUUUBUUBUUUBUBBUUUUUBBBUBBUUUUBBUUUUUUUUUUUUUUUBBUUUBBUBBUUBUUBBBUUBUUUUBUBUUBUUUUUU
BBBUBUUUUBUBUBUUUUUUUUBBUUUUUUUUBBUUUUBUUBUUUUBUBUUBUUUBUBUBBBBBUBUUUUUUUUUUUBUBUUBUUUBBUBBUUUUUUBBUU
UUBUUUBUBBUUUBBUUUUBBUUUUUUUUUUUUUBUUBUUUUBUUUBUUUUUUBBUBUUUBUBBUUUBUBUUUBBUUBBUUBUUBUUUUBBUBBBUUUBUU
BUUBUBUUBUUUUUUUUUBBBBUBBBUUUBBUUUBUBUUBUUUUUUUUUUUUUUUUUBUUUUBUUUUUBUUUUUUUUUUUUBUUBBUBBBUUUUUUUBUUU
UBUUBUUUUBUBBUUUUUBUUBUBUUUUUUUUUUUBUUUUUBUUUUUUUUUUBUUBBUUBUUBUUUUUBUBUBUUBUUUUUUUUBUUBUUUUUUBUUBUUU
UBUBBUUUUBUUUUUBUBBUUUUUBUUUUUUBUBBBUBUUBUUUUBUUBBUUUUUUBBBUUUUUUUUUBUUUUUUBBBBUUUUBBUUUUBUUUUUUBBUBU
UUUUBBBUUUBBUUUUUBUUBUUUBUUUUUUBUBUUBUUBUUBUUUBBBUUUBUUUUUUUBUUUUUUUBUUUBBUUUUBBUUUUUUUBUUUBBUUUUUBUU
BUBUBUUBBUUUBUUUUUBUBBUUBBUUUUUBUBUUUUUUBUUUUUUBUBBUUBBUUUUBBUUUUUUUUUUUBUUUUBBBBUUUUUBUUBBUBUUUUBBUB
UUBBBBBUUUUUUUBUBBBUUUBUUUUBUUBUBBUUUUBUBUUBUUUUUBBUUUUUBUUUUUUBBUUBBUUUUUUUUUUUBUBUUUUUUBUBUUUUUUUBB
UBUBUBUUUUUUUUUBUUUUBUUUBUUBBBBUUBUUUUBBBUUUUBUUUBBUBUUBUBUUUBBBBUBBUUUUUUBBUUBUBUUUBUUUUUBUUUBUUUUUU
UUUUUBUBBBBBUUUUBUUUUUBBUUBBBBUBBUUBBBUBUUBUUUUBUBUUUUBUUUUUUUUUBBBBBUUUUBBUBUUUBBUBUBBUBBUUBUUUBUBUU
UBBUUUUBBUBUUBBUBUBBUBBUUUBUUUUUUUUUBUBBUUUBUBUUUUUUUUUBUUUUUUUBUBUBBBUUUBUUBBUUUUUUUUUBUUBUUUUBUBUUU
BBBUUBBUBUBUUUBUUBUBUUUBUUUUUUBUUBUUUUBBUUUUUBBUBBUUBBUUBBBBUUUBUUUBBBUUUUBBUUBBUBUUBUUUBUUUBUUUUUUUB
UUUBUBUUUBBBUUUUUUUUUBBUUUUBUBBUUUUUUBUUUUUUUUUUUUUBUUUUBUUBBBUBBUUUUBBBBUUUUUUUUBUUUBUBUBUBUUUUUUUBU
UBUUUUUBUUUUBUUBUUUUUUUBUBUUUUUUUUUUUUUUUUUUUUBBUBUUUUUUUUUBBUUBUUUBUBBUUBUUUBBUUUUUUUUUUUBUUUUUUUUUU
UUUBUBBBUUBBBUUUUBBBUUUUUBUUUBBBUBUBBUUBUUUBUUBUBBBUUBUBUUUUBUBUBUUBBUBBUUUUUUUUUUUBUUUBUUUBUUBUUBUUB
UUUUUUUUBUUUUUUUUUBUUUUBUUUBUUUUUUBUUBUBBUUUUUBBBUUUBBUBUUBUUUBUUUBBUBBUBBBUUUBUBUUUUUBBUUUBUUBUBUUBB
UBBUBUBUUBBBUUUUUUUUUUUUUUBUUBUUUBBUUUBUUUUUUBUUBUBBBUUUUBUBUUBBBBBUUBUBUUUUUUUUUBUUUBUBUBBUUUUUBBUUU
BUBUUUBUBUUUUUUUBUUUUBUUBUUUUUUBUBUBUUBBUBBBUBBBUUBUBUBUBUUUUBUUUUUUUUBBBBUUUBUUBUUUUBBUUUBUBBBUUBUBU
UUUUBUUBUUBBUUUUUUUUUUUBBBUUUBUUBUBUUUUUUBUBBUBUUUBBUUUUUUUUUUUBUBUUUBUUBBUBUUBBUUUBUUUUBUUUBBUUUBUBU
BBUUUUUBUBUUBUUUUUBUUUUBBUUUUUUUUUUUBUBBBBUUUBUUUBUUUBBUBUBBUUBUUUUUUUUBBUBUBBUUUUUUUUUUBUBUBUBUBUBBU
UUBUUBUUUBUUUUBUUBBUUUUUUUUUUUBBBUBUBUUBBUUBUUBUUBUUUUBUUUUUUUUUUBUUUUBUUUBUUBUUBUUBUUUUBUUBUBUUUBUUU
UUUUBUUUBUUUUBUBUBUUUBUUUUUUUUUUBUUUUBUUBBUBBUUBBUUUBUUBBBUUUBUUUUUBBUUBUUBBUUUBBBUUUUUUUBUBBUBBUUUUB
UBUUUUUBUUUUBUUUBUBUUUUUUBUBUBUBUUUUUUBUBUBBUUBBBUUBUBUUUUUUUBBBUUUUUBUUUUUBUUUBUBUUUBUUUBUBUUUBUUUBU
UBBBUUUUUUUUUUBBUBBBUUUBBBBUUUUBBUUUBUBBUBUUUUUUUBBUUUBBUUBBUBUBUUUUUUUUUUUUBUUBUUBBUBBUBUBUUUBUUBUUB
BBUUUUBUUBUBUUUBBUUUUUUUUBUBUUUUUBUUBUUBUUUUUBBBUUUUUBBBUUBUBBBBUUUBUUUUBUUBBUBUUUBBUBUUUUUUUBBUBBBBB
UBUUUBUUUUBUBBUBUBUBBBUBUUBUUUBUUUUUBBUBUBUBUBBUUUUUUUUBUUUUUUBBUBUUBBUUUUBUUUBUUUBUUUBUUUUUUBBBUUUUB
BUUBBUUUUBUUUUUUUUUUUBBUUUBUUUUUBUUUUBUBUUBUUUUBBUUBUBBUUBBUUUUUUUUUBUUBUUUUUUBBUUBUBUUUBUUUBBUUUUBBU
BUBUUBBBUUBBUUBUUUUUUBUUBUUUUUBUBUUUUUUBUUBUUBUUUUUUUBUUUUUUBUUUUUUUBBBUUBUBUUUBUUUBUUUBBUUUUUUUUBUUU
BBUUBUUUUUUBBUUBUUUUBUBUUUBUBBUUBUBUUUUUBBUBBUUBUBUUBBUUBUUUUUBUUUUUBUUUUBBUUBUBUUUUUBUBBUUUUUUBUUBUU
BBUBUBUUUBBUUUUBBBBUUBUBUUBUBUBBUUUUUUUUUBBUBUUBBBUUUUBUUBUUUUUUUUUUUUBUBUUBUUBUUUUBUUUBUUUUUUBBBUUBU
UUBUUBBUBBUUUUUUBBUUBUUUUBBUUBUBUUUUBBUBUUUUUUUUUUUBUUUUUBUUUUUUUUUUUUUUUBUUBUUUUUUUUUUUUUUUUUBUUBUBU
UUUUUUUBBUBUUBUUUUUBUUBBUUBBBUUUBUUUBUUBUUBUBBBUBBBBBUUUUUUUUUBBBUBUBBUUUBUBUBUBUUBUUUUBBBBUUUUBBUBUB
BBUUUBBUUBUBBUUUUUUUUUUBUUBBBBUBUUBBUUBUUUUUBUUUBUUBUBUUUUUBUUUUBUUUUUUBBUUUBUUBBUUUUUBUUBUUBUUUBBUUB
UBUBUUBUBBUUUUUUBBUBBUUBUBUBUUUUUBBUBBUUBUBUUUUUBBUBUUUUUBUUUUUUBUBBBUUUUBBUBUBBUBUUBBUUUUUUUBBBBBUUU
UBUUUBUBUBUBUUUUUUUUUUBUUUUUBUUBUBUUUUBBBUBUUBUUUUBBUUUBBUUBUUUUUBBUBUUUUBUBUUUUBUUBUBUUUUBUUUUUUUUUB
UUUBBBBUUUUUUUUUUUUUUUBUUBUUUUUUUUUUBUUUUBUUUUUBBUBUBBUUBUBUUUUUUUBBUUBUUUBUUBUBBBBUUBUUUUUBBBBUUBBUU
UUBUUBUUUUUBUUUUUUBUBUBUBUUUUUBUBBUUBBUUBBBBBUUUUBUBUBUUUUUUUUUBUBUBUBBUBBUUUUUUUUUBUUUUBUBBBUUUBUUBU
UUUUUBUUUUBUUUUBBUUUUBBBBUBBUUUUUUUUUUUBBBUUBUUUBBUUUUUUBBUUUUUBBUUUUBUBUBUBBBUBBBUBBUUUBUUBUUUUBBUUU
UUUUUUBBBUUUBUBUUBUUUUUUUUBUUUUUUUUUUBBUBBBUUBUBUUUUUUUUUUUUUBUUUUBUBBUUUUUUUUUUUBBUUBUUUBBUBUBUBUUUU
UUUUBUUUUUUUUUBBUUUUUBBUBUBBUUUUBUBUUUUBUUUUBUUUUUBBUUBUUUUUUUUBUUUUUUUUUUUUBBUUUUUUUUUUBBUUBUUUUUUUU
UUBBUBUUUBUBUUUUBUBUBUBBBUBBUUUUUUBBUUUUUUUBBBUBUUBBBUUUUUBUBUBUBUUBUUUUUUUUBUBUBUUBUBBUUUUUUBUUUBUUB
UUUUUUUUBUUBUBUBUUUBUBBUBBBUBUBBUUUUBBBUUUBUUBUUUUUUUBUUBBUUUBUBBBUUBUUUBUBUBUBBUUBUBUBUBBBUUBUBUBUUB
UBUBUUUUBBUUBUUUUUUUBUUUUUUUUBUUBBBUUBUUBUUUUBUUUUUUBUUBBBUUUBUUUUUBUUUUBBUUUUUUBBBBBUBUUUUUUUBBUUUUU
UUUUBUBUBBUBUUUUUUUBUUBUUUUUUUBUBUUUUUUBUUBUUUBUUUBUUUBUUUUUBUUUUUUUUUUBUBUUUUUUUUUUUUUUBBBUUBUUUUUUU
BBUUBUUUUUUUBUUUUUBUUUUUBBBUUUBBUBUUBUBUUBUBBBBBBUUUUUUUUUUUUUBUUUUBUBBBUUUUUUUUBUBUUUUUBUBUUBBBBUBUU
BUBUBUUUUUUBUUUUBUUUUBBUUUUBUUUUBUUUUUUUUUUUBUUUUUUBUBUUUUUUUBUUUUUUUUBBBBBBBUUUUUUUUUUBBUBBUUBUUUUUU
UUBBUBUUUUUUUUUUUUUUUUUUUUUBUUUUUBUBBUBUUBUUUUUUUUUBBUBBUUUUUUBUUUUUBUUUBUUUBUUUUUUUUUBUUUUBUUUUUUUUB
UUUUUBUUBUBUBBUBBBUUBUUUUUUUUUBUUUUUBUUUUUUUUUUUUUUUUUBBUBUUBUUBUUUBBUUUUUUUUUBBUUUUUUUBUBUUUBUUUBUBB
UUBBUUUBUUUUUUBUUBBBBUUBUUUUUUBUUBUUBUUUUUUUUUUUBUUUUUUUUUUUBUUUUUUUUUUUUUBUUBBUBUUUBUUBUBBUUUUUUUBUB
UBUBUUUBUUUUUUUUUBUUUUUUUBUUBBUBUUUUUUBBUUUUUBUBUBUUUBUBUUBUUBUBBUUBUUUBBUUBUUUUUUUBBUUUUUBUUBUUUUUUB
UUUUUUUUBUUUUUUBBUBUBUUUUUUUBBUUUUBUUUUUUUUBBUUUUBBUBUUUBBBUUUBBBUUUUUBBUUUUUBUBBUUUBUBUUUUBUUBUUUBUU
BUUBUUUBUBUUUBUBUUUUUUBUUUUBUUBBUUUUBUBUUUUUBUBUUUBUUUUUUUBUUUUUUUUUUBBUUBUUUBBUUUUUBBUUUUBBUBBUUBUUU
