UUBUUBUBUUUUUUUUBUUBUUBBBUBUUBUUBUUBUUUUBUUBBUUUUBUUBUUBUBBUUUUUUBUUBUUBBUBUUBUUUUUUUUUUUUUUUUBUUUBUU
UUBBUBUUUBUUUBUUUUBUUUUUUUUUUUUBUBUUUUUUUUBUUUUUUBUUUBUUUBBUBUUBUBUUBBUUUUUUUUUBUUUUUUUUUUUUUUUBUUUUU
UUUUBUUUUBUUUBUUBUUUUUBUBBBUUUBBUUUUUUUUUUBUUBUUUUUUUUUBBBBUBUUBBUUUBUBUUUUUUBBUUUUUUBUBUUUBBUUUUBBUU
BBBUBUUBUBUBUBBUBBUBBBUUUBUUBBUUUUUUUUUBBUBUUBUUBBUBUBUBBBBBBUUUUUUUUUUBBBUBUUBBUUUUUBBUUUUUUUUUUUUUU
UBUUUUBUBUUBUUBUUBUUUUUUUBUUUUBBBUUBUUUUUUUBBUBUBUUUUUBBUUUBBBBBBBBBUUBUBUBBBBUBUUUUUUBUBBUUBBBBUUUUB
BBUUUBUUUUUUBBUUBBBUBUBUBBBUBUBBBBUUBUBUBUUUUBUUUBBBUBBUUUUBBBBBBUUUUBUUBUUBUBUUUUUUUUUUBBUUUUUUUBUUU
UUUBUUBBUUUUUBUBUBUUBUBUBBBUBBBUBUUUUBUUUUUUUUUUUUUUBUUBUUUBUUUBBUUBUBUUBUUBUUBBUBUUUUUUBUBBUUBUBUUUU
BBBBUUUBUUUUUUUUUUBUUUBUUBUUUUBBUUBBBBUUBUBUBUBUUUUUBUBUUUUUBBUUBBUUUBUUUUUUUBUUUBBUBBBUBUUBBUUUBUBUU
UUUUUUUBBUUBUBUUUUBBUUBUBUUUUUUUBUBUBBUBUBUUUUUUBBUUUUUBUBUUBUBUUBUUBUUUUBBUUUUUUUBBUUBUBUUUUBUUBUBBB
UBUUBUUUUBUUUUUUUUUUUUUUUBBUUUUBBUUUBBBBBUBUBUUUUUUBUBUUBUBBBUBUUBUUBUUBUBBUUUUUBUUUUUUBBUUUUUUBUUUUU
UUUUUUUUUUUUUUUBUBUUUUUUUUUUUUBBUUUUUUUUUBUUBUUUUBUBUBBUUBUBBUUBUUUBUUUBUUBUUUBUBUUUUUUUBUUUUUUUUUUBU
UUBUUUUUUUUUUUBUBBUUUUUUUUUUUUBBUUUBUBBUUUBUUUBBUUBBBBUUUBUBUUUUBBUUUUUUUBBUUBUUUBUBBUBBBUUBBUUUUUUUU
BUBUUBUBUBUUUBBUUUUUUBBBUUUBUBUUBUBBUUUUUUUUBUUUBUUUBBUBUUUUUBUUBBUBBUUBUBUBUUBBBUUUUBUBBUBBUUUUUBBBU
BUUUUUUBUUUUUBUBUUBUUUUUUBBBBBBUUUBUUBUUUUUUBUUUUBUUBUUUUBUUUBBUBUUUBBBBUUUBUBUUUBBUUUUUUBUUUUUBUBUBU
UBUUBUBUUUUBUBUUUBUUUUBUBUUUUUUUUBBUBUUUBUUBUBUBBUBUBUUUBUBUBBBUUUBUUBBUBUUBUBBBUBUBUBUUUBUUBUUUUBBBU
UBBUUUBUUUUUUUUUUUUUBUBUUUUUUBUBUUBBBUUUUUUUUUUUBUUBUUUBBBUUBUUUUBUUBUUUUUUUBBUBUUUUUUBUUBUUUUUUUUBUU
UUBBUUUBUBBUUUUUBBBBUUUUUUUUBUBUBBUUUUUUUUUBUUBUUUUUBUUBUBUUBBUBUUUUUUUUBUBBUUBUUUUUUBUBUBUBUUUUUUUUU
BUUUUUUUUUUUUUBBUBUBBBBUUUBUBBUUUUUUUUBUUBUUUUUBUUUUUUUUBUUUBUUUUBUUUBUBUUBBUUUUBUUBBUBBUUUUUBUUUUUBB
BUUUUUBUBUUUUUBBUUUBUBUUUUBUUUBBUBBUUBUBUUUUUUBUUUUUUBUUUUUBBUBBBUUUBUBBUUUUUBUUBUUUUUBBUUBUBUUUBUBUB
UUBUBUUUUUUUBUUUBUUBUUBUUUUUBUUUBBUBUUUUUUUUUBBUBUUBBUUBUUUUUUUBUUBUUBUBBUBUUBUUUUBBBUBBBUBUUBUUBBBUU
UBUUBBUUBUUBBUUUBUUUUBUBBUUUUUUBUUUUUUUBUUBUUUUUUUUUUBBUUBUBBBBBUUUUUBUUUBUUUBUUUBUBUUUBBUUUUUUBUUUUB
UBBUBUBUBUBUUUUUBUUUUUBUUUUUUBUUUUUUBUBUBBBBUUUUUBBUUUBUUBBUBUUUBBBUBUUUBUUUUBUBUBUBUBUBUUUUUUUUBUBUU
UUUUBUUUBUUBUUUUBUUBUUUBUUBUUBBBUUUBBUBUBBBUUUUUUUUBUUUUBUBBBUBUUUBUBBUUUUBUUBUBUBUUUBUBUUUBUBUUBBBUU
UBUUUUUUBBUUBUUUUUUBBBUBUBBUUBUUUUUBBUUBUUUUUUUUUUUUUUUUUUUUUUUUUBUUUUUUBBUUUBUUUBBUBUUUBUUBBUUUUUUUU
BBUBUUBUUUUUUBUBUUUUBUBBBUUUBUBBBBBUUBBUUUUUUUUUUUBUBUBUBBUUUUUBUUBUUBUUBUBBUUUUUUUUUBBBBUUBUBBUUUBUB
UUUUUBBUUBUBUUUUBUBUUUBUBUUUUUBBUUBUUUUUUUBUUUBUUBUBUUUUUUBBUUUUBUUUUUUUUUUUUUUUUUUUUUBUUUBUUBUUUUUUU
UUBUUUBBBUUBUUUUUBBBBBUUUUUBBUUBUBUBUUUUBUUBUBUBBUUUUBUUBBUBUBBUUUUBUUUUUBBUBUUUUBUBBUBUUUBBBBUUUUUUU
BUUUBUUUUBUUBUUUUBUUUUUUUBBUUUBUUBUUUUUUBUUUBUBUBUBUUUUBUUBUUBUBUUBUUUBUUBUUBBUUUUBBUUUUUUUUUUUUUUUBU
BUUBBBUBBBBUUBUBUUUBBUBUUBUUBUUBUUUUBBUUUUUUBUBBUUUUUUUUUUBUUUBUBUUUUUBUUUBBBUBUUBUUBUUUUUUUUBUBUUUBU
BBBUUUBUUUBUUBUBBUUUUUBUBUUBBBUUUBUBUUUUUUBUUUBUUUUUUBUUUUUUUUUBBUBBUUBUUUBUUUUBUBBUBUUBUBUUUBUBBUUUB
BUUUUBUBUUUUUUUBBUBUUBUUBUUUBUBUBBUUBUUUUBUUUUUUUBUUUBUUBUUUBBBUUBUBUBUBUUBUUBUUBUUUBUBBUBUUBBBBUUUBU
UUBUUUBUBUBUUBUUUUBUUUUUUUUUUUUBUUBUUUBUUBUUBUBBUUUBUUUBUUUUUUUUUBBUUBBUUBUBUUUUUUUUUBBUBUUUUBUUUUBBU
UUUUUBUUUUUUUBUUBUUUUBUBUUBUUBUUUUUUUBUUBBBUBUUUUBUUBUUUBUUBUUUUBUUUBUUUUUUBBUUUUUUUBBBUBBUUUUUUUUUBB
UUUUUBUUBUBBUUUBBBUUUUBBBBUUUUBUUBUBUUBUUBBUUUBBUBUUUBUBUUUUUUUBUUUUBBUBBUUUUUUUUBUBBBUUUBUUUUUUUUUBU
BUUUUBUBBBUUUUUUUUBUUUUUUUBUUUUUUBUUUUUUBUBUUUUUUUUUUBBUUBUUUUUUUUUBBBBUBUUUBUBUUUUUBBUUUUUUBBUUBUUBB
UUBUBUUUUBBUUUUUUBUBUBUUBBUBUUUBBUBBBUUUUBBUBBUUBUUUUUBUUUUBUBBBBUUUUUUBUUBBUUUBUUUUUUBUBBUUBBUUBUUUB
UBUUBBBUUBUBBBUUBBUUBBBUUUUBUUUUUUUBUUBUUUUUBUUBUUUUBUUBUUUUUBUUUBUUBBBUBUUUBUUBUUBUUBUUBUBUUUBUBUUUB
BUBUUUUUBBUUUUUUUUUUBUUUUBUUUBBUUBBUUUUBUBUUUBUBBBUUBUBUUUUBUBUUBUUUUBBBUUBUUUUUBUUUBUBUUBUUUBUUUUUUU
BUUBUBUUUUUUUBUUBUUUUUBUUUUUUBUUUBUBUUUUUBBUBUUUBUUBUBUBUUUBUBUBBBUUUUUUUBUBUUUUUBUBUUBUUUBUBUUUUUBBB
UUBUUBUBUUUUUBUUBUUUUUUUBUUBUUUUBUUBBUUUUBBUUUUUUBUBBUUUUUUUUUUUUUUUUUUUUUBUBBBUBUUUUUUUBBUBUUUUUUBUU
UUUUUUUBUBBUBBBBBBBUUUBUUUUUUUUUBBUUUUUUUUUUUUUUUUUUUBUBBBUUBUBBUBUUUUUUBUBBBUUUUUUUBBBUUUUBBUBBUBUUB
BBUBUUUBBUUUUBUUUUBBUBUUBUUUUUBBUUUUUUBUUUUUUUUUBUBUUUUUUBUBUBBUBUUUUUBBUUBUBUUUUUUUUBUUUBUBUUBBBUUUU
UBUBBUUUUUUUBUUUUUUUUBUUBUUBUUUUUUUUUBUBUUUUBUBUBUUUUUUUUBUBUBBUUUBUUBUBUUBUUBBUBUUUBUUUUUUBUUBUUBBUU
UBUUBUBUUUUUUBUUBUUUUBUUBUUBUBUUUUBBUUUUUUUBUBBBUUBUUBBBUUUBUBUUUUUUBUBBBBUUUBBUBUUUBBUUUBUUBBUUBBBBB
BUUUUUBUBUUUUUUUUUBUUUUBUBUUBUUUUUUBBUUUUBUUUBUUUUUUUBBUBUUUBUUBUBUUBUUUUUUUBUBBUUBUUUUBUUUBBUBUUUUBB
BBBUUBUUUBUUUUBBUUBUBUUBUBBUBBUBUBUBUUUUUUUUUBUUUUUUUUUUBUBUUBBUBUBUBBUBUUBBUBUBUUBBUUUUBUUBUUBBUBUUU
UUBBUUUBBBUUBBBUUUUUUBUBUUUUUBUUUUUUUUBUUUUUBBUUBUUUUBBUBBUUUUBBUUBBUUUUUBUUBUUBBUBUUUBBUUBUUUUUBUBBU
UBUUBUUUBUUBBUUUUUBUUBUUUBUUBUUUUUUUUUUBUUUUBUBUUBBUUUBBUBUBBUUBBBBUBUUBUUBUUUUUBUUUUUUUUBUUBUBUUBUBU
UUBUUUUUUUUBUUBBUBBBUUBUUBBUUUBUBBBBBBUBUUBUUUUUBBBUUUUUUUUBUUUBBUUBUUUBUBBBBBUUUBUBUBUUUBUUUUUBUUUUU
UUUUUUBUBBUUUUBUBUUBUUUUUUBBUUBUUUUUUBBUUUBUBUUUBBUUUBUUUUUUBBUUBUBUUUUUUBUBBUUBBUBUBUUUBUUUBUUBUBUBB
UBUUUBBUUUUUBUUUUUUBUUUUUUUUUBUBUUUBBUUUUUUBUBBUUBUUUBUUUUBBBUBUBUUUUBBUUBUBBUUBUBUUUUUUUUUBUUUUUUUUU
BBUUBUUUUBUUUUUUUUUUBUUBBUBBUUUUBUBUUUUBUUBUUUBUBUUUUUBUBUUUBUUBBBUUUUUUUUUBUBUUBUBUUUUUUUBUUUUUUBUBU
UBBUUUUUUBUBUUUUUUUUBBUUUUUBUUBUUUUUUUUUUUUUUUUBBUUBUUUUUBBBUBUUUBUBBBUUUBBBUBUBUUUBUUBBUUUBUBUUUBBUU
UBUUUBBBUUUBUUBUBUBUBUBUUUUUUBUUUUUUBBUUUUUBUBUUBUUUUUUUBUUBUUUUBUUUUUUUUUUBBUUUUUUUUBUUUUUUUUUUBUUUB
BBUUUUUUBUUUUUUBUBBUBBUBUUBUUBUUUUUUUBUUUUBBUBUBUUUUUBUUBUUUUBUBUUBUBBBUUUUBUUUUUBUUBUUUBUUUUBUUUBUUB
BUUBBBUUUUBUUUBUUUBBUBUBUUUUUUUBUBUUUUUBUBBUUUUUUUUBBUUBUUUUUBUUUUUBUBUUUUUUUUUUUUUBBUBBUUBUUUBUUUBUB
UUUUUUUUUBUUUUUBUUUUBUUBBBUUUUUBBUUUUUBUUBUUUUUUUBUBBBBUBBUUUUBBUUBBUBUUBUUUUUBBUUUUUUUUUUUUUUUBUBBUU
UUUBBUUBUBUUBUBBUBUBUBBUBBBBUBUUBBUBBUUUUUUUBUUUUBBBBUBUBUBBBBUBUUUUUUUUUBUBBUUUUUUBUUBBUBUUBBUUUUBBU
UUUBUUBUBUUUUUBUUUUUUUUBUBUUUBBBBUUUUUBUUUUUUBUUUUUUUUUUBUBBUUUBUUUBBUUUBUBUUUUBUBBUBUBBBUUBBUUBUUUUU
BBUUUBUUUBBUBUUUUBUBBUUUUUUUBBBUUUBBUUUBUUUUUUUBBBUBBUUUUUUUUUUUUBUUUBUUUBBUUUUBUUUUUBUBUUUBUBUUUBUUU
UUUBUUBBBBUUUUBBUUUUUBUBBUUBUBBUUUUUUUUUUUBBUUBUUBUUBUUBBBUBUUUUBUBBUBUUUBBUBBUUUUUBUUBUBBUUUBUUUUUUB
UUUBBBUUUBBUBUBUUUBBBUUUUUUUBUUUBBUBBUBUUUBBUUUBUUUUUUBUBUUUUBUUUBUUBUUUUUUUUUUUBUUBUUUUUUBUUBBUUUBUU
UUUUUBBUUUBBBBBBUBBBBUBUBBUUUUUUUBBUBUUUUBUUBBUUUUUUBBUBUBBBUBUUUUUUBUUUUUUBUUUUUUUUUUUUUBBUBBUUUUBUB
UUBBUUUUUUBUUBBBUBUUBBBBUBBUBUUBUBBUUUUUUUBUUBUBBUUUUUBBBUUUUUUUUBUUBUUBUUUBBUUUUUUUUUUUUUBUUUUUUUUUU
UUUUBUBUUUUBBUUBUUBBUUBUUUBUUUBUUUUUUBBUUBBUUBBUUBUUUBUUUUUUUBUUUUUUUBUUBUUBUUUUUUUBBBUBUUUBUUUUUUUUU
UBUUUUUUUUBUUUUUBUUUUUUUBBBUUUUUUUUUUUUUBUUUBUBUUUBUBUUUBBBBUUUUUBBUUUBUUUUUUBUUUUBUUUUUBUBBBUBUUUUUU
UUBUBUUUBBUUBBUBBBUUUUUBUUUUUBUBBUBUUUBBUUUUUBBUBBUUBBBUUBUBUBUUBBBBUUUUUUBUUUUUUUUUUUUBUBUUUUUBBUBUU
BUUUUUUUUUUUBUUBUUBBBBBBUBBUUUUUUUUBUUUBUUUUUBBBBBUUUBBUUUBBUUBUUUBUUBBBUUUUUBBUUUUBUUUUUUUBUBBUUUUBB
BUBBBBUBUUBUUBUUBUUUUBUUBUUUUBUBUUUUUUUUBBUUUUBUUBUUUUUBUBUUUBBUUUUUBUUUUUUUUUBBUBBUBUUUUUUUBBUUUUUUB
UBBBUBBUUUUUUUUUUUBUUUBUUUUUUUUUUBUUUUBUUUUUUBBUBUUUBUUUUUBBUUUUBUBUUBUUBUUUUUBBBUUUBUBUBUUUUBUUUUUUU
UUBUBBUUUBBUUUUBUUUUUBUBUUUUBUBUUBBUUUUUUUBUBUUUUUBUUUBUUUUUUUUUBUUUBUUUUBBBUUBBUBUBUBUUUUBUUUUUUUUUB
UUUUUBUUUUUUBBUUBBUUUBBBUBUUUUUUUUBUBUUUUBUUBUBBUUUUUUBBUUUUBUBBBUUBUUUUUBBBBUUUUUUUUBUUUUUUUUBUBUBBU
BUUUUUUUUUUUUUUUUBBUBUUUUBUUUUBUUBBUUUUUUBBUUBBUUBUUUUUBUBUUBBUUBUUUBUBUBUBUBBBUBUBUUBUUUBUBUUUBUBUBB
UBUUBUUUUUUUUUBBUBBBBUUUUUBBUBUUBUUUUBUBUUUUUUUUUBBUUUUBUBBUBUBUUUBUUUUUBUBUBUUUUUUUBUUUUUBBBUUUBBUUU
BUUUBUBUUUUUUBUUUUUBUUBUUUUUUUUUUBUUUUUBUUBUBBUUUBUUUUBUUUBBUUBUBBUUBUUUUUUBBUUBUUBBUUUUBUBUUUUUUUUBB
UUUUUBUUUUUUBBUBBUUUUBUUBUBUBUUUBUUBUUUBUUUUUUBBBBBBUBUBUUBUBUUUUBUUUBUBBUUBUUUUUUBUUUUBUUBUUUUUUUUUU
UUBUBUBBUUBBUBUUUBUUUUUUUUUUUUUUBUBUBUUBUUUUUUBBUUUUUUBUBUUUBUUUUBUBBUBUUBUUBUUUUUUUUUBUUUUUUUUUBBBBU
UBBUUUUBBUBUBUUUBUBUBUBUBUBUUBUUUUUUUBUUUUBBUUUUUUUUUBUUUUUUBUBBBUUUUUUUBUUUUUUBUUUUUBUUUBUUUUBUUUUBB
UUUUBUUUUBBUBUBUBUBUUUUBUBBUUUUUBUBBUUUUBBBUBBUUBBUUBBUUUUBUUUUBUBUBBBUUUUBBBUUBUUBUUUUBUUUUUUBUUUBUB
BUBUUUUBBUUUUUBUBUUUUBUUUBUUUUBBBBUUUUUUBBBBUUUUBBBUUUBUUUUBUUUUUUUUUBUBUBBUUBUUUUBUUUBUUBBUUUUUUBUUB
UUUBUUBUUUUUBBUBUUUUBUUBUUBUBUBUUBUUUUUBUUBBBBUBUUBUBUBUUBUUBUBUBUUUUUUUBUUUBBBBUUUUUUUBUUBUUUUUBUUUU
UBBUUUUBBUUUBUUBBUUUUBUUUUBUBUUUUUUUBUUBBBUUUUUUUUUUUBUUUUUBUUUUBBUUUBUUUUBUUBUBUUUUUUUUUUUUUUUUUUUUU
UBUUBUBUUUUUBUUUUBBBUUBUUUUBUBUBUUUUBUBUUUUUUUUBUBBBUUUUUUUUUUUUUBUUUBUBUUUUBBUUUBUBBUBUUUBUBUUUUUUUU
UUUBBUUBUUUUBUUUBUUUBUUUUUBUBBUUBBUUUBUUUBUUUUUUUUUUUUBBBUUBUUUBUUUUBUUUUUUUUBUUBUUBUUUBBBBUUUBUBUBUU
BBBUUUUBUUBBUBUBBBUBBUUBUUUUBUBUUBUUBBUUUUUBUUBUUBUUUUUBUUBBUBUUUBBBBUUUBUUBBBUUUUBUBUUBBUUUUBUBUUUUU
UUUBUBUBUUUBUUUBUUUBUBUBBBUUUUUUBBUUBBUBUBBBUUUBUUUUUUUUUBUUBBUUUUUUBUBBUUUUUUUUBUUUUBUUUBBBUBUUUUUUU
UUUUUUUBUUUBBUBBUUBUUUUUBBBUBBUUBUUUBUUUUUUBBBBUUUBUUUBUUUUUUUBUUBUUUUUBUUUBBUUUUUUUBUBUBUBBUBUUBUBBU
BUUBBUUBUUBUUUUBUBBUUUUBBBUBBUUBUUBBBBBBBBBUBBBBUUUUUUBUUUUBUUUUUUUUUUBUUBBUUUUUUUBUUUUUUUBUUBBUUUUBU
UUUBBBBBUUBBUBUUBUUBUBUBUUUUBUBUUUUUBUUBUBUUUUUBUUBUUUBBUUUBUUBUBUUUUUBUUBUUBUUUBUBUBBUUUUUBUBUUBUUBU
BUBUUBBUUUUUUBBUUUBBUBBUUBUUUBUUBBUBUUUBUUUUUBUUBUUBUBUUUBUBUUUUBUBBUUUBUBUUBBUUUBUUBUUBUUUBUBUUUUUBU
UBUUUUUUUUBUBUUBUUUUUUUUUBBBUBUUUUUUUUUBUBUUUUBUBUUUUUUUUUUUUUUUUBUUUUUUUUBUUUBUBUUUUBUUBUBUUUUUUBUBU
UBBBUUBUBUBUUUUBUBUUUBUUUBUUUBUUBUBUUUBUUUUUUBUBBUBUBUBBUBUUBUBUBUUUUUBUBUBBUBUUUUUUUUUUUUBBUBUBUUUUU
UUUUUUUUBUUBUUUUUBUUUBBBBBBBBUUUUUUUUBUUBUUUBBUUUUUBBUBUUBUBUUUBUUBUBBUUUUBUUUBUUUUUBUBBUUUBUBUUUUUUU
UUUUBUUUBUUUUUUUUBUUUBUUUUUBUBUUUUUBBUUUUBUUUUUUUBUUUUUUBUUUBBUUBBUBUUUUUUUBBBBBUUUBUUUUUUUBUBUUUUUUU
UUUUUUUUBBBUUUUUUUBBBUUBUBUBBUBUBBUUUUBUUUUUUBUBBUUBBUUUBUBUUBUUUUUUUUUUUBUBUUBUBBBUUUBBUUUUBUUUUBBUU
BBBBUUUUBUUBUUUUBUUUBBBUBUUUBUBUBUBUBUUUUUBBUUBUUUUUBUUUUUUUBUBUUUUUUBBBBUBBUUUUUUUUBUUUUBUBUUUUBUUBU
BUBUUBBUBBUUBBUUUUBUUUUUBUBUUUUUBBUUBBBUUUUUBUBUUBBUBBBUUUUUUBUUUUUBUUBUBBUUBBBUUUUBUUBBUBUUUBUUBBUBU
UUBUBUBBUUUUBUBUUUBUBUUBUBUBUUUUUUUUUUUUBBBUUUBUUUUUUUUUBUUUUBUBUUBUBUUBUUBUUUUUBUUUUUUUUUBBUUUUUBBBU
UUUUUBBUUUUBUBBBUUBUBUBBUUBUUUUUBUUUBBBBUUBUUUUUUUBUUUBUUUUBUUBUUUUUUUUUUBBUUUUUUUUBUUUUUUUUUUUUUUUUU
UUUUBUUBUBBBUUUUUUUUUUBUBBUBUBBUUBUUUUUUBUUUBUBBUUBUBUUBUBUUUBUUUUUUUUUUBUUUBUUBBUUUBUBUUUBUBUBUUUBBU
UUUUBUBUBUUUBUBUBUBUBUUBUUUUUUUUBUUBBUUUUUUBUUBBUUUUUUUBUUBUUUUUBUUBUBBUUUUBBBUUUUUBUBUBUBUUUUBBUUUUU
