UUBBBUBUUUUUUUUBBUUBUUUUBBUBUBUUUBUBUUUUUUUBUUBUUBUUUUBUBUBBUUUUUBUBBUUBBUUUBBUUBUUBBUUUUBBUUUUBUUBUB
BUUBUBBUUUUBBUBUUUUBUUUBBUUUBUUUBUBUUBUBUUUUUBUUUUUBUUUUUBUUUUUUBUUBUUBUUBUUUUUUUUUUUBBBUUUUBUBUUUUUB
UUUBUUUUBUBBUBBBUUUUUBUUUBBBUUUUUBUUBUUBBUUBUUUUUUUUUUUBBUBUUBUUBBUUUUUUUUUUUUUUBBUBBBUUUUBUUUUUUBUUU
UUUUUUUBUBUUUUUUBUBUUUUUUUBBBBUBUUBBUUUUUUUUUUBUUUUUUUUUBUBUUBUUUUUUUBUBUUBBUUUUUUUUBBUUUUUUUUBBUUUBU
UUBUUUUUUUUBBUUBUUUUUBUUBUUBUUUUBUBBUUUUUUUBUBBBBUUUBUUBBBBUUUUBBBUBBUUBUUBBBUUUUUUUUBUBUUUUUUBBUUUBU
UUUUBUUUUUUUUUBUUBUUUUUUBBUUUUBUBBUUBBUUUUUBUUUUUBBBUBUUUUUUUBUUUBBUUUUUUUUBUBUUUUUUUUUUBBUUUUUUUUBBU
UUUBUBUBBUUBUBBUUUUBUBUUUUUBBUUUBUBBUBUBUUUUUUUUUBBBUBUUUUUBBBUUUBBUUUUBUUUUUUUUUUBUBUUUBUUUBUBUUUBBU
UUUBUBBUBBUUUUUUBUUUUUUUUUUUBUBUBBUUBUUUBBUUUBUUBBUBBBUBUBBUUUBBBUUUUUUBUUUUUUUBBUUBUUUBBUBUBUUUBUBUU
UUUBBUBUUUUBBUUUUUUBUUUUUBUUUUUUBUBUUBBUBBUUUBUUUUUBUUUUBUUUUUUUUUUBUBBBUBUUBBBBUBUBUBUBBUUBUBUBUBUBU
UUUBUUUUBUUUBBUBUUUUUBBUUUBUBUUUUUUBBUBUUUBUUUUUUUBUUBUUBUUUBUUUUUBUUUUUUUUUUUBUBUBBUBUBUUBUUUBBBUUUU
UUUUBUBUBUUBUBUBBBUUUUUUUUUUUUUUUUUUUUBUUBUUUUUUUBBUBUBUUBUUUUUBUUUUUUBUBUUUBUBBUBUUUUUUBUUUUUUBBUBUU
UUUBBUBBBUUBBUBUUBUBBBUUBUUBBUUUUBBBBBUUBBUUBUUUBBUUUBUUUUBBUUUUBBUBUUUUUBUUUBBBBUBUUBUUUUBBUUBUUUUUU
UBUUBUBBUUUUUBBUUBBUBUUUBUUUUUBUUUUUUUUUUBUUUUUUUUUUUBUUUUUBUUUUUUBUBUUUUUUBUUUBBUUUUBBBBUBBUUUUUUUBU
UUUUUBUUUUBUUBUUUUUUUBUUUUBBUUBUBUBUUBUBBUUUUUUUUUUBUUBUUUUUUBUUUUBUUBUUUUUUUUBUUUUUUBBUBBUUBBUUBUUBU
BUUUUUBUBBUUUUUUUUUUUBUUBUUUUBUUUUUBUBUUUUBBUUUUUBUUBBBUUUBUUUBUUUBUUBUBBUUUBBUUUUUUBUUUUUUUBUUUUUUUU
UUBUBUBUUBUBUUUBBUUUUUUUBBBUUUUUBBBUBUUUUUUUBUBUUUBUUUUBBUUBUUUUBUUUUUUUUUBUUUUUUBBUUUUUUUUUBUUUUUBBU
UUBUUBUUUUUUUUUUUUUUUUUUBBBUBUBUBBUUUBUUBBUUUUUBUUBBUUUUBBUBUUBUBBBBUBBUUUUBUUUUBUUUUUUBUUBUBBUUUUUBU
UUUUUUBUUUBUUUUBUUUUUUBBUUBUUBUUBBUUUUUUBBBUUUUBUBUUUUUBBUUUBUUUUUUBUBBUUUUUUUUUUUUUUUUUBBUUBUUBBUUUU
UUUBBBUUBUUUUUUUBUBBUUBUUUBUBBBUBUUBUBUUUUUUBBUBUBUBUUUUUUUBUUUBBUBBBUBUUBUUUBUUUUUUUUUBBBUUUBUUUUBUU
BUUUUUUUBUUUBUUUUBBBBUUUUUBUUUUUUUUBUUUUUUUUUUUUUBUUUUUUBBUUUUUUUUUUUUBBUBUBUUBUUUUBUUUUUUUUUUUUBBUBU
BUBBUUBBUUUUBUUBUUUUUUBUUBUUUUBBBUUUUBBUUUBUUBBUBBUUBBBUUBUUUUUUUUUUUUUUUBUUUUBBUBUUBUBUBUUBBUBUUUUBU
UUUUUUUUUUUUUUUUUUUUUUUUUUUBUBUBBUUBUBUUUUUUBUUUUUUUBBUUUUBUUUUBUUUUBBBUUUBBBUBUBUUBUUUUBBUUUUBBUUUUB
UUUUBBBUUUBUUBBUBUUUUUUUBUUUBUBBUUUUBUUBUBUBUBUUUUBUUUUUUUBUUUUUUBUUUUUUUBBUBUUUUUUUBBBUUUUUUBBUUUBBB
UBUUBUBUUUUUBBBUBBUUUUBUUBBUBUBBUUUUBUBBBUBUUUBBUUUUUUUUBUBUUUBBBUUUUUUUUUUBBBBUUBUUUUUUBUUBUUUUUUBUU
UUBUUUBUBUUBUBUUBUUUUUUUUBBUUUUUBUUUUUUUUUUUUBUBBBBBBBBBUUBBBUUUBUUBUUUBUUUBUUUBUBBUUUUUBUBBUUBUUUBUB
BUUUUUUUUUBBBUUUBBUBUUBBUUUUUBUUUUUUUUUUUUUUUUBUUBBUUBBUUUUBUBBUUUUBUUBUBUUBUUUBBUUUUBUUUBUUUUBUUUUUU
BUUUUUUUUBUBBUBUUUUUUUUUBUUUBUBBUBUUBBBUUUBBBBBBUBUUBUUUUUBBUUUUUUBBBBUUUUUUUUUUBUUUUBBUUUUUBUUUUUUUB
BBUUBUUUUUBBUBUBBUUUUBBUBBBUUBBUUUUUBUBUUBUUBUUUBUUUBUBUUBBUUUUBBBBBUUUBUUUUBBUUUUBUUUBBBBBUUBBUUUUUU
UBBBUUBUUBBUUUUUBUBBUUUUUBBUUUUUUUBUUUUUUUBUUUUUUBUUUUUBUBUBBUBUUUUUUUUUUBUUBUUUUBBUUBUBUUUBUBUBUUUBU
UUBBUUUBBBUUUUBUUUUUUBBUUUUUBBUBBBUBUBUBBUBUUUUBUUUUUBUUUUUUBUUBUUBBUBBBUUBUUBUBUUUUUUBUBUBBUBUUUUBBU
UUBUUUUUUUUBUUUBBUUBUBUBUUBBUUUBUUBBBUBBBUUUBUBUBUUBUUBBBBUBBUUUUUUBBUBUUUUUBUBUUUUBUUUBBBUBUUUUBBUBB
UUUUBUUBBBUBBUUUUUUUUUUUBUBBUUUUUBUUUUBUBUUUUUBUUBUUBUUUUBUBBBUUUBUUUUUBBUUUUUBBUUUBUUBBBUBBBBBUUBUUU
BUBUUUUUBUUUUUUBUUBUUUBUBBUUUBUBBBUUUUUUUUUUUUBUUUUUUUUBUUUUUBUUBUUUUUBUBUBUUUBUUBUBUUBBUBUUUUUUUUUUB
UUUUUUUUUUUBUUUBBBUUBBUUUBUUUBUUBUUBBUUUUUUBUUBUUUUBBUUUUBBUUUUBUUUUUUUUUUUBUUUUBUUUBUBUBUBBUUUBUUBUU
UBBUUBUUUUUUBUBUUUUUUUUBBUBUUUUUUBBUBUUUUUUBUUUUUBUBBUUBUUUUUUUUUUUBUUUBUBUBUUUUBBUUUBUUUUUUUUBBUBUUB
UUUUBBUBUBBUBBUUUBBUUUBBUUUBUUUBUUBBUBUUUBUUUBUUUUUUBBUUBUUUUUUBBUUBUUUBUUUUUBBUUUUUBUUBBBUBBUUUBUUBU
UBUUUUBUBUUUBUUUUUUBBBUUBUUBUUBUUUBUUUUUUBBUUBBUUBUUUUBUUUUUBBUUUUUUUUUUUUBBUBUUBUBUUUBUUUUBUBBUUBUBU
BBUUUUBUBUUBBBBUBBUUUUUUUUUBUBUBBUUBUUUBBBUUBUUUUUUUUUUBUBUUUUBUUUUUUUUUUBBUBUUBBUBUBBUBUBBUUBBBUBUUU
BUUBUBBBUUUUUBUBUUUUUUUUUUUUUUUUBUBBBBUBBBUUUUUUBUBUUUBUUUUBUUUUBUBBUUUUUUUUUUUUUUBUUUUUUUUBBUUUUUBBB
BUBUUUUUUUUBBBUUBUUBUBUUBUUUUUUUUBUUUUUUUUUBUUUUBUBUUBBBUUUUUUUUBUUBUUUBUUUUUBUUUUUBUUUBUUUUUBUUUUUBU
UUUUBBUUUBUBUUUUUUUUBUBUUUUUUUUUBUBUUBUUBUUBUBUBBUUUUUUUBUUUUUUUUBUUUUUUBUUBBUUUBBUUBUUUBBUUUUUUUUBUU
UUUBUBUBUUUUBUUBBBUUUUBBBUUUUBBUBBUUUUUUBBBUUBUBUUUUUUUUUUUBUUUUUUBBUUUUUUBUBBBUUUUBUUBBUBUBUUUBUBBUB
UUUUUUUUBBUUUUUUBUUBUBBBBUUUUUUBUUUBUBUUBUBUBBUUBBBBBBBBBBUUUBUBUBUUBUUUBUUUBBUUUUBUBBBUBUUUUUUUBUUBB
UBBUUBBUUUUBBBBUUUUBUBUUBUUUUUBBUUBBUBUUBUUUUUUUUUUUBBUBUUUUUBUUUUUUUUUUBUBUUUUUBUUUUBBUUUUUUUUUUUUUU
UUBBUBUUUBBUUBUBUUUUUUBUBUUUBUUBUBUUUBUUUUBUUUUUUUUUUUBUUBUUBUUUUUUUUUBUBUBUBUUUUUBBUBUBUBBUBUUUUUUUU
UUUUBBUUUUBUUBUBUUUUBBBUBUBUBUUBUBBBUUBUBUUBUBUUUBUBBUUUUUUUBUUUBBUBUBBUUBBUBBBUUUUUUBUUUUUUBUUBBUUUU
BUUUUUUUBUBUUUUUUUBBUUBUUBUUUUBBUUBUBUUUUBBUBUBUUUUUUUUUUUUUUUUUUUUBBUBUUUUUUUBBBUBUBUUBUBUUUUUBBUUUU
BUUUBUUBBUBBUUUUUBBUUUUUBUBUUUUUUUBUUUUBUUUBBUBUUBUUBUUUUBBBUBBBUUUBBUBUBBUUBBUBUUUBUUUBUBUUUUUUUUUBU
BUUUBUUBUBBBBUBUBUUBBUUBUUUBUUBUUUUUUUUUUBUUUBBUBUUUUUUUUUBUUBUUUUBUUUUUBUUBUUUUUUUUBUUUBBUBUBBUUUUUU
BUBUBUBUBUBUUBBUUBBBUBUUUUUUUUUUBUBBUBUUBUUBUUUUBUUUUUUBUBUUBUUUUUUUUUUUUBUUBUUUBUUUUUBUUUBUBBBUUUBUU
UUBUUUUUUUBUBBUBBUUBUBUUBUUBUBBUUUUUUUUBUUUBUBUUBUUBBUUBUUBBBUBUUUUUBUUBUBUUUBUUUBUUUBBUBBUBBUUUBUUUU
UUBUBUUUUBBUBUUUUUUUUUUUBUUUUUUUBUBBUUBBUUUUBBUUBUUUBUBUBUBUBUUUUUUUBUUBBBUUBUUBUBUUUUUUUUUUUUUUUUUUU
UBUUUUBUUUUUUUUUUUUUUUBUUUUUBBBUUBUUUUUUBUBBUUUBBBUBUUBUBBBUUUBUBUUUUUUUBBUUBUUBUUUUUUUBBUBUUUBBUUUUU
UUBBUUUBUUUUUUBUBUUBUUUBUUBUBUUUUUBUUUUUBBUBUUUUUUUUUBBBUUBUUUUUUBUBBBBBUBUUBUBUUUUUUUUUBUUUUBUUUBUBU
UBUUUBUBBUUUBUBUUBUBBUBUUUUBUBUBUUUUBUBUUUUUBUBUBUUBUBBUUUBUUBBUUUUBUUBBUUUUBUBUUUUUUUUUUUBUBUUUUUUBB
BUUUUUBUUBBUUUUUUBUUUUUUBUBBUUBUBBUUUUUUUUUUBBUUUUUBUBBBUUBUUUBUBBBUUUUUBUUBBUBUBUUBUUUBBBBUUBBBUBBUU
UBBUUUBUBBUUUUUBBUBUUBBUUUBUUBBUUBUUUUUBUUBUUBBUUUBUBBBBUBUUBUUUUBBBBUUBUUUUBUUBBBBBUUUBUUUUBUBUBUUUB
UUUUUUUUUUBUBBBUUUUBUUUUUUUUUBUUUBUBUUUUUUUBBUBUUUUUUUUUBUBUBUUUBUUUBBUUUUBBUBUBUUBUUUUUUUUBBUUUBUUUU
UUUUUUBUUUBUBUUBUUUUUBUBUUUUUUUUBUUBBUBBUUUUBUUUBBUBUBUUUUUBUUUUUUUUBBBUBUBUUUBBBUBUBUUBBUUUUUUUUBUBU
UBBBUUUUUBUUUUUUUUBUUUUUBUBBUUUUUUUUUUBUUUUUUUUBUUUUUBUUUBUUUUUUUUUUUBUBUBBUUBUBUBUUUUBUBBUUUBBUUUUUU
BUBUUUUUBUUBBUUUUUBUUUUUUUBBBBBUUBUUBBBUUUUUBBUUUUUUUUUBUUUUBUUUBUUUBUBUBUBUUBUUUBBUUUBBUUUBUUBBBUUUU
UUUBUUUUUBUUUUBBUBUUUBUUUBBUBUUUUUUUUUUBUUBUBUBUUBBUBUBUUUUUUBUUBBUUUUBUUBUBUUBBUUBUUBUBUUUUUUBBUUBUU
UUUBUUBUUUUUBBUUUUBUBUBUUBUBUUUUUUUUUUUUUUUUBUBUBBUUUUBBUUBUUBBUUBUBUUBUUUUUBUBUUBUUUBBUUBUUUUUUUUUBU
UBUUUUUUUUUUBUBBUUUUUUUUBUUUUUUBUUBUUUUBUUUUUUUUBUBUBUUBBUUBBBBBBBUBBBBBBUUUBUUUUBUUUBUUUBUUUUUUUBUUU
BBUUBUUUUUBUUUUBUUUBUUUUUUUUUBBBUUBUUUUUUUUUUUUUBBUUUUUBUUUUUBUBUUUUBUBBUBUBUUUUUUUUUBBUUUBUUUBUUUUUU
UUBBUBUUBUBUUBBBBBUUBUUUUUBBUBUBUUUUBUUUUUUUBBUUBUUBUUBUUUUUBUUUBBBUUUUBUUBUUUBUUBUBBUUUUUUUUUBUUUUUB
BUBBUBUBBBBUUUUBUUBUBBUBUBUUUUUBUUUUBUUBUUUUUUUBUUUUUUUUUUUBUBUBUBUUUUBUUBUUBUBUUBUUUUUBUUBUUUBUUUUUB
UUUUBUUUUUUUUUUBUUUBUUUBBUUUBUUUUUUUBUUUUUUUUBBUUUUBUUUUUUUBBUUUUUUUUUUUUUBBBUUUUUUUUBBBUBBUUUUBBUUUU
UUUUUUBUUUUUUUBBUBBBUUUUUBUBUUUUUUUUUBUUUUUUUUUBBUUUUBUUUUBUUBUUUUBUUUUUBUUUUUUBUBUBBUBUBUUUUBUUBUBBU
BUUUUBUUUBUUBUUUUUUUUUUBUUUUBUUUBUBBUUUUUUBUUUUUBUUBBUBUUUBBBBUBBUUUBUUUBUBUBUUUUBUUUBUUUUUUUUUUUBUBU
UUUUUUUBUUBBUUBUUUBUUBUUUUBUBBUUBUUUUUUUUBBBUUUBUUUBUBUUBBUUUBUUUUUUUUBBUUBUUBUUBBBUUUBUUBBUBBBUBUUBU
UUBUUUUBBBBUUUBUUUUUUUUUUBUUUUUUUUUBUBBUUBUBUBUUUUUBUUUUBBUBUUBUUUUBUBBUUUBUUBUUBUUBBUUUBUUUUUUBUUBUU
UUUUUUUUUUUUUUUBUUUUUBUBUUBUUUBBUBBBBUUUUUUUUUBUUUUBUBUUUBUUUUBUBUUUUUBUBUUUBUBUUUBUUBUBUUUUUUUUUUBUB
UUUUUBUUBUUUUBBUUUBUUBUUUBUUUBUUUUBUUUUBBBBUUUUUUUBUUUUUBUUUUUUUUBUUBUUBUUUUUUUUUUUUBUUUBBBUBBBUBUUUU
UUUUUBBUUUUBUUUBBUUUUUUUUBBUUUUBUUUUBUUBUUBUUBUUUUBUUUBBBUBBUUBBBUBBUUUUUUUUBUBBUUUUUBUBUUUBUUBUUUUBU
UUUBUUUUUBUUUUUUUUUUUUBBBUUUUBUBUBBUUBUUUBUBBUBBUUUBUUUUUUUBUUUBUUUUUBUUUUBBBUBUUUUUUUUUBUUUUUBBUUUBB
BUBUUUUUBUUUUUBUBUUUUUUBUUUUUUUUUUUUUUUUUBUUUBBBUUUBUUBUUBUUBBUBBUUUUUUUUUUBUUUUUUUUUBUUUBBBBUBUBUBUU
UUUUUUUUBBUUBUUUUUBUBUBBUBBBUUBUUBUBUBUUBUUBUUUUUUBBBBUBBUUUUBUBBUUUBUUUUUBBUUUUBBBUUBUBUUUUUUUBBUUBU
UUBUUUUUBUUBUUUBUBBBUUUUBUUUUBUBUUUUUUUBBBUBUBBUUUUUBBUUUUUUUUUBUUBUUUUBUUBUUBUUUUUUBBUUBUBUUUBUUUBUU
UUUUUUBUBUBUUBUBBUBUUBBBUUUUUUBUUUUUUUUUBUUUUUUUBUBUUUUUBBUUBUBBUUUUBUBBUBUUUBUBBUBUUUUUUBUUUBUUUUBUB
UBUUUUBUUUUUUUUUUUBBUUUBUUUBBUUUBUUUBUUUUUUUUUUUBUUUUUUUBBUUBUBBBBUBUBUUUUBUUUBUUBUUUUUUUUUBBBUBUUBUB
BUBBBBUBUBBUUUUBBBUBBUUUUUBUUUUUBUUUUUUUUUBUBUUUUUBBUBBUUUUUBUBUBBUUUUUUBUUUUBUUUBUUUUBUUUBUUUBBUUBUU
UBUUUUBBUUUUUUUUBBUUUBBUUUUBUUUBUUUBUUUUBUBUBUUUUUUUUUUUBUBBBUUUBBUUUUBUBUBBUBUBUUUUUBUUUUUUUUUUUBUUU
UUUUUUUBUBUUUUUUUUUUUUUUUUUBUUBUBBBBBBUUBUBUUUUUUBBUBUUBUUUUBUBBUUUUUUUUUUUUBUBBUUUUUUUUUBBUUBUUUUUBU
UUUUUBUBUBUUUUUUBUBUUUUUBUUBUUUUUUBBUUUUBUUUUBUUUUBUUUBUUUUBUBBUUBBUBUUUBBBUUUUUUUUUBUUUUUUBUUBUBBUUU
BBBUUBUUUBBUUUUUUUUUBBUBUUBBBBBUBUBBBUUUUBUUUUUBUBUUUUBBUUBUUUUUUUUBBUBBUBUUBUUUUBUUBUUUUBUUUBUBBUBBU
UUUUUUUUUUBBUUUUUUUBBBUUBUUUUBBBUUUBUUBBUUUBUUUBBUBUBUBBUBBUUUUBBBUUUUUUUUBBUBUUUBBBUUUBUBUBUUUBUUBUB
BUUUUUBBUUBUUUUBUUUUUUUUBUUUBUBUBUUUUUUUUBUBUUUUBUUUUBBBUBUUBUUBBBUUUBUBUUBUUBUBBBUUBUUUUUBUUUUUUUUBU
BBUUUBUBUUUBUUBUUBUUUBUUUBUUBBUUBUUUUUBUBUBUUUUUUBBUUBUUUBUBUUBUUUUUUBUBUUUBUBUUUUUUUUBBUUUUBUBBUUUBU
UUUUUUUUBBUBUUUUUUUBUUUUUUBUUBUBBBBUUUUBBBBUBUUUUUBUUUUUUUUBUBUUBBUUBBUBUUUUUBUUUUBBUBBUUBUUUUUBUBUUU
UUBBUUBUUUBUUBUUUBBUUBUUUBUBUUBUBUUUUUUUUUUBUUUUBUBUUBBUBUUUUUBBBBBUUUUUUUUUUUBUUUUBUUUBBUUUUBUUUUBUU
UBBUUUBUUUUUUUUUUUUBBUBUUUBUUBBUUUBUUUBUUUBBUUUUUUUUBUBBUUUBUUUUUUUUBBBBBUUBUBUUBUUUBUUUBBBBUUUUUUUBU
BUUUUUUBUUUBUBBUUUUBBBUUBUUBUBUUUUUUBUBBBUUBUUUUBUUBBUUUUUUUUUUUUBUUUUUUUBUUUUBBBUBUUUUUUUBUBBUUUBUUU
UUBBUUUUUUUUUUBUUBUUBUUBBUUBUUUUUUUUBUBUBUBUUBUUUUBUUUUUUUUBBUUUUUUUUUBUUUUBUUUUBBBUBBUUBUUUUUUUBBUUU
UUUBUBUBUBUBUUUUUBUBUUBUUUBUUBBUUUUBUBUUBBUUUUUUBBUBUBBBUUUUBUUUUBBBBBBUBBUBUBUUUUUUBUUUBBUUUUUUUUBBU
UUUUBUBUBUUUUUUBUBUUBBUUUUUUUBUUBUBUBUUUUUBUUBUUUUUUUBUBUBUBUBUUBUUUUUBUUUUUUUUUUUUBBUUBBBUUUUUUUBBUU
UBUBUUUUUUUUUUUBUUUBUUUUUUBUUUUBBUUBUUUUUUBUUUUUUUBUBBUBBBBUUUUBUUUBUUBUUUUBUUBUUBUBBUUUUBBUUBBBBBBUU
BBUUUUBUUBUBUUUUUUUUUBUUBBUUUUUUUUUUUUUBUUBBUBUUBUUBUBUUUUUUBUUBUUUUBUUBUUUBBBUUUBUBUBUUUUBUUUBBUBUUU
UUUBBBBUUUUBUUUBUBBUUUBUUUUUUUBBBUBUUUBUBBUUUUUBUBUUUUBUUUUUBBBUUUUBUUUUBBUUUBUUBUUBUUUUUUBBUUUUUBBUU
UBUUUUUUBUUUUUBBBUUUUUUBUUBBBUUUUUUBBUUBBBBBBUUBBBUUUUUUBUUUUUUBUUUUUUUUUUBUUUUUBBUBUBUUUBUUUUBUUUUUB
UBUUUBBUBBUUBUBUBUUUUUUUUBBUUUUUUBUUUUUUUBUUUBUBUBUUUBUUUBUBBUUUUBUUUUUUUUUUBUUUUUUUUUUBUUBUUUUBBBUUU
