UUUUUUUBUUUUUBUBBUUBUBUUUUUBUUUBUBUUUBUUUUUBBUUUUUUUUBUBBUUUUUUUUUBUBUBBUUUUUUUUBUUBUBBUUUUUUUUUUBBUB
UUUBUBUUUBBUBUUBUUUUBUUBUBBBUUUUBUUUBUBUBBBUUUBUBUUUUUUUBUUBBBUBUBUBUUUUUUUBBUBBBBUUUUUUUBUBUUUUUBBBB
UUUUBUBUBBBUBBUUUBUUUUUBBBBBUBUUUUUBUBBUUUUUUUUBBUBUBBUUUBUUUBUUUBUUUUUUUUUUBUUUUBUUBUBUUUUUUUUUBBUBB
UBBBUBUUUUUUBUUBUBUUBUUBUUUBUUUBUUUBUUUUBBBUUUBUBBBUUUUUBUBUBUUUBBBUBUUUBUUUBUBUBBUUUBBUBBUBUUUUBUBUU
UUUBUUUBUUBBUUUBUUUUBUUUUUUUUUUUUBUUUUUUUUUUBBUBUBBBUUBBUUUUUUBUBUUUUUUUBUUUUUUUUBBUUUUUUBUUUUBUUUUUU
UUUUBUUUUBBBUUUBUBBUUUUUBUUUUUUBBUBBUBUUUBUUUUUBUUUBUBBUUUUUUUBUUUUBBUUUUUBUUBUUUUUBBUBBUBUUUUUUUUUBU
BUUUUBUUBUUUUUUUUUBUUUUUBUUBUBBUUUBUUUUUUUUUUBBBUBBUUUUBBUBUUBBBUUUUUUUBUUUUBBUBUBBUUUUBUUUUBUUUUUUBU
UBUUUBUUUBBUBUUBUUUUUBUUUBUUUUBUUBUBUUBUUUBUBUUUUUUUUUUUUBUUUUBUUBUUUBUBBBBUBUUUUUUBUUUUUUBUUBUBBUUUU
UUUBUUBBBUUUUUUUUBUUBUBUUBUBBUUUBUUBUUUUUUUUUUUUUUBBUUUUUBBBBUUUUBBUUUUBUUUUUUBUBUBUUBUBUUUUUBBUUUUUU
BUUUUUUBUBUUUBUUUUUUUUBUUBUUBUUUUUUUUUUBBUBUUUUUUBUUUUBBBBUUBBUUUBUBBBUUBUUUUBUBUUUUBUUUUUBUBUUUBUUUB
UUUBUUBUUUUUUBUUUUBUUUUUUBUUBUUUUUUUUUBUUBUBUUBBUBBUUUBUUUBUBUUUUBUBUUUUBBUUBUUUBUBBUUUUUBUUUBUUUBUUU
UUUBUBUUUUUUBBUUUUBBUUBBUBUBUBUUUUUBBBUUBUUBUBUUUBUUUUUUUBUUUBBBBBUUUUUUBUBUUBBBBUUUUUBBUBBUUUUUUUUUU
BUBUUUBBUBUUUUUUUUUUUUBUUBUUBUUBBUUUUBUUUUBUUUUBUBUBBBBUBUUUBUUBUUUUUUBUUUUBUUUUUBUUBUUUUUBUUBUBUUBBU
UUBUUUBUUBUBBUUUBUUUUUUUUUUUUUUUBUBUBBUUUUUBUUUUUBUUUUBUUBBUUUBUUUBBBUUUUUUUUUBUUBBUUBUUUBUBUBBUUUUBB
UUUBBUUUUUUUUUUUUBUUUBBUBBUUUUBUBUBUUUBUBUUUUBUBUUUUUUUUBBUUUBUUBBUBUUUUBUBUUUUUUUUUUUUUUUUUBUBBBUUUU
BUBUUUUUBBUUUBUUUUBUUBUBBBBUUUUUBUUUBBUBUBBBBBUUUUUBUUUUUBUUUUUUBUUUUUUUUUUBUUBBUUUBUBBBUBUUUUUBUBUUU
UUUUBBUBBUUUUBBBBUUUUUBUUBUUUBBUUUUBUUUUUBUUBBBUUBUUUUUBBBUUUUUBUUBBBBUUUBBUUBUUUBBUUBUUUBBUUBUUUBUUU
UUUUUBUUUUBBUUUUBBUUUUUBUUUUUUUUUUUUUBBUUBBUBUBBUUUUBUBBUBUUBBUUUBUUBUBUUUUUUUBBBUBUUUUBBBUBBBUUUBUUB
BUUUUBBBUUUUUUUUUUUUUBUUBUUUUUUUUUBUBUUUUUUUUUBUUUUUUUBUBBUUUUBUBBUUBUUBBUBUBUBUUUBBUUUBUBBUUBBBBUUBU
BUBUUUUUUUBUBUUUBUUBBBBUUUUUUBUBUBUUUBBUUUUUUUUUUUUUUUUBUUUUUUBBUUUUUUUUBUUBUUUUUBUUUBUBUUUUUUUUUUUUU
UUUBBUUUUUUBUUUBBUUBBUUBUBUUUBUBBUUBBUBUBUUUUUBUUBUUUUUBUUUBBUUUUUUBUUBUBUUUUUBUUUUUBUBUBBUUUUUUUBUUU
BUUBBUBUUUUUUUBUUBBUUUUUUBUUUBUUBUUUUUBUUUUBUBBUUBUUUUUBUBUBBUUUBBBUUUUBBUBBBBUUUUBUUUUUUBBUUBUUBUUUU
UUUBBUUBBBUUUUBUUUUBBUBUUUUUUBUUUUUUUBUUBBUUUUBUBUBBBUUUUBUUUUUUUBBUBUBUBUBUBBBUUUUUUUUUUUUUUUBBUUBUB
UUUUBUBUBUUBUUUUUUBBUUUUUUUUUBUUBBBUBBUUUBUUUBUBUBUUUUBUBUUUUUUBUBUBUBUUBBUUUUUBBUBUUUUUUUUUBBUUUBBBB
UBUBUUUUUUBUBUUUBUUUUBUBUUUUUUUUUUBUUBUUBBUBUUUUUUUBUBUUBBUUBBBUUUBBBBBUBUUUUUBUBUBUUBUUUUUUUBUUUBBUB
BBBUUUBUUUUUUUUBBUUUUUUUUUUUUUUUUUUBUUUUUBUBUUUUBUUBUBUUUUUUUBBUUBUBUUUBUUUUUUUBUUUBUUBUUUBBUUUUBUBUU
UUBBUUUBUUUBUBUUBUUBUUUUUUUBUUBBUUUUUUUUUUUUBUBUUUUUUUUBUUUUBBBUUBBUUUUBUUUUUUUUBUBUUUBUBUBUUBUUUUBUU
BBUUBUBUUBUUUBUBUUUUUBBUUUUBUUUBUUUBBBBBUUUUUUUBUBUUBUUUBUUUBUBUUUUUUBBUUUUUUUBUUBUUUUBBBUUUUUUBBBBUU
UUUUUBUBUUUBUUUUUUUBUUUUUUUBBBUUUUUUUBUUBUUBUUUUUBUUUUUBUUUBBUBUUBUBUUBBUUBUUUUUBBUUBBUUUUUUUBUUUUUUU
UUUUUUBBUUUUBBUBUBUUUBBUBUBUUBUUUUUUBUUUUBUBBUUBUUBUUUUUBBUUUBUUUUUUUUUUUBBBUBUBUBBUUUBUBUUUUUUUUUUUU
UBUUUUUUBUBBUUUUUBUBUUBUUBUBUUUUUUUUBUUUUUUUUUBUUUUUBBUBUUUUUUBBUBUUUUUUBUUUBUUUBUBUBUBUUBUUUUUUUBBBU
UUUUUUBUUUUBBUUUUUUBUUUUBUUUUUUUUUUBUUBBUBUUUBUUUUUUUUBUUUUUBUUUBUUBUUBBUUBBUUUUUUBBUUUBUUUUUUBUUUUBU
UBBUBUUUBUUUBUBUUUBUUUUBUUUBUUUUUUUUUBBBUUUUUBUBUUBUUBUBBBUBBUUUUBBUUUUUBBUBUBBUUBUUUUUBUUUBUUUBUUUBU
UUUUUUUUBBBUBBBBUBUUBBBUUUUUUBUBUUUUUBBUUBUBUUUBUUUUBUUBUUUBUBBUUBUUUUUBBUUBUUUBUBUBUUBBUUUUUBUUBUUBB
UUUUBUUBBBBBUUUBUUBBUBUUUUUBUBUUBUUUBUUBBBUUUUUUUUUUUUUBBUBUUUUUBBUUUUBUUUUUUUUUBBUUUUBUUUBBBUUBBBUUU
UUUBUUBUUUUUUUUUUUBBBUUBBBUUUUUBUUBUBUUUBBUUUUBUBUBUBUBBUBBUUUUUBUUBBUUBBUBUUUUUUUBUBUBUBUUUUUBUUUUBU
UBUUUBUUUUUBUUBBUUUBUUUBBUBUUUBUBBUUBUUUUUUBUUUBUBBUUBBUUUUBBBBUUUBBBUUUUUUUUUUBBUBBBBUUUUUBBUBBUUUUU
UBUUBBBUUUUBUUUBUUUUBBUBUUUUUUBUUUUUUUUBUUUUUBBUUUBBUUUUUUUUBBBBBBBUUBUUUBUBUUUUUUUUBUUBUUBUBUUUUBUBB
UUUUBUUUBBUUUUUUUUUUBUUBUUBUUBUBBUUBUUUUBUUBBBUUBUUUUUUUUUBUUUUUUUBUUUUBUUUUUUUUBUUBUBBBUUUBBBUBBBUUB
UUBBBUUUUUBUUUBUUUBBUUUUUUBBUUUBUUUBUUUUUUUUUUUUUUUUUUUUUUBUUUUUUUUBBUUBBBUUUUBBUBBUBUUUUBBUBBBBBUUBB
BUUBUUBUBBUUBUUUBBBUUUUUUUUUUUUUBUUUUBUUBBUUUUUUBUUUUUUUBUUUUUBBBUBUUUUUUBUUUUBUUUUBUBUUUUUUUBBUUUBBU
UBUUUBBUUUUBBBUBUBUUUBUUBUUUUUUBBUUBBBBBUUBBUBUUBUUBBUBBBUBBUUUUUBBBUBBBBBUUBBUUUUUUUBUBBUUUUUUUBUUUU
UBUBBBUBUUUUUBUUUBUUUBUUUUUBUUUUBUBUUUBUBUUBUUUBBUBUUUUUBUUBUUUUUUBBUUUUUUUUUUBUUUUUUUUUUBUUUUUUUUUUB
BUUBBUUBBUBUUUUUUUBUUUUUUUBUUUBUUUUBUBUUBBBUUUUUUUBUBUUUUBUUUUBUBUUUUUBBUUUUUUBBUUUBUBUBBBUBUBUUBUUUU
UUUUBUUUUBUUUBUUUUUUBBUUBBUBUBUUUUUBUUUBUUUBBUUUUUUUUUUBBUUBUUUUUUUUUUBUUBBUBBUBBUUUUUUBUUUUBUUUBUUUU
BUUUUUBBUBUUUUBUUUBUUUBUUBBUBBUUUUUUBBUUUUUUUUUBUUBUBUUUUUUUBUUUBUUUUUUUUUUUUUUUUUUUUUUBUUUBBUUUUUBUU
BBBUUUUBBBUBUUUUUBBUUUBBUUUBUUUUBBUUUUUBUUUUUUUUUBUBBBBUBUUUUBUUUUBUBUBUUUBBBUBBUBUUUUUBBUUBUUUUUUUBU
UUBBUBUBBUBUBUBUBBBBUBBUUUBUUBBUBBBUBUBUBBUUBUUUUUUUUBBUBUUUUBBUUBUUUUUUUUUBUUBUUUBUBUUBUUUUUBBUUBBUU
UUBBBBUUUUBBUUUUUUBUUUBUUUUBUBUUBUUUUBUUUUBBBUUUBUUUUBBUUUUUUBBBBUBBUUUUUBUBUBUUBBBUUUUUUUBBBUUBUUBBU
UUUUUUUBBUBUUUBUUBUUBUBUBBUUBUUUUBUUUUUBUUBUUUUUUUUUUBBUBUBBUBBBUUUBUBUUUUBUUBBBBBBBUBUUUBUUBUUUUUUUU
BUUUUUUUBUUUUBUUBUUUUUUBUUUUUUUBBBUUBBBBBBUUBUUUBUUBUBUUBBUUUUBUUUUUUUUBUUUBBUUBUBBBBUUUUUUUUUUBBUUUU
UUUUUBUUUUBBUUUBBUUBUUBUUBUUBBUUUUUUBBUUUUUUBUUUUBBUBBBUBUUUBBUUUBBBBBUUUBBBUUBUBUUBUBBUBUUUBBUUUBBBU
UUBUUBUBUUUUBBUUBBBBUUUBBUBUBUBBUUBUUUUUBUUUUUUBUUBBUBUUUUUUUUUBUUBUUUBUBBUUUUBUUUUBUUUBUBUBBBBBUUUUU
UBUBUUBBBUUUUUUUBUUBUUUUUUUUBBBUBUBBUUUUUUBBUBBBUUUUUUUUUBUUUUBUUUBUUUUBBUUUBBUUUUUUUBBUUBBUUUUBBUUUB
BUBUUUUUBUBUUUBBBUUUBBUBUBUBBUUUBBBBUUUUUUUUBUUBUBBUUUBBUUUUUBUUUUUBBUUUUUBUUUUUUBUUBUUBUBBUUBBUUUUUB
UBBUUUUUBBUBUUUBUUBUUUUUBUBUUUUUBBBUUUUBUUUBUBBUUBUUUUUUUUUUUBBBUUBUUUUBBUUUUUBBUUUUUUUUUBUUUUUBUUUUU
BUBUBUUUUUUUBBBUUUUUUUUBUUUUUBBUUBBUUUUUUUBUUUBUUBUUUUUBUBUUBUUBUUUUBUBUUUUUUUUUBUBBUUBUBUUUBUUUUUUUU
BUBUUUUUUUUUUUBUUUBBUBUBBUUUUUUUUBUBUUUUUUBBBUUUUUUUUUUUBUBUUBUUBBUUUBUBUUUBUUUBUUUBUUUBUUBUBUBUBBUUB
BBUUUUBUUBUUBBUBUBUBUBBUBBUUUUUUBUUUBUUUUUUBUUBBUUUBBUUUUUBUUBUUUUBUUUUBUUUUUUUUBUUUBUUBBUBBUUBUBUUUU
BUUUUBBUBUUUUUBUBUUBUUUUUUUUUUUBUUBUBUBUUUUUBUBBBBUBUBUUUUUUUBUBUUUUUUBUUBBUBUUUUBUUUUBUBUUBBBUUUUBUU
UUUBUUUUUUUUUUUUUBBBUUUUUBUUBUBUBUBUBBBUUBUUUBUBUUBUUBUUUUUUBUUBBUBBUBUUUUUUUBUBUUUUUBUUBBUBUBUUBBBUU
UUUUUUUBBBUBUUUUUBUUBBBUUUUUUBBUBUUUUUBBBBUUUUUUUBBUBUBUBBUUUUUBUUUUUBUBUUUBBBUBUUUUUUUUUUUUUUBUBUUUU
BBUUBUBUUBUUUUUUUUUBUUBBBUUUUUUUUUUBUBUUUUUBUUUBUBUBUUUBUUBBUBUBUBUUUUUBUUUUUBBUUUBBBUBBUBBUUBUUBBUUU
UUUBBBBUUUBUBUUUUUBUUBBUBUUBUUBUBUUUUUUUUUUBUUUBUUUUUUUUUUUUUUBUUBBUUUUUUBUUUUBUUBBUBUBBUUUBUUUBBBBBU
UUUUUUBBUBUUUBBBUBBUBUUUBUUUBUUUUUBBUUUUUUUUBUUUUUUUBUUUBUUUUBUUUUUUUUUUUUUBUBUUBUUUBBUUBUUBUBBUUUBUB
UUUUUBUUBUBUUUUUUBUUUUBUUUUUUUBBUUBUUBBUBUUUBUUUUUUUUBBBUUBBBUUUUBBBUUBBBUUBUUUBBUUUBBBBUBUUUBUUUBUBU
BBUBBUBUUBUUBUUUUBUUUBUUBUUUBBUBUUBBUUUBBBUUUUUUBBBUUUBUBUUUUUUBUUUBUUUBUBUUBUUBUUUBUUUBUUUUUUUBBUUBU
UUUBBBBUBBUUUUUUUUUBUUUUUUUUBBUUBUBUUUUUUUUUUBUUUUBBUUBUUUBUUBUBUUUUUBUUBUUUBBUUUUUUUUUBBUUUBUUBUUBUU
BUUBUUUBUUUUUUUUBUBUUUUUBUBUBUBBUUUUBUUBBUUUUBUUUBUUUUUUUUBUBUUUUBUBUBUBUUUUUBUUUUUUUUUBBUUUUBUUUUUUU
UUUBUUUBUUBUUUBUBBUUUBUUUBBUUUBUUUBUUUUUUBUUUUUBUUUUBUUUUBBUUBUUUBBUUUBUUBBUBUUUUBUUUUBUUBUUUUBUUBBUU
UUUBUUBUBUUUBUUUUUUBBUUUBUUUUUUUUUUUUUUUUUUUUBUUUUUUUUUUUUUBUUUUUUUBBUUBUUBUUUBBUBBUUBBBUUBUUUUBUBBUB
UBUUUUUUUUUUUBBUUBBUUUUUUUUBBUUBBBUBUUBBUBBBUUUUUUUUBUBBUUBUUBUUUUBUBUBBUUUUBUUUUBBBUUUUUUBUBUUUBBUBU
BUUUBBBBUBUUUUBUUBUBUUUUBUBUUUUUUUUBBBUBUBBUUBBBBUBUUUBUUUBUUUUUUBUUUUUUUUBUBUUUUUUBBUUBUUUUUUUUUUUUU
UUUUUUUUUBUUBUUUUUBUUUBBUBBBUUBUUUUUUBBBBUBUUUUUUUUBUUUUUUUUBBBBBUUUUBUUUUUUUUBBUUBUUUUUUBBBUUBUUUUBB
UUUUUUUBUUUUUUUBUUUBBUBBBUUUUBUUUUUBBUUUUUUBUUBUBUUUUBUUBBBUBUUUUUUBBUBUUUBUUBUUBUUUUUUUUBUBUUUUUUBUU
UUUBUUBUUUUUUBUUBBUBBUBUUUUBBBUUUBUBUUBUBBUUUBBBUUBUUUBUUBBUUUBUUUUUBUUUBUBBUBUBBUBUUUBUUBUUUUBUUUUBU
UUBUUBUUBUBBBUBUUBUUBUBUUBBUUBUUUUUUBBBUBBUUBBUUUUUUUUUUUUUUUBBUBUUUUUUBUBUUUUBUUUUUUUBBBUUUUUBBUBBBU
UUUUUUUBUUUUUBUUUUUUUUUBUUUBUUUUUUUUBUUUUUBUUUBUBUUUUUUUUUUUBUUBBUUBUUUUBBUBBUBUUUBUBBUUUBBUBBUUBUBBU
UUBUBUBUUUUUUUUBUBUUBBBBUUBUBUUBUUUBBUUBUUUBUUBUUUUUUBBUUBUUUUUUBUBBBUUBUUUUUUBUUUUBBBUUBUUBUUUUUUUBU
UUBBUUUUUUUBBUBUBUUUBUUUUBBBBBUUUBBUUUBUBBBUUUUUBUUUUBUUBUUBUUUUUUUUUBUUUUBBUUUUUUUBBBUBUUBUUUUUUBUUU
UUUUBBUUUUUUUUUUUUUBUUUBBUUBBBUUBUBBUBBUUUUUUUUUUBBUUBUUUUUUBBUBBUUUBUBUUBUUBUUUUBUUUUUUUBBUBBBBUUUUB
UUBUUUUUUUBBBUUBUUUUUUUUBUUBBUUBUUUUBUBUUBBUUUBUBUUUBUUBUUUBUUUUUUUBBBUUBBBBUBUUUBUBUUUBUUUUUUBUBUUUU
UUUUUUUUBUUUBUBBBUBUBUBBUUUUUUBBUBUUUUUUBBBUUBBBUUBBBUUBUUUBBBBUUUBUUBUBUUUUUUBUUUUUUBUUBUUUUUUUUUBBB
UUUBUUUBBBUUBUUUUUUUUUUUBUUUUBUBUUUUUUUUUUBUUBUBUUUUUBUUUUUBUUUUUBUBUUBUBUUUUBBBUBBBUUUUBBBBUUBUUUBUU
BUBBBUBUBUUUUUUUUUUUUBUBUUUBUUUUUBUBBUUUBBUUUBBUUUUBUUUUUBUUBUBUUUUBBUUUUUUBBUUBUUBUUBUBUUUUBUBUUUUUU
BUBUBBBUBUUUUUBUUBBUUUUUUBBBUBBUUBUUUBUUBUBUUUUUUBUUUUBUUUBBBBUUUBBBUBBUUBUUUUUUUUBUBUUBBUUUUUUUUUBBU
UUBBBBUUUUUUUUBUBUUUBUBUBUUUBBUUBUBUUUUUBUUUUUUBUUBUBUUUUUUBBUBBUUBUBBUUBUUUBBUUUUUUBBUUUUUUUUUUBUBUU
UBBUUUUUUBUUUUBUBBUUUBBBUUBUUBUUUBBBUBUUUUUUUBBUBUUUUBBBUUBUBBBUBBUBBBUUUBUUBBBUBUUBBUBBUUUUUUBUBUBBU
UBBBUUBUUBUUUBUUBBUBBUBUUUBBUUUUBUUBUBBUBUBUUUUUUBBUUUUUBUUBUUUUUUUUUUUUBUUUBUUBUUUUUUUBUUBUBUBUUBUUB
BBBUUBUUBUBBUBBUBBUUUBUBUBUBUBUUBUUUBBUUUUUUUUUUBUBUUUBUUUBBUUUUUUBUUBUBBUBUUUUBUUUUUUBUBBUBBUBUBUUUU
UUUBUUUBUUUUBBBUUUUBUBUBBUBBUUUUUUUUUUBBUUUBUUBUBUUUUUUUUBBUBUUBUBBBUUUUUUBUUBUUUBUUUUUBUUUBUUUBUUBBU
BUUUBBBUUBUUUUBBBUUUUUUBUUBUBBUBUBUUUUUBBUUUUBUUUUBBUUUBUUBUUUUUUUUUBBUUUBUBBUBUUUUUUBUUUUUUUUUUUBBBB
UBBUUBUUUUBUBUUUUUUUBUUBUUUUBUUBBUBUUUBUUUUBUUUUUBBUUBBUUBBBBUUBUBUBUUUBBUBUUUUBUBUUUUUUBUUUUUUBUUUBB
BBUBUUUUUUUBUUBUUBUUUUBUBUBBUUBUUBUUUUUBUBBBUBUUUUBBBUUUBUUUUUUUUUBUUUBBUUUUBBUUBUUUBUUUUBUUUUBBUUUUU
UUUBBUBUUUUUUUBUUUUUBBUUUUBBBUBUUBUBBUUBUUBUUBBBUUBUUBUUUBUUUBBBUUUUBUUUUUBUUUUUBUBUUUUUUUUBUUBUUBUUU
BUBUBUUUUUUUUUUUUUUUUUUUUBBBUUUBUUUUUBBBUBUUBBUUUUBBUUUUUBUUUUUUBUUUUUBBUBUUUUUUUUUBUBUUUBUBUBBBUUUBU
UUBUBUUBUUBBUUUUUUUUUUUBUUUBBUUUUBBUUUBUUUUUUUUUUUUUUUUUUBUUBBUUUUUBUUUUUUBUUUUUUUUUUUUBUUBUBUBUUBUUB
BUUUUUUBUBUBUUUUUUUUBUBUUUUUUUBBUUUBUBBBUUUUUUUBUUUUBBUUUUBBUUUUUUUUBUUBBBBUBBUUUUBBUUUUUUUBUUBUBBBUB
BBUBUBUBUUUBUBBBUBBBUUUUBUUUBUUUUUUUUBBBBBBUUUUBUUUUUUUUUUUUBUUUUUUBUUBBUUUBBUUBUUUBUBUBUBBBUUBUUUBUB
UUUUUUUBBUUUBBUBUBUUUBBUUUBUUUBUUBBBBUBBBUBUUBUUUUUUBUUUUUUUUBUUUBBBUUBUUBUUBBBUUUBBUBUBUUUUBUUBUUUUB
UBUUUUUUBUBBBUUUUBUUUUBUUUUBBBUUUUUUUUUUUBUBUUUBUUBBUUBBUBUUUUUUUUUUBUUBUUBUUUUBUUBUBUUUBBBUUUUBUUUUU
