UUUBUBBUBBUUUUBUBUUUUUUBUUBUUUUUUUBUBUUUUUUUUUBBUBBUUUBUBBBUUUBUUUUUBUUBUBBUUBBUUBUBUUUBBBUBUUBUBUUBU
UUUUUBUUUUUUUBUUUBUUUUUUUUUBBUUUUUUBUUUUUUUBUUUBUUUBUBUUUBUUBUUUUUUUUBUUUUBUUBUBUUUUUBUUBUUUUUBUUUUBB
UBUBUBBUUUUBUBBUBUUBUBUUUUUUUUUBUBBUUUBUUBUBUUUBUUUUUUUUUUBUBUUBUBBBUUUUBUBUBUUUUUUBBUBUUUUBUUBUUUUUU
UUUUUUBUUUBUUBUUBUUUBBUBUUUBBBUBUUUUUUBBUBUUUUBUUUBUUBUUBUUUBBBUUBUUUUUUUBUUUBBBUUUUUBUUUUUUUUUUUUUUB
UUUBUUUUUUUUUBBUUBUUUUUBUUBBBUUUBBUUUUUUBUUBUBUUBUUUUUUBBBBUUBBUUUBUUBUUUBUBUUBUUUBBBUUUBUBUUBUUUUUUU
UBBBUUUUBUBUUUUUUBBBUUUUUUUUUUUBUUUUUBUUBUUBBUBBUBUBUUUUBUUBUUBUBUUUUUBBUBUUUUUUUUUUUBBUBUBUUUUBUBUBU
UBUBBBUUBBBBUBUUUUUBUUBBBUBUUUBUUUUUUUBUBBUBBBUBUBBUUUBUUBBUUUUBUBBUBUBUUUUUUUUUUUBBBBBBUUBUUBUUUUBBU
UUUUBBUUUBUUBUUBBUBBBBUUBUUBUBUUBUBUUUUUUUBUUUUBBUBBUUUUUUUBUUUUUUUUUBUUUBUUUUUUUUBUUUBUUUUUUUUBUUUUU
BUUUUBUUBBUUBUUUUUUUUUUUBUUUUUUUBBUUBUBUUUBBUUBBUUUUUUUUBBUUUBUUUUBUUUUUUUUUBBUBUUUUBUUBUUUUBUUUUUUUB
BBUUUUUUUBBUBBBUBBUUBUUUUBUBUUUUUUUUBUUBBUUUBUBBUBUBBBUBUUBUBUUBUBUUUUUBUUUUUUBUUUBUUUUBUUUUUBUUUUUUB
UUUBUBUUUUBUUUUUBBUBBUUBUBUUUUUUUUUBBUUBUUUUUUBUUUUUUUBUUUUBUUUBUUBUUUBUUBBUUUBBUUUUBUUUBUBUBUUUUBUUU
UUBUUUUUUUUUUUBUUBUUUUBUBBUBBUUBUUBUUUBUBUBUUUUBUUBUBBUBUUBUUBUBBBUUUUUBBUBBBUUBBBUUBUUUBUBUUUUBUUBUB
BUUBBUUUUUUBUUBUUUUBUUUUUUBUBBUUUUUUUUUBUUBUUUBUUUUUBUUUUUUBUBBBUUUBUUBBUBBUUBBBUUUUUUUUUUBUUUBUUUBUB
UUUUBUUBUBBUUBBBUBBUBUUUUUBUBUUBUUUUUUBBUBUUUBUUUBUUUUBUUBBUUBUUUUBBUUUUUUUUUBUUUUUUUUUUUUBUUUUUUUUUU
BUUUUUUUUBUBBUBUBUUUBBUUUUUBBUBBBUUUUUUBUBBUUUUUUUUUUUBBUUUUUUBUUUUBUUBBBUUBUBUBUUBUBUBBUUUUUUBBBUUBU
UBBUUUUUUUUUUUUUUUUBUUUUUUUUUBUUBBUUUUUUBBBUUUBUUUUBUUUUUUUUBUBUUBUUBBUUUUUUUUUUUBUUBBUUUBBUUUUUUUBUU
UBBUUUBUBUUUBUUBBUUUBUBBUBUUUUBUUUUUBBUUUUBUUBUBBUUUBUUUUBUUBUUUUUUUUBUUUBBUUUUBUUBUUUUUBBUUUBUUUBUUU
BBUUBBUUUBBBUUUUBUUBUUUBUUBUUBUUBBUBUUUUBUBBUUBUUUBUUUUUBBUUUUUUUBUUUUUUUUUUUUBUUUUUUBUUBBBUUUBUUUBUU
UUUUUUUUUUUBUBUUUUBUUBUUUUBBBBBUUBUUBUUUBBUUBUUUBBBUUUBUUUUUBBUBUBUUUUUUUBUBUUBUBBUBUUBUUUUUUBUBUUUBB
UUBUUUUUUUUUUUBUUUUUUBBUUBBBUUBUUBUUUUUUBBUUUBUUUUUUBUUUBUUUUUBBUBBUBUBBUUUUBBUBUBBUBUUUUBUBUBUBBBUUU
UUUBBUUBUBBBUUUUUUBUUUUUUUUUUUBUBUUUUUUUUUUUUBUUUUUUBBBUUUUBUBBUUUUUUUUBUBBUBUUBUBUUUUBUBUUUBUBBBUBUB
BUUBUBUBUUUUUUUUUUUUBBUUBUUUBUBUUBBUUUBUUUUBUUUUUBBUBBUUUUUUUUBBBUBUUUBBUBBUUBUBBUBBUUUUBUUUUBUUBBUUU
UUUUUBUBBBBUUBBUUUBUUBUBUUUBUBUUUUUUUBBUBUUUUUUUUUBBUUBUBUUUUBUUBBUUUUUBUBUUUBUUBBUUUBUUUUUBUUBUUBBUU
UBUUUUBUUUUUUUUBUUUUBUBUUUUUUUBUUUBUUBBBUBUUUUBBUUUBBUUBUBBBUBBUUUBUBUBUUBUBUUUUUUUUBUBUUUUUBUUBUBBUU
BUBUUBUUUUBUUUUUBUUUUUUUBUUBBBUBUUBUUUUUUUUBUBUUBUBUUUUUUUUUUUBUUUUUUUUUUUUBBUUUUUUUUUBUUUUUUBBBUBBUU
UUBUUUBUUBUUUUUUBUUBUUBUBBUUUBUBUUUUUUBBBBUUUUUUUBUUUBUUBUUUUUUUUBBUUUBBUBUBUUUUUUUUUUBUUBUUUUUUUBBUB
UUBUUUBUBUBBBBUBUUBBBUUUUUUUBUUBUUBUUUBBBUUBUUUUUUUUBUUUUUUUUUUBUUBBUUBUUUBBBUBUUUBBUUBUUUUUUUUUUUUUU
UUBUUUUUUUUUBUUUBBUBUUUBBUUUBUBBUBUBUUUUUBUUBUBUUUUUUBBUUUBUUBBBUBBUUUBUBBUUBUUUUUBUBUUBBBBUUBBUUUUUB
BBUUUUUUUUUBUUUUUUBUUBUBUBBBBUUUBUBUUUUBBBUUUUBUUUUUUUUUUBUBBBUBUUUUUUUUUUBUUUBUUBUUBUUBBBUBUUUBUUUBU
BUUUUUUUUUUUUUUUUUUUBUUUUBUUBUUUBUUBBUUUBUBBUUUUUUUUBUUBUBUUUUUBUUUBUUUBUBUUBUUUUUUBBBUUBUUUUBUUUUUUU
UUUUUUUBUBUUUUUUBUUBBBUBUBUBUUUUBBBBUUUUUUUUUBBUUBUUBUBBBUUBUUUBBUUUUUBUBUBBUUUUBUUUUBBUBBUUBUUUUBBUU
UUUUBUUUUUUBUUUBUUBUUUUBUUBUBUUUUUUUUBBUBUUBUUBUUUUUUUBUUBUUBBUUUBUUUBUUUBBUUUUUUUUUUUUUBUUUUBBUUBBUU
UUUUBUUUBBUBUUUUUUUBBUUUUBUBBUUUUUUUUUBUUBUUBBBUUUBBUUUBUUUUUUUUUUUUBUBUBUUUUUBBBBUUUUBUUUUUUUUUBUUUB
BUUUBBUUBUBBBUUUUUUUBUUUUBUBBUUUBBBUUBUBBBUUBUUUBBBUUUUUBUUUUUUUBBBUUBUUBBUUUUUUUUBBBUBUBBUBBBUUBUUUU
UUUUUBUUUUBUUUBBUBBBBUUBBUUBUBUUBUUBBBUBBBBBUUBBUUUUUUUUUUBUUUUUBUBUUBUUBBUBUBUUUUUUUUUUBUUUUBBUUUUBU
BUUBUBUUUBUUBBUUUBUUUUUUUUUBUBUBUUBUUBBUBUBUUUUUUBBUUUUUUUUUBUUBBUUUBUBUUUBUBUUUUBBUBUUUUUUUUUBUBBBUU
UUBUUUUBUUBUUBBUBUBUBUUBUBBUBUUUUBBUUBUUBUBUBBBUBBUUBUBBUUUUUUUUBBUBBUUUUBUUUUUUUUUUBBUUUUUUBBUUUUUUB
UUUBUBBUUUBBUBUBUUBUUBBUUUBUUUBUBUUUUBBBBBUUBUUUUBBBUUBUBUBUUUUBBUUUUUUBBBUUUUUUUUUBUUUUUUUBUUUUBBBUB
UUUUBBUUUUUBUBUUUUBBBUBUBUUUUBUUUBBUUBUUBUUUBUUUUUUUUBBUUUUUBUUUUUBBUUUUBUBBUUUUBUBBUUUBBUUUUBUUUUBUU
BUBBUUBUBBUUUBUUUBUUBUUUUBBUUUUBUUBUUUUBUUUBUBBUUUUUUUUUUBUUBUUUUUUUBUBBBUUBUUBBUUBUUBBUBBBUBBUBUUUBU
UUBBBUUUUBBBUUBUUUUBBBBUUBUUBUUBUBUUUUUUUUUBBUUBUUUUUUUUUBUUUUUBUUUUUUBUUBUUUBUUUUUBUUUUBUUUBUBUBBUUB
UUUUUBBBBUUUUUBBBUBUBUUUUUUUUUUUBUUUUBUUUUUBBUUUUBBUBBUBUUUUUUUUBUBUUUBUUUUUUUBUUUUBUUBUBBBUBUBUUUUUU
BBUUUBBBUBUUBUUUBBBUUBUBUBUUUBUBUUUUUBUUUUUUUBUUUUUUBUUBUUBUBBBUUUBUUUUUUBUBUUBUBUUUUUBUUBBBUUUBBUUUU
BBUUUUUUBUUUUUBBUUUUUUUUUUUUUUUUBUUUUUBUUUUUUUUUUBUUUUUUUBBBBBUUBUUUUBUUUBUUBUUBUUUBUUBUUUUUUUBUUUBUU
UBUUUUUBBUUUUUBUUBBBUBUUUBUUBBUUUUBUUUUBUUUUUBBUUUUBUUBBBUUUUBBUUUBBUBUUUUUUUUBUUBUBBUBUUUBUBBBUBUUBB
UUUUUUUUUUBBUUBUUUUBUUBUUUUUBBUUUBBBUUBUBUUUBUUUUUUUUUBUBUBUUBUUBUUUUBUUUUUUUUUBBUBUBUUUBUBUUUUBUBBBB
UUUUUUBUBUBUUUUUUUUBUUBUUBUUBUUBBUUBUBUUUBUUUBUUUUUUUUBUBUBUBUUUUUUUBBBBUUBUUBUBUBBBBUBUUUUUUUUBUBUUU
UUUUUBBUUBBUBBUUBUUUUUUUUUUUBBUUUUBUUUBBUUUBUUBUBUUUUUUUBBUUBUBUBBUBUUUUUBUUUBUUUUUBUBBUUUUBBUUUBUUUU
UUBBUBUUBBUBBUUUUUBBBBUBBUBUBUBUUBBUBBUUUBUUBBUUUBUUUUUUUBBUUUUUBBUUUUBUUUUUUUUUUUBUBUUUUUUBUUUBUBBUB
UUUBBBUUUUUBUUUUUUUUUBUBBBUUUUBBUUUUUUUUUBUBUUUBBUUBUBBBBUUBBUUBUUBUBUUBUUBUUBUUUUBBUUUUUUBBUBBUBUUBU
BUUBUUUUUUBBUBUUUUUUBUBUUUBUBBUBUBUUUUUUUBUUUUUUBUUUUUBUBBUUUUUBUUUUUUUBUUUUBUUUUUBUUBUUUUBUBUBUUBBUU
UUUBBUBUBBBUUUUBUUBUUUUUUUUUUBUUUUUUUUBBUUBBBBUBUUBUUBUUUUBUUBBUBUBUBBUUUUBUUUBUBUUUBUUUUUBUBBBUUUBUU
UUBBUUUBUBUUUUUUUUUBUBUUBBUUBUUUUBBUBUBUUBUUUUUUUUUUUBUUBUBBBUUBUUUBBUUUUBBBBBUUBBBUUUBUUUUUBUUBUUUUB
UUUUUUUUUUUBUUBBBUUUUUUBBBUBBUUUUUUUBUUBUUBBUUUUUUUUBUUBBUUUUUUUUUBBUUUBUUBBUUBBBUUUUUUUBUBBBUUUBUUBB
UUUUUUBBUBUBUUBUBUUUUBBUBUUUBUUUUUBUUUUBUUUUBUBBUBUUBUBUBUUUUBUUBUBBUUUUUUBUUUBUUUUUBBUUUUUUBUBUUBBBU
UBUUBUUUUBBBUBUBUUUBBUUUUUBUUUBUBBUBUBUUUBUUUUBBUBUUUBUUUBUUUUUUUUUUUUUUUUUUUUUUUUBUUUUUBUUBUUUUUUUBU
UUUUBUUUUUUUBUUUBBUUUUBBUBBUBUBUUUUBUUUUBUUBUUBBBUUUUUUUUUUBUUUUUUBUUBUUUUUUUUBUBBUBBUBBUBUUUUUBUUBBU
BUBUUUUUUUUBBUBUBBBUBUBBUBUUUUUUBUUUUBBUUUUUBUUUBUUBUUBBUUUUUUUUUUUUUBBBUUUUUUUUUUBUUUUUBUUUBUBUBBUUU
UUBBUUBBUUBUBBUBUUBUUBUUUBUUBUUUUUUBUBUUUUUBUUUUBBUUBUUUUUUBBUUUBBUUUUUUBBUUUUBUUUUUUUUBUUBUBUUUUUBUB
BUUUBBBUUBUBUUBUBBUUUUBBUUUBUBUBUBBUUUUUUUBBUBUUUUUUUUUUBUBUUUBUUBUUBBBUUUUUUUUUUUBUBUBUBBUUUUUUUBBBB
UUUUUUBUUUBUUBUUUBUUBBUUBUUUBBUBBBUBUUUUUUBUUBBUUBBBUUUBUUUUUBUUUUBUUUUBUUUUUUUUUUUBUBBBBBUUUUUUUBUBU
UUUUUBUUUUBUBUUUBUUUBUBUUUUBUUBBUUBUUBUUUBUUUBUUUUUUUUUBUUUUUUUUUUUUUUUBUUBUUUBUUUUUBUUUUUBUUUUUUBUUU
UBUBUUBUBUUUUUUUUBUUBBUUBBBUUUUUUBUBUUBBUBUUUUUUBUUUUBBUUUBUBUBBUUUUUUUUUUUBBUBBUBBUBUUUBUUUBUBBUUBUU
BBUUBUUUUUBUUUBBBUUUUUUUUUUUBBUBUUBBBUUBBUUBUUUUBUUBUBBUUBUUUBBUUUUUUUUUUUUBBBBUUUUBUUUUUUUUBUUBUUUUB
UUUBUUUUBUBUUBUUUUUUBUUUUUUUUUUUUUUUUUBUUBUUUUUUUUUUUUUUBUUUUUBUUUBUUUBUUBUUUBUUBUBUUUUUUBUUUBBUBBBBU
UUBUUBUUUBUUBUUUUUUUUUUUBUUBUUUBUBBUUUUUUUUUUUUUBBUUBUUUUUUUUUUBBBBUUBBBBUBBUUUBBBUUUUBUUUUUUBUUUUBBU
BUUUBUUBUUUUUBUUUUUUUUUUBUBUBUUUBBUUBUUUUUBBUUUBUUBBUUUUUUUUUUUUUUUUUBBUBBUUUUBUUUUUUUBBBUUUBUUUBUUUU
UUBBBBBUUUUBBBUUBUBUUUUUUUUBBBBUUBUUUBUUBUBUUUUUUUUUUUUUUBBBUBUUUBBUBBUUUUBBBBBUBUUBUUUBBUUUUUBBUBUBU
UBUUUUUUUBUBUUUUUUBUUBBUBUUUBBUUBUUUUBBUUUUUUUUUUUBUUUUBBBUUUUBBBBUBUUBUUBUUUUBBBUUUUUUUUUUBBUBUUBUUU
UUUUUUUUUUUUBUUUBUUBUUUUBBUUUUBBBBUUUUUUUBUBBUUUBUUBUUBBBUUBUBBUBUUUUUUUBBBUUUBUUUBUBBUUUBBUUBBBBBBBU
BUUBUBUUUUUUUBUUBUUUUUUBUBUBBUBBUUBUUUUUUUUUUUBUBUUUUUUUUBUUUUBUUUUUBBUUUBUBUUUUBUUUBUBUBUUUUUBUUUUUU
BUUUUUUUUUUUUUUUBBUUUBUBUUUUBUBUUUBUUBUUUUUUUUUUUUUBBUUBBUUBUUUUUBUUUUBUUUUUUBBUUUUUUUUBBUUUUBBUBUUUU
UUUBBUUBUBBUUUBUBBUUUUBUUUUUBUBUUUUUUUUBUBUBUUUUUUUBUUBUUBBUUBUBUUBUBUUUUUUUUBUBBBUBUUUUUBBUUUUUUUUBB
UUBUUUBUUUBUUUUBUBUBUUUBBUUBBBUBUBBUBUUBUUUUUBUUBBUUBUUBUUUBUUUBBUUUUUUUBUUBUUUBUUUUUUUBUUUUBBUUBUBUU
BUUUBBUBUUUBUUBBBBUUBUBUBUUUUUUBUUBUUUBUUBUUBBUUBUUUUUUUUBUBBUUBBUBUUBUUUUUUUUUUUUUBUUUBBUUUBUBUUBUBU
UUBUUUBUBUUBUBUUUBUUUBBBUBBUBUUUBUBUBUUUUUUUBUUBBUUBUUUUUUUUUUBUUUUUBBUUBUUBUUUBBUUUUUBUUUBUUUUUBUBUU
BUUUBBUUUUUBBUUBUUBBUUUBBUUUUBBBBUBUUBUUBBUUUUUBBUUUBUBUUUUUUUBUUUBUUUUUUUBBUUUUUBUBBUBUUUUUUUUBUUUUU
UBUUBUUUUUUUBBBUBBUUBUUUBUBUUUBUBUBUBUBUUUUUUUUUBUUUUUUUUUUBUBUUBBUUUBBBUUUUBUBUUBUUUBUUUUUUUBUUBUBBB
UUUBBUUUBUUUUUUUUBUUUUUBUBBUBUUUUBUUUBBBUUUBUUBUUUBUUUBUBUBUUUUUBUUUUBBUUUBUBUUUUUUBUUBUUUUUBUUUUBUUU
UUBUUUBBBUBUUUUUUBUUUBUUUBUBBBBUUUUUUUUBUUUBBUUUUBBUUUUUUUUUUUUUUBUBUUUUUUUUUUBBUUUUUUBUBBUBUUBUUUUBB
UUUUUUUUUUUUUUBUBUUBBBUUBUUUUUBBUBUBUUUUUUUUUUBUBUUUUUUBBUUBBUBBUBUUUBUBUUUUUBUUBUUUBUUBBUBUUUUBBBBBU
UUUUUUUBUUBUUUBUUUBUUUUBBUUUUUUBBBUBUBUBUUBUUUUBBUBUUBUUUBUUUBUUUUUBBUUUUUBUUUUUUBUUUBBUUUBUUUUBBUUBU
BUBBUUUUBUUUBBBUBUUUUBUUUBUUUUBBUBUUUBUBUUUUUUUUUUBUUUUUUUUBBBUUUUBUUUUUBUBBUBUUUBUUUUUBBUUUUUBUUUUUB
UUBBUUBUUUBBUUUUUUUUBUBBUUUBUUBUUUUUUUUUUBBBBUUUUUUUUUUUUBUUUUUBBUUUUUUUBUUUUUBUUBBUBBUUUUBUUUBBUBBUU
UBUUUUUUUUUUBUUBBBUBUUUBUUUUUUBBBUUUBUBBUUUBBUUUUUUUBUUUUUUUBUUBUBBUUBUUUUBUBUUUBBBUUUUUBUBUBUUUUUUUU
UUBUUUUUUBBBBUUUUUUUUBUUBUUBUUUBUUUUBBUBUUBUUUUUUBBUUUBBUBUUUUUUBUUBUUUUUUUUBUBUBBUUUUUUBUUUBUBUUUBUU
UUUUUUUUUBBUUUUUUUUUUUBUUUBUBBBUBBUBUUUUUBUUUUUUUUUBBUBUUBBBUUUUBUBBUUUUUUBUUUUUUUBUUUBUBBBBUUUUUUBBB
UUUUUUUUBUUBUUBBUUBUUUBUUBUBUUUUUUUUUBUUBUUBUUBUUUUUBUUUUBBBUUBUUUUBUUUUBBBUUUUBBBBBBBUBUBUBUUUUUUUUU
BUUUUBUUBBBUUUUUUBBUUUUBBBUBUUBUUUBUUBUUUBUBUUUBUUBUBUUUUUUUBBBUBBUBBUUBUUUBBUUUUUBUBUBUBUUBBUUUBUUUB
UBBUBBUUUBUBUUBBUBBBUUUUUBUUUUUBBUUUUUBUUUUUUBUUUUUBUUUUBUBUUBUBUUBBUUUBUUUUBUUBUUUUUUUBUBUUBUBUBUBBU
UUUUUBUUUUUBBBBUUUUUBUUBBUBUUUBUUBUUUUUBUUBBBUUUUUUUUUBUUBUUUBUUUUUBBBUUUBUBUBUBUUBBBUBUUUUUUUUBBUUUB
UBUUUBUUUUUUUBUBUBUBUUBBUBUBBUBUUBBUUUBUBBBUBUUBBUUUBBUBUUBUUUUBBUUUBUUUUUUUUBBBUUUBBBUBUBUBUUUUBUUUB
BBBBUUUBBUBUUBUUBUUUUUUUBUUUUBUUUBBBBUUUBUUUUBUBUBUUBUUUBBUUUUUUBUUBUUUBUBUUUUUUBUUUUUUUUUUBUUBUBUUUB
UBBUUUUUUUBUUUUUUUBBBUUUBBUBUUBUUUBUUBBUUUUUUUUBUUUUUBUBBBUUUUUUUUBUUUUUUUUUBUUUBUUUBBUBUBBBUUUUBBBBU
UUUUUUBUBUBUBUUBUUUUUUUBUUUUUUUUBUUBUUBBUUUUBUUUBUUUUBBUUUUUBUUUBBBUUBBUBUUUUUBBBUUUUBBUUUBBUUUBUUUUU
UBUUBUBUUUBUUUBUUBUUBUBUBUBUBUUUUUUUUUUUUUUUUUUUUBBUUUUUUBUUUUUUUBUUUBBBUUBUUBUUBUUUBBUUUBUUUBUUBBUUU
BUBUUUUUBUUBBBUBUUUBUUUUUUUBUUBBUUUUUUBBUUBBUUBUUBUUBUUUUUUBBBUUBUUBUUBUUBUUUBUBUBBUUUBUUUUUBBUUUUUUB
UUUBBUBUUUUUUUUUUUUBUUUUUBUBBUBUBUUUUUUUBBUUBBBUBUUUUUUUUUUUUBUBUUUUUUUUUBUBUUUBUUUBUUUUUUBUBBBUUBUBB
UBBUUBUUUUUUUUBUBBUUBBBBUBBUUUBUUUBUUUUBUUUUUBUUUBBUUUBUUUUUBBBUUUUUUUBUUBUBBBUBUUUUUUUBUUUUUBBUUUUBU
BBUBUBBUBUUBUBUUUUUUUUUBBUUUUUBBUUUUBUUUUUBUBUUUUUBUUUUBUUBUUBUUBUUBUUBUBUUUUUBUUBUUBBUUUBUBUUUUUBUUU
BUBUBBUBBBBBBUUUUUUUUUBUUUBBUBUBUUUUUUBUBUUUUUUUUUUBUBBUUBBUBUBBUUBUUUUBBUUUBUUBBUUUUUBBUUUUUBUUBUBUU
