UUUUUUBBUUBUUBBBBUUUBBUUUUUBUBBBUUUUBUUUUUBBUUUBBUBUUBBBUUBBUUUUBUUUBBUBBBUUUUBUUUUBUBBUUUBBUBUBBUUUU
BUUBUBUUUUUUUUUUUUUUUUUUUUUUUBUUBBUUUUUUUUUUUUUUUUBUUUBUBBUUUBUBBBUUUUUUUUUUUUUUUUUUBUUUBUUUUUUUUUUBB
UUUUUBUUUUBBUUBUBUUBUUUUUBUUUUBUUUUBBBUUUUUUUUBUUUUBUUUUBBUUBUUUUBUUUUUUUBUUUBUUUUUBUUUBUUUUUUUUBBUUU
UUBUUUUUUUUUUUBUUBUBUUUUUUUBUBUBUBUUUUUUUBBBBBBUBUUUUUUBUUUUUUUUBUUBUBUUUBUUBBUUBBUBBUUUUUUUUUBUBBUUB
UUUUUUUUBBUUUUBUUUUUBUUBUUUBUUUBUBUBBUBBUUUUUUUUBUUUUUUBUUUUBUUUUUUBUBUBBUUUUBUBUUUUUBUUUBUBUUUUUUUUU
UBUUUUUUUUUUUBUBUUUUUUUUUBBBUUUUUUUUUUUUUUUUUBUUUBUUUBUUUUUBUUBUUBUUUUUUBBBBUUUUUUUUUBUUUUUBUBUUBBUUU
UUUUBBUUUBBUUBUUBUBUUUBUUBUBUUUUUUBBBUUBUUBUUUUUBUBBUBUUBUBUBUUBUBBUUBUUBUBBUBBUUUBUUUUBBUUUBUUUUUBUU
BUBBBUUUBUBUUUUBBUUUUUBBBBBUUUBUUUBBUUUBBUUBBUUBUUUUUBUBBUUBUUBUUUUUBBUUUUUBBBBUUBUUBUUUUUUUBUUUBBUUB
UUUUBUBBUUUUUUBBUBUBBBUUBBUUUBUUUUUBBUUUBBBUUBUUUUBBUUBUUUUUUUBUUUUUUUUBBUUUBUBUUUUUUBBUBUBBUUBBUUUUU
BUUUBUBUUUUUUUUUUUBUBUUUUUUBBUUBUBUUUUUBUUBUUUBUUUBBBBBBUUBBBUUUBUBBBUBUBUUUUUUUUUUUBBUBUBUUUUUUUUBUU
UUUUUBUBUUUUUUBUBUUUBUUUUUBBBUUBBUUUBUUUBUUBUUBUUUUUBUBBUUUBUUUUBUUBUUUUBUUBBBUUBBUUBBUBUBUUUUBUUUUUU
BBBUBUUUUUBUUBUBUUUUUBBUUBUBBBBBBUUUUUUUBUUUUUBUUBBBUBBUUUUBUBUBUUBUUUUBUUBUBBUUUBBUUBUBUBUUUUBBUUUBB
BBUBUBUUUUUBUUBUBBBUBUBBUUUUUUUUBUUUBUUBUUUUUBUBBUUUUUUUUBUUBBUUUUUUBUBBUUUUUUUUUUBUUBBUUUUUUUUUUUUBB
BUUUBUBBBUBUUUUBBUUBUUBUUBUBUUUBBUUBUUBBUUBUBUUUUUUUBBUUUUBUUBUBUUUUUUUUUBUBUUUBUUUUBBBUUUBUUBBUBUUUU
UUUUUUUUBBBUBBUBUUUUUUUUBUBUUUBBUBUUUUUUBUUBUUUBBUBUUUUUUBBUUUUBUUBBUBBUBBUUBUUUUUBUUUUUUBUBBBBUUUBBU
BUBUUUUUUUBUBUUBBBUUUUUUUUBUUBUUUUUUUBUUUBUUBUUUUUUUUUUBUUUBUUBUUUUBUUBUUUBUUUUUBBUBBBUUUBUUUUUUBUUUB
UUUUUUBUBUUUUUUBBUBUUUUUUBBUUUUUUUUBBUUBUBUBBUBBBBUUUBUUUUBUUUUUUBBUBUUBUUBUBBUBBBUBUBUUUUUUUBBBBBUUB
UUUUUBUUUUUUUUBUUUBUUUUBUUUBBBUUUUBUBUUUBBBUUUBUUUUUUUBBBBUUUUBUUUUUBUBUBUUUUUUUUUUUBUBBBUBBBUUUUUUBU
UBUBBUBBUUUUBBUBBUUBBBBUUUUBUBUUBUUBBBUBBUUUBUUUUBUUUBUUBUUBUUUUUUBBBUUUBBUUBUUUUBUUUBUUBBUUUBUUUBUUU
UUBBBUUBBUUUUUUUBBUUUUUUBUUBUUUUBUUUUUUUUUUUUUUBBUBUBUUBUUUBBBUUUBUUBUUBUUUBUUBUUUUUUUUUUBUBBUUUUUBBU
BUBBUUUBUBBBBBUUUUUBBUUBUUUBUUUUUBUUUBUBUUUUUUUBBUUBBUBUBUBUBBUBUUUUBBBBBBUBUUBBBUUUBUUBUBUUBBUUUBUBB
UUUUUBBUUUUBBUUBUBUUBUBUUBBUUUUUUBBBUUUUUUUBUUUUUUUUUUUUUUBBUUUUUUUUUBUUUUBBUUBUBBUUUUBBBUUBBUUUBUUUB
BUUUUUBUUBBBUUUBBUBUBBBBBUUUBBUUUUUBUUUBUUUUUUUUUBUUBBUUUUBUUBUUUBUUUBUUUBBUBUUUUBUUBUUUUUUUUBUUUUUBU
UUUUUUUUBUUUUUUUBUUUBUBUUBUUBBBUBBBUBUUUUUUBBBBBBUBUUBBUBUUUBBUUBBUBUBBUUUUBUBUUUBBUUUUUUUBUBUBUBUUUB
BUUUUUBUUUUBUUUBUBUUUUUBBUUUUUUBUUUUUUUUBUBBUUUUUUUUBBUBBUUUUBBUUUUUUBBUUBBUBBUUUUUUUUUBUUUUUUUUUUUBU
UBBUUBUUUUUUUUUBUUUUBUUUUUUUUUBUBBUUUUUUUUUBUUBUUUUUUBUUUUUUBUUBUUUUUUBUBBUUBBUUBUBUUUUUUBUUUUBBBUBUU
UUUBUBUUBUUUBUBBUUUUUBUBUBBUUUUUBUUUUUBUUUBUUUBUUUUUUBUBUUUUUUUBBUUBBUBUUUUUUBUUBUUUUUUUUUUBUUUBBBUUU
UUUUUUBUBUUUUBUUBUBUBUBUBBUBUUUUUUUBBUUBUUUBUUUUUBUUUBUUUUUUUBUUBUBUUUUUBUBUBUBUUBUUUUUUUUBUUBUUBBUUU
UUUUBUUUBUUUUBUUUUBBUUUUUUUBBBUUBUUBUUUBUUUUBBUUUBBUBUUUUUUUBUBUBUUUUUUBUBUBUBBUUUUBUUUUBUUUUUUUUUBBU
UBUBUUUUUUUUBUUBUUUUUBUBBUUBUBUBBUUBUBUUBUUUBUUBBUBBBUUUBBUBBUUUUUBUBUUUUUUUUUUUUUBUUUUUUBUUUUUUUBUUU
BUBUUUBUUBUBBUUBUUUUUUUUUUUBUUUBUBUBUUUUBUUUUUUBUUUBUBUUUUUUUUBUUUBUUUUUUUUUBUUUBUUUBUUUBUBBBUUBUUUUB
UUUUUBBBBUUUUBBUUUBBBUBUUBBBBUBUBUUUBBUBUBUUBBBUBBUBUBBBUBBUBBUBBUUBBBUUUBBBBUUUUUUBUBUUUBUBUUUUBUBUU
BUBUBUBBUUBUBBUUUUUUUUUUBUUBUBUBBUUBUUBUBBBUUBUUUBUUUBUUUUUUUUUUUBBBUBUUUUUUUUUUUUUUBBUUBBUUBUUBUUBUU
UUUBUBUUUBUUUUUUBBUUUUUUUUUUUUUUUUUBUUUUUUBUUUBUUBUBBUUUUUBBUBBUBUUUUUUUUUBBBUBUUUBUUUUUUUUUUBBUUUBUU
UBUUUUUBUUUUBUUUUUUBBUBBUUUBBUBBUBUBUBUBUUBUUUUUUUBUBUUUBUBUUUBUUUUUUUUUBBUUUBUUUUUUBBUUBUBUUBUUUUUBU
UUUBUUUBUUUUUBUUBUUUUBUUBUBUUBUBUUUBUUBUUBUUUBBUUUBUUUUBBBUUUUBUUUBUUUUUUUUBUUUUUUBUUUUUUUUUUUUUUUBBU
BUUUUBUUUUBBUUUBBBUBUUUBUUUBUUUUUBUUBUUUBUBUBBBUUUUUUUUUUUUUUBUUUUBBUUBUUBBUBUUUUUBBUUUBBUUBUUUUUUBUB
BBUBBUUUUUUBUUUUUBUUUUBUBUUBBUUUBUUBUUBBUUUUUUUUBUUUUUUUBUUUUBBBUUBBBUUUUBBUUUUBUBBUBUBBUUUBUUUUUBUUU
UUBUBBUUUUUUBBUUUUUBBBUUUUUUUUUUUUBUUUUUUUUBUUUBBBUUUUUUUUBUUUBBUUUBBUBBUBUUBBUBBUUUUBUUUUUBBUUBBBUBU
UUUBUUBUUBUUUUBBBUBUBUBUUUUBBBBUBUUUUUUUUUBUUUUBUUUUUUBUBUBUBBUUBBBUUUUBUUUUUBUUBBBUUUBUUBBUBBBUUUUBU
UUUUUUBBUUUBBUUUUBBBUUUUBBBUUUUBBBUUUBUUBBUUUUUUBBUUUBUUUUUUBUBUBBUUBUUUUBUUUUUBBBUUUUUBBBUUUUBBBUBUU
UUUUUUUUUUUUBUBBUUUBUUBUBUBUUUBUUUUUUUUUBUUUBBUUUBBUBUUUUBUUUUUBUUBUUUUUUBUUBUBUUUUUUUUBUUUUUBUUBUUUB
BUBUBUBUBUUUBUBUBUUUUBUUUUBBBUUUUBUUUUUUUUUBUUUUBBBUUUUUBBUUUBUBBUUUUUBUBBUBUUBUBBBUUUUBUUBUUUBBUUUBU
BUBUUBUUUUUUBUUBUUUUBUUUUBBUUBUBUUBBBUUUUUUUUUUBUUUUBUUUUBUUBUBUBUUBUBBUUUBUUBUBUBBBUUBBBUUBUUBUBUUBU
BBBUBUUUUBUUBUBUUUUUBUBUBUUUBBUUUUUUBUBUUBBUUUUUUUBUBUUUUBBUUBBUUUBUBBBUUUBUUBUBUBUUBBUBUBUUUBUBUBUBU
UUUUUBBUUUUUUUUUUUUUUBUUUBUUBUUBUUUUUUUUUUBBBBUBUUUBUUBUBUUUUUUBUBBBBUUUBBUBBUUBBUUBUUUBBUBUUUUUBUBBB
BBUBUUUBBUBUUUBUUUUUUBUBUUUUUBUUBUBUUUUUUUUUBBUUUUUUUUUBUUUUBUUBUUUUBUUBBUBUUUUUBBBUUBBUUUBBUUUUUBUBB
UBBUBUUUUUBUUUUUUUUBBUUUUUUBUUBBBUUUBBUUUBBUBBBUBUUUBBUBUUBUUUUUBBUUUUBBUUUUUUUBUUBBUUBBBUUBUBUUUUUUU
UUUUUUUUBBUUBUUUUUUUUUUBUUBUBUUBUUUUUBBUBUBBUUUBUBUUBBBUUUUUBBUUBUUUUUBUBUUUBUBUUBUUBBUUBUBBBBUBUBUBU
UUUUBBUUUUUUUUBBUUBUUUUUUUBUUUUUUBBUBBUUUUUBUBBBUUBBUUUBUUUBUBUUUBUUUUBUUUUUBUUBUUBBBBUBBUUBBUBBUUBUB
UBUUUBUUUBUUUBBUUUUUUBUUUBBUUUUBUUBBUBUBUUUUUBUUBUUBUBBUUBBUBUUUUBBUBUBUUUBBUUBBBUBBUUBUUBUUUUUUUUUUU
UUUUBUUUUBBUUUUUBBBUUBBUUUUBBUBUUUUUUUUUBUUUUBUUUBUUBUUUUBBUUUUUUBUUBBBBBBUBUUUBUUUUUUBUUUUBUBUUUUUUB
UUUUBUUUBBUUUUUUUBUUUUUUUUBBBBUUUBUBUBUBUUBBUUUUUUUUUUUBBUUUUBUBUUUUUUUUBUUUBUBUUUUBBBUUBBUUUUBUBUUUU
UUUBBUBUUUUUBUUUBUUUBUBUUUUUUUBUBUUUBUUUBUUUUUUUUBUUUBUUBUBUUUUUUUBUBUUBUUUUBBUBUUBBBUUUUBBUBUUUUBBBU
UBUUUUBUUUUUBUBUUUUUUUUUBUUUUUBUBUUBUUUUUBUUUBUBUUUUUUBUUBUUUUBUUBUBUUUUUUUBBUUUUBBBUBUUBBBUUUUUUUUUU
BUUUBBUUUBUBUUBBBBUUBUUUBUBUBUUUUBUBBUBUUUUUBUUUUUUBUUUUBBUUUUUUUUUUUUUUUUUUUUUUBUBUUUUUUUUUUBUUUUBUU
UUUUBBUBBBUUUUUBUUUBUUBBBUUUUUUBBUBUBUUUUUUUUBUUUUUBBUBUUBUUUBUBUUBUUUUUUUUBBUBUUUBBUUBUUBBUUUUUUUUUB
UUUUUUBUUUUUUBUUUUUUBUUUUUBBUUBUUUBBUUUUUBBUBUUBBUBUUUUUUUUUBUUUUBBUUUUUBUUUUUBBUUUBBUUUUUUUUBUUUBUUU
UBUUBUUUBUUBBUUUBBUUUUBUUUUUBUUUUUUUBUBBBBBUUBUBUBUUUBBUBBUUBBUUUUBBUUBUBUUBBUBBUUUBBBUUBUUBBBBUBUUBU
BUUUUUUUUBUUUUUBUBUUBUUUBUUUUUUBBUBUUUUUUBUUUBUUUBBBUUUUUBUUBUBUUBBUUUUUBBUUUUUUBBUUUUUUBUUUUBBUUUBUU
UUUUUUBBUUBUBBUUUBBUBUBBUUUUBUUUUUBBUUUUUBUUUUUBBBUUUUUUUBUBUBUUBBUUBBBUUUBBUUUBUUUUUUUUUUUUBUUUBUUBU
UUUUUUBUUUUUBBBBUUBUUUUUUUUBUBUUUUUUUUUBBUUUBUBUUBUBUUUUBBBBBBBUUBBBUUUUUUUUUUUBUUBBUUUUBUUBBUUBUUUUU
UBUUUBUUBUBUUBUBUBUUUUUUUUUUBBUBUUUUUUUUUUUBUBUBUUUUUUUUBUUUUUBUUUUUBUUUUUUUUBBUUUBUBUUUUUBUBUBUUUUBU
UUUUBUBUBUUUUUUUUUUUBUBUUBBUUUUUUBBUUBUUUUBUBBUUUUUUUUUBBBUUUBBUBUBUBBUUUUUUUUUUUUBUBUUBUUUUUBUUBBUBU
UUBBUUUUUUBBUUBUBUUUUBUUUBUUUUUUUUBUUUUBUBUUUUUUUUBUUBUBUUUUBUUUUUBUUUUUUUUUBUBUUBUUUBUBBBUBBUBBBUUUU
UBBUBUUUUBUUUBUBUUUBUBUUBUUUBUUBBUUUBUUUUBUUBUUUBUBBBUUBUUBBUUUUUUBBBUBUUUUBBBUUUUUUBBBUUUBUBUUBBUUBU
UBUUUUUBUUUBUUUUUBUBBUUUUUUUUBBUBUUUUBBUUUUBBUUUUUUUUBUUUUUBUBUUUUBUUUUUUUBBUBUUUBUUUUUUUUUUUUUUUUUUU
UBUUUBUUUUUUBUBUUUBUBUUUUUUUUBUBUUBUUUUBUBUBUBBUUUUBUUUUUUBUUBUUUUBBUUBUUBBUBUUBUUBUBUBUUUUBUUBUBBBUU
UUUBUUUUUBBUUUBBUUBUBBBUBUUBUUUUUUUBUUUUBUBUUUUUUBUUBUUUUBUUUBUUUUUUBUBUUUBBUUBUUUUUUBUUUUUBUUBBUUUUU
BUUUUUUBUUUUUUUUBBUUUBUUBUUUUBBUUUBUUBBUBBUBUUUBUUUBBBUBUBUBUUUBBUBUBBUUUUBBUUBUUUUBUUUUBUUUBBUUBUUUU
BUUUUUUUUUUUUUUUUUUUBUUUUBUUUUUBUBUUBUUUUBUUBUUBBUBUUUUUUUUBUUUUBBUBUBBUUUUUUUUBUBUUUBUUBUBUUUUBUUUUB
UUBBUUBBUUBUUUUUUBUUBUBBUUUUUUUUUUBUUUBUBUUUUBUUUBUUUBUBUUBUUBUUBUBUUUUBUBBUUBBUUBUUBUUBUBUUBBBUUUUUB
UUUUUUBBBUBUUUUBUUUUUUBUUBUUUUUUUBBUUUUUUUUUUBBUBUUUUBUUUBUUUUUUBUUBUUBUBUUUUBUBUBUBUUUUUUBBUUUUUUUUU
UUUUUBUUBUUBUUUUUUBBUUUUUUUUUBBUUBUBUBUUBBBUUUUUUBUUBUUUUUBUUUUBUBBBUUBUUUBUUUBBUUUUUUBUBUUUBBBUBUBUU
UBBUUUUUBUUUBBUUUUUUUUBBBUUBUUBBUUBUBBUBUUBUUUUBBBBBBBUBUUUUUUUUUUUUBUUUUUBBBUUUUUUUUBUUUBUUBUUUBBUUU
UBUUBUUUUBUUBUUUUUUBUBBBUUUBBUUUUUUUBUUUUUBUBUBBUUBBBUUUBBUBUUUBUUUBUBBBUUUUBUUBUUUUBBUUUUBUUUUUUBBBB
BUBUUBBBUBUUUUBUBBUBUUUBUUUUUBBBBBUUBUUBUUBUUUBUUBUUUBUUUUBBBUUUUUUUUUUBBUUUUUUUBBUUBBBUBUUUUBUUUUUUU
UUUBUUBUBBUUUUUBUUUUUUUUBUUUUBBBUUBUUUBBUUBBUUBUUUBBUUUUBBUBUUUBUUUUBUUUBBUUBUUUUBBUBBUUBUUBBBBUBUUUU
BUUUUUBBBUBUUUUUBUUBBUUUBUUUUUUUBUUUUUUBBBUBUUBUUUUUBUUBBUBBUUBUBBBUBUBBUUUUUBUUUBUUBUUUUUUBBUUBUUBUU
UUUBUUUUBUUBUUBBUUUUUUUUUUBBUUBUUUBUUUUBUBUBUBUBUBUBUUUBUBUUUUUUBUUBUUBUUUBBBBUUUUUUBUBUUBUUUUUBUUBUB
UUBUUUUUBUUUUUUUUBUBBUUUUUUUBUUUUBBUBUUBBBBUUBUUUUBBUBUBUBUUUUBUUBUBBUUBBUBUBBBUUBBUUUUUUUBUBUUUUUUBU
UUBBUBUUUUUUUUUBUUUBUBUBUBUUBUBBUUUUUUBUUBUUBUUUUUUBUUBBBUBUUUUUUUUBUBUUUUBUBUBUBUUUUBUUUUUBBBUUBBBUU
UUUBUUUUUUBUBUBUUBUBBBBUUUUUUUBBUBUUUBUBUUUUUUUUBBUUUUBBUBUUUBUUUUBUUUUUUUUBBBUBUUBBUUUBUUUUBUUUUUBUB
UUBUBBUUUUUUUUUUBUUUUUBUUUUUBUUUBBBBBUUUBUUBUUBUBUUBUUUUBUBUUUUUBUUUUBBUUUUBUUUUUUBUBUUUUUBBUUBUBUBBU
UUBUUBUBUUBUUUUUUUBUBBBUUUBBUUUUUBBBUUBUUBUBBUUUUUBBUUUBUUUUUUUBBUUUUUUBBBBUUUUBBBUUUBBBUUUUBBUUUBBUU
UUBUUUUBUUUUUUUUUBBUUUUUUUBUBBUUUBBUBUUBBUUUUBUUUUUBUBUBUBUUUBUUBUUUUUUBBUUUUUUUUUUUBBUUUUBUUUUUBBUUU
BBUUUUUBUUUUUUUUUUUUUUBUUUBBUUUUBUUUUUUUBUUUUUUBUUUUUBBUBUUUUUUBUBUBUUUUBBUUBUUBUUUBUUBUUUUUUUUUUUBBB
UUUUBUUUUUBUBBUBUBUUUUBBBUUBUUBUUUUBBBUUUUUBUUUBUUBUUUUUUUUUUBUUUUUBBUUBUUBUUBUUBUUUUUUUUUUUUBBBBBUUB
BUUBUBUBUUUUUUUBUUBBUUUUBBUUBBUUUBBBUUUBUUUUUUUUBBBUUUUUUUUBUUUUUUBUBBUUBUUUBUUBUBUUUUUUBUBBBUUBBBUUU
UUUUBUBBBUUBUUUBBUBUUUUBUUUBBUBUUUUUUUUUUBUUUUUBUUBBUUUUUUUUBUUUUUUUUUUUBUBUUBUUBBUBUBBUUUBUUUUUUBBUU
BUUUUUUUBUUUUBUUBUUUBBUBUUUUBUUUUUUBUBUUUUUUBUUBBBUUBUBUUBBBUUUUBUBUUUUUUBUBUUUBUUUUBBBBUBUBUUUBBUUUU
BUUUUBUUUUUBUBUUUUUBUUUBBUUUUUBUUUBBUBBUUUBUUUUUUUBUUBUUUUUUUBBUUUUBUUBUUBUUUBUBUUUBBUUBBUBBBUUUUUUUU
UUBUBUUUUUUBBUUBUUBBUUBUUBUUUUBUUUUUUUUUBBUBUUUUBUUBUUUBUBUUUUUBBUUUUUUUBBUUUUUUUUUBUBUBUUUUUUBUUUBUU
UBUBUUUUBUUUUBBUBBBUBUUBUUBBUBBUBBUUUUBBUUBBUUUUUUUBUBUUUUUUBBBBUUUBUUUUUUBBUUUUUUBUUUUUUBUBUBBBUBBUU
UUUUBUUUUUUUUUUUBUBUUUUUUUUBUUBUUUUUUUUUUBBUUUBUUUBBBUUBUBUBUUBUUBUUUBUUBBUUUUUBBUUBBUUUUBBBUUUUBBBBU
BUUBBUUUBUUUUBUUUUUUUUUUUUUUUUBUBBUUBUBBBBUUUBUUBBBUUBUUBUUUUUUBUUUUBBUUBUUBUUBBUBUUUBUUUUUUBBUBUUUUU
UBUBBUBUUUUUUBUUUUBUBUUBUUUBBBUBUUUUUUUBBBBBUUBUBUUUUUUUUUUUUBUUUBUUBUUUUUUUBUUUUBUUBUUUUBUUUBUUBUUUU
UUBUUUUUBUUUBUUUUUUUUUBBUUUUUUUBBUUBBBUUUUUUUUUUUUUUBUUUBUUUBBUUUUUUUUUUUUUUUUUBUUUUUBUUUUUUUUUUUUUBU
UUBUUUBUBBUUUUUUUUBUUBBUUBUBUBBUUBUBBUUUBUBBUBUUBUBUBBUUUUUUUUBUBUBUBUUBUBBBUBUUUUUUUUUUBUBBUUUBUBBUB
UBUBUUBBBUUUBUBUUUUUUBBUUBUUUUUBBUBBBUUUUUUUUUUUUBUUUUUBUUBBUUUBUUUUUUUBUUUUBUBUUUUUUBUUUUBUBUBBUBBUU
BUBUUUUBUUBUUUUUBUBUUUUBBUUUUUUUBBUUUUUUBBUUUUUUBUUUUUUUUUUUBUBUUUUBUBUUUUUUBBUBUUUBBUBUBUUUUBBUUUUUU
