UUUUBUBUUBUUUBUBUUUBUUBUUUBUBUUUUBUUBUUUUUUUUBUUUBUUUBUBUBUUUUUUUUBUUUUUBUBUBUUUUUBBUUBUUBUBBBUUUUUUU
UUUBBUUUUUUBUUBBUBUUUBUBBUUUBUBUUBUUUUUUUBUUBUBBUBUUBUUUUUUBUUUUUUBUUUUBUUBUBUUUUBBUBBUUBUBBUUBBUUUUU
UUUUUBUBUUUBUBBUUUBBUUBUUUUBUUBUBUBBUUBUUUUUUBUBUUBBUUBBUUBBBUBUBUUUUUUBUUUUUUUUBBUUUBUUBUBUUUBUUUUUU
BUBUBBBUUBUBUBUUUUUUUUUUUUBUUUUBUBUBUUUUBUUUBUBUUUUUUBUUUUUUUUUUUUBUUBUBBUUUBBUUUBUBUUUUUUBBUUBUBUBUU
BUUUUBUUUUUUUBBUBBUUBUUUUUBBUUBUUUBBBUUUUUUBBUUUBBBUUUUBBUUUBBUUUBUUUBUUBBBUUUUUUUUUUBBUUUUUBUUUUUBBU
BBBUUUUUUUBUBUUUUUUUBUUUUUBUUBUUUBUUUUUUBBUUBUBBUBBBUUUBUBUBUBUUUUUBUBBUUUUUUBUUUUUBUUBUUBUUUUUBBBUUU
BBBUUBUUUUUUUUUUBUUBUUBBUUBUUUBUUBUBUBUUUBUUBUUUUUUUUUUBUUUUUUUUUUUBUBBBBUUBBUUBUBBUBUUUUBUBUUUUUUUUB
UUUUBUBUBBBUUBUUUUBBUBUUUUBUBUUUUUUUBUUBUUUUBUUUUUUUUUUUUUUBBUUUUUUBUBUUUBUUUUUBBUUUBUUUUUUUUUUUUUBBU
BUUBBBBUUUUBUUUBUBUUUUUUUUUUBUUUBUUBUUUUUBBUBUUUUUBUBBUUUBBBUUBUBUUUUUUBUUUBUUBUUUBUUBUBBBBUUUUUUBBUB
UUUUUUBUUUUUUUUBUBUUUUUUBBUUUBUUUUBBUUUUBBUUUUBUUUUUUBUUUUUUUUUUUUUBUBUUBBBBBUBBBUUUBUUBUUUUUUBUUUUUU
UUUUUUUUBBUUUBUUBBUUUUBUUUUUBBUUUBUUUUBBUBBUBUUBUBUUUBUUUUBBBUUUUBBUBUUUBBUBUUUUUBUUUBBUBUUUUUBBUUUUU
UUUUUUUUBUUUUBUUUBUUBUUBUUBUUUBBBBBBBUUUUBBUUUUBUUUUUUBUUUUUUUUUUUBBUUBUUBUUBBBUUUBUBUUBBUBUBUUBBBUBB
UUUUUUUBUBUBUBUBBBBUBBUBUUUBUUUBBUUUUUBUUBBBUUBUUBUUUUUUUUUUUBUUUUUBUUUUBBUBUBBBBUUUUUBBUBBBUUUBUBUUU
UBBUUUBBUUUBUUUBUBUUUUUUBBBUUUBUBUUUUUUUUUUUBUUUUUBUUUUUUUUBUUUUBUUUUUUUUBBBUUBUUUUUUUUUBBUUUUBUUBUUU
UUBUUBUUBBUBBUBUBBUUUBUBUUUBUUUUUBUUBBUBBUUBUUUBBBUBBBBUUUUBBUBBUUBUBUUUBUUUUUBUUUUUBUBUBUUUUUUUUUBUB
UUUUUUUUUBUBUUUUUUUBBBUUUUBUUUUUUBUBUUUUUUUUUUUUBUUUBUBUUUUBBUUUBUUBUBUUUUUUUUBBUUUBUUUUUBUUUUBUBBBBU
UBUBBUBUUUBBBUUUUUUUUUBBUBUUBUBUBBUUBUUUBBUUUUUUUUBUUBUUUUBUUUBBUUUUUUBUUUUUBUUBBBUUUUUUUUBUUUBBUBUUU
UUBUUUUUBUUUUUUUUUUUUUBBUBBBUUBBUUBBBBUBUUBUUBUUUUUBUBUBUBUBBBBUUBUUUUUUUUUUUUUUUUUBUUUBUUBBUUBUBUUBB
UBUUUUUUUUBUBBUBUUUBUUUBBBUUUUBUBUUUBUUBBUBBBBUUUBUUUBUUBBUUUUUUUBUBUUUUBUBUUUUBBUUBUUUUBUBBBUBBBUBUU
UUUBUUUUBBUUBUUUUUUBUBUUUUUUUUUUUUUUUUUUBUUBUUBUUUUBUUUUUBBUUUUBBUUUUUUUBBUUUUUUUUUBUUBBUUUUUBUUUBBBU
UUUUBUUBUUUUBBUUUBUUUUUBBBUUUUUUBUBUBUUUBUUUUUBUUUBBUUUUBUUBBUUUUBUBUUUBBUBBBUUUUUUUUBUBUUBBBUBUUUBUU
BBBBUUUUUBBUUUBBUUUUUUUUUBUUUUUUUBBBUUBBUUUBUUUUUBUBBUUBUUUUUBUBUUUUUUUUBUUUUUUUUBUBUUUBBBUUUUUUUBUUB
UUUUUUUUUUUUUBUUUUUUUBBBUUUUUBUBUUBUBUBUUUUUUUBUUUBUBUUBBBUUUUUBBBUUUUBUUUUBBUUBUUBBUUUUUUUUUUBUUUBUU
UUUUBUUUUUUBUBUUUBUUUUUUBUBUUUUUUUUBUUUUUBUUBBUUUBBUUUUUUBUBBUUUUUUBBUBUUUUBBUUUUUUUUUBUBUUUUUUBUUUBU
UUUUUUUUBUUUUUBBBUUBUBUUUUUBUUUUBUBUBUBUBUUUUBUUUUUUBUUUUUBUUUBUBUBUUUUBUUUUUUBUUBBBUUUUUBBUUUUUBUUUU
UUUUUUUBUUUUBUBUBUUBUUUUUBUUUUUUUUUBUUUUBUUBBBUUBUUUUBBUBBUUBUUUUUBUUUUUBBUUUBUBUUBBUUBUUBUUBUUUUUUBU
BUUBUBUUUBUBBUBUBUUUUUBUBUUUBBUUBUUUBUUUBUUUUUUUUBBUUUUUUBUUBUUBBBUUUUUUUBBUUUUUUUBUUUUUUBBBBBUBUUUUU
UUBUUBBUBBUBUUUUUUBUUBBUBBUUBBBUUBUUUBBUBUUUBUUBUUUBUUUUUUBBBUBBUBUUUUBUBUUUUBUBBUUUUBUBUUUUUBUUUBBBB
UBBBUBBUUBUBUUUBBUUBUUUUUBBUUBUUBBUBUBUUBUUUUBUUBUUUUBBBUBBUUUUUBUBBUUUUUUUUUBUUBBBBUUBUUBBUUUUUUBUBU
BUUBBUBUBUUUUUUUUBUBBBUUUUUUBUBUUUUBUUUBBBUUUUUUUUBUUBUUUUBBBUUBUBBUUBUUUUBUUUUBBUUUUUUUUBUUUUUUUUUBB
BUUBUUBUUBUBUUBUUUUBUBUBBBUUUBUUBUBUUUUUUUUUUUUBBUUUUBBUUUBUUUUUUUUUBUUUUBUUBBUUBUBBUUUBUUUUBUUUUUBUU
BBBBUUUBUUBUUBUUUBUUUBUBBUUUUUUUUUBUUUBBUUUUBUUBBBUUBUUUUUUUBUUBUUBUUBUBBBUUBUUUUUUUUBUBBUUUBBUUUBUUB
UUUUBUBUUUBUBUUUUBUUUUUUUUUUBBUBUUUUUUUUUUUUBUUBBBBUUUUBBUBBBBUBUUBUUUUUUBUBBBBBUUUUBBUBUBBUUUUUBUBBB
BBUBUBUUUUBUUUBUUUUBUUBBUUUUUUUBUUBUUUBBUUBUBUBUUBUBUUUBUBUBUBBBUBBBUUBBUUUUUUUUUBUUUBUUUUUUUUBUUBUBB
UUUUBUBUUUUUUUBBUBUUBUBUUBBUBBUUUUBUUBUUUUBUBBUUUBBUUUUUUUBUBBBUBUUUUUUUUBBBUBUUUBUUUUUUUUBUBUUUUUUBU
UUUUBBBBUUUBBUBUUUUUUUUUBUUUBUBUUBUBBBBBUUUUUUBBUBUBUBBBUBBBBUBUUBUBBUBBUUUUUUUUUBUUUUUUUUUUUBBBBUBBU
UBUBBUUBBUUUUUBUUUUUBUUBUUUUUUUUUUUUUUUUUUBBBBUBUBUUBUUUUUBUUBUUBUBUBBUUUBUUUUBUBUBBBUUBUUUUUUBBBBUBU
UUUUUBUBUUUUBUUUUUUUBUUUUUBUUBBBUUBUUUUUUUBUUUBUUUUUUUUBBBBUUUUUUUBBBUUBBBUBBUUUUBUUUUBUBUUUUUBBUBBUU
BBBUBUBBUBUUUBUUUUUBUBUBUBUUUUUUUUUUUUUUUBUBUUUUUUUUBUUBUBUUUBUBUUUUBUBBUUUUBUUUUBBBUUBUUUUUUBUUBUBUU
UUBUUUUBUUBUUBUUUUUUUBUUUUUBUUUBUUUUUUBUUUBBUBUBUUUBBBUUUUUUUUBBBBBUUUUUUBBUBUUBUUBUUBUUBUUBUBBUUUBUB
UBUUUUUUBUBUBUUUBUBUBUBUUUUBUUUBUUUBUUBUUBBUUUUUUUUUBBUUBUBUBUUUBUUBUBUUUBBUBUBUBUBUUUUBUUBBUUBUUUBUU
UUUUUUUBBUBBBUUBBUUUUBUUBUUUUUBUUUBUBUUUUUUUUUBUUBUBUBBUUUUBUUBUUUBUUBUUUBUBBUUUBBUUUBUUUUUBUBUUBUBUU
BBUUUUUUUUUUUUUUUUUUUUBUUUUUUUUUBUUUUUBUUUUBBUUUUUUBUUBBUBUUBUUUUUUUBUUUUUUBUUUUUBUUUUUUUUUUUUUUUBBBU
BBUUUUBUBUUBUUUUUUUUBBBUUUUUUUUUUUUBUBUBUUUUBUUUUUUUUUBBBUBUUUBUBUBUUUUUBUUUUBUUBBBUUUUUUUUUUUUUBBBBB
BUUUUUUBBUUUBUUBBUUUUUUBUUUUUBUBUUUBUUUUBUUUUUUUUUUUUBBUUUUUUUUUBUUBUUUBUUUUUUUBUUUUUUUUBUUUUBBBUBUUB
UUBUUBUUBUBUUBUBBUUUBUBUBBUBUBUBBBUBUUUUBUBBUUBUUUBUBUUUBUUBBUUUUUUUUUUUUUUUUUUUUUBUBUUUUUUUBBUBBUUBB
UBUBUUUUUUUUBUUBUUBUUUBBUUBBUUUUUUBUUBUUUUBUUBUUUUUUUUUUUUUBUBBBUBUUUUUUUBBUUUBBBBUUBUBBUUUBUUUUUUBUU
BBUUUUUBUBUUUUUBUBUBUUBBBUUBUBUUBBUUUUUUUUUBUUUBUUUUUUBBUUUBUBUUUUUUUUUUUUUBUUUBUBUUBUUUUUUUUUBUUUUUU
UUUUBUBUBUUBUUUUUBUUUUUBUBUUUBUUUBUBUUUUUBUUUUUUUBUUUUUUUBBUUUUUUBUUUBUUUBBBUUBUBUBUUBBUUBUBBUUBUBUBB
UBUUUUBUBUUUBBUUBUUUBBBUBBUBUBUBUUUUUUBBUUUBUUBUUUUUUBUBUUBBUUUUUUUUUUUUUUUUUUUUBBBUUUUUUBUUBUUUUUBUU
UBUUUBBUUBUUUBUUUUUUBUUUBUUUBBBUUUBUUUUUUUUBBUUUUUUBBUUBBUUUUBUUUBUUUUUUBBUUUUUUUBBBBUUUUUUUUBBUUUUBU
UUUBUUUUUBBUUBUUUUUUUUBBBUUUUUUUUUUUUUUUBBBUBUBUUUUUUUUUBUUUUBUUUUBBUUUBBUUBUBUUUUUUUUUUBUBUBUUUUUBUB
UUBUUUUUBUBBUUUUBBBUUBBBUUUBUUBUUUUUUUBUBBBUUUBUUUUUBUUUUBUUUUBUUBUUUUUUUBUBUBUUUUUUBUUUUUUUBBBBUUUUB
UUUUUBBBBUUUUUUUBUBUUUUUUUBBUUBBBUBUBUUUUUUBUBUUBBUUBBBUBUUBUBUUUUUUUUUUUUUBUUUUUUUUBUUBUUUUUBUBBBUUB
UBBUBBUBUUBUUUUUUUUUUUUUBUBUUUBUUBBUUBBBBBUUUUUUUUBUUUBUUBUUUBUBUUBBUUUUUBUBBUUUUUBUUUUUBBUUBBUBUUUUU
UUUUUUBUUUUUUUBUBBUUUUUBUUUUBUUUBUBUUBUUUUUBBUUUUUBUUBBUBBUBUUBUUUUUBUBUBBBUBUUUBBUUUUUBUUBBUBUUUUUBU
BUUUUUUUUUUUUBUBUUBUUUBBBUUUUUUUUBUBUBUBUBUBUUBUUUUUUBUUUUBBUUUUBUUUBBUUUBBBUUBUUUUUBUBUBBUBUUUUUUUBU
BBUBUUUUUUBUUUUUUUUUBUBUUBBUUBUUUUUUUUUUUUUBBUUUUBUBUUUUUBUUUUBBUBBBUBBUUUUUUUUUUUUUUBBUUBBUUUUUUUBBB
BUUBBUUUUUBUUUUUUUBUUUUUUUUUBBUBUUBBBUUBUUUBUUUBUUBBUUUUUBBUBUUBBUUBUUUBBUBUUUUBBBBUUBBUUUUUUBUUUUBBU
UUBUUBUUUUBUUBUBUUBUUUUUUUUUUBBBUBUUBUUUUUBBBBUUUBBUUBUUUUUUBBUBBBUUUUBUUUUBUBUUUBBBUUUUUUBUUUUUUUBBB
BUBBUUBUUUUUBBBUUBBUUUBUBUUUUUUUUUUUUUBBBUBBUUUUUBBUUUUBBUBBBBBBUBUUUUBUBBUUUUBUBUBUBBUBUUUBUUBUUBUUU
BUUUUBUUUUUBUBUUUBBUBUBUUBUBUUUBUUBBUUBUUBBUUBBUUBUUUUBUUUUUBUBUUBBBUUUUBBBUUUUUUUBUUBUUUUUBUBUBBBBUU
UBUUBUUUUUUBBUBBBUUBBBBUUBBBBUUUBUUUUBUBUUUBUUBUUUUUUUUBBUUBUBUUUUUUBUUUBUUUBUUUUBUUUUUBUUBUBBUUBUUUB
UUBUUUUUUUUUUBBUUUBUUUUBBUBBBBBUUUUBUUUUBBUUBUUUUBUBBUUBBUBUUBUUUBUUUUUUUUUBBBUUUUUUBUBBBBUBBBBUBUUBU
UUUBUUBBBUUUUBBBUUBUBUUBUUBUUUBUUBUUBUBBUUBBUUUUUBBUUUBBUBBBUBBUUUBUUBUUUUBUUBUUUUUBBBUUUUUBUUUUUUBBB
UUBUBUUUUUBUUUUUUUBUBBUUUUBUBUUUBBUUUUUBBBUUUUBUUUUBBUUUUBUUUBBUBUUUUBUUBUUUBUUUUUBBBUBUUUUBBBUUUUUUU
UUBUBBUUUUUBBUUUBUBUUUUUUUUUBUUBBUUUUBUUUUUUUUBUBUUBUBBBUBUUBBUBUUBUBUBBUUUUUUUBUBBUUUUUUUUBUUUUUUBUB
UUUUUUUUUUBUBUBUBUUUUBBUUBUUUUBUBUUUBBUUBUUBBBBUUUUBBBUBBBUUBUUUUUUUUUBUBUBUBUBUUBBBUUUUUUUUUBBUUUUUU
UUUUUUUUBBUBUUUUUBUUUUUUBUUUUUUUUUUBUBBUUBUBBUUBUUUBBUUUUUUUUBUUUUBUBUUBBUUUUUUUUUBBBBUUUBUBUUUBUBUBU
UBBUBBBBUBUBBUUUUUUBUBUUUBUUBUUUUUUUBBUBUBBUUBUUBBUBBUUBUBUUBBUUUUUBUUUUUUUUBBUUBUBUBUBUBUUUUBBBUUBUU
BBBBBUUUUUBUBBUUUUUBBUBUBBBBUBUUUUBUUUBUUUUUUUUUUUUUUUUBUBBBUUUUUBBUUUUUUUBUUBBUBUUUBUUBUBBUBUUBBUBBU
UUBUBUUUBBBUBBUUUUUUUUUBUBUUUUUUUBUUUBUUBUUUUUBUUBUUUUUUBUUUUBUUUUUUUUUBBBUUBBUBUUUUUBBUBBBBUUBBUUUBB
UUUUUUBUBBUBBUUUUUUUUBBUUUBUUUUUBUBUUUUUBUUUUBUUBUUUUUBUUUUUBUUUBUBUUBUUUUUBUBUUBUUUBUUUUBUBBUUBUUUUB
UBUUBUBUBUUUUBUUUBUBUUUBBUBBUBUUUUUUUBUUBUUUUUBBBBBUUBUUBUUUBUUUUUUUUUUUUBUBUUBUUUUUBBUBBBUUUBBUBUUBU
UUUUUUBUUBUUUUBUUUUUBBUUBUUUUUBBUBBUUUUUBUUBBUBUUUBUUUUUUUUUUUBBBUBBUUBUUUBBUUUUBUUUUUUUUUBUBUBUUUUBU
UUBUBUUBUUUUUUUUUUBUUUUUUBBBUBBUUUBUUUBUUUUUUUBBUUBUUUUUUUUUBUBUUBUUUUUUUBUUUUUBUUUBUUBUUBUUUUUUBUUUU
UBUUUUUUUBUBBBUUBUUBBBBUUBUUUUBBBUBUUUUBUBUBUBUUUUBUUBBUBBUBUUUBUUUUUBUUBUUBUUBBBUBUUUUBBUUUUBBUUUBUB
BUUUUUBUUUUUUUBBBUUUUUUUUUUUUUUBBUUUBUUBBUBUUUBUUUUBUUBUUBBBBBBUUUUBBUUUUUUUUUUBUUUUUUUUUBUUBUUUUUUBU
BUUBUBUUUUUBUBUUUBUUUUBUUBBUUBUUUBUUBBUBUUBUUUUUUBUUBUUUBUUUUUUUBUUUBBUUUBBBUBUUUUUUUBUUBUUUBBUUBUUBU
UUUUBBUUBBUUUBUBUUUUBUBBBUUBUUUUUUUUUBUBUUUUBUUUUBUUUBBUBUUUUBUUBBBBUUUUUUUUUBUUUBUUUUBUBUUUUUBUUUBUU
BUUUBUUBBUUUBUBBUUUUUUUBBUUUUBUUBBBUUUUUUUUUBUUUUUBBUBUBUBUUUUUUUBUUUUUUBUUUUUUUUBBUBUUUUUUUUBBUUBUUU
UUBBUUUUBUBUBBUUBUBUUUUUBUUBUBUBUBBUBUUUBUUBUUBUUUUBUUUBBBUUUUUBBUBBUUUUUBUBUUUBUBUUUBUBBUBUUUUUUUUUB
BUUBUUBUBUUBUBUUUUUUUUUUUUBUUUUUUBUUBUUBBUBUBBUUUBUBBUUUUUUUUUUBUBUUBBBUBUUUUUUBBUUUUBUUBUBUUUUUUUBUU
UBUUBUBBUUBUBUBBBBUUBUBBUBUBUUUUUUUUUUBUUUBUUUBUUUUUUUUUBUUUUUBUUUUUBUUUBUUUBUUUUBUUUUUUUBUBUUUUBBBUU
UBUBBUUUUUBBUBBUBUUUUUUUUBUBUUUUUUUBBBUUUUUBUBUUBUUUUUUUUUUUBUUUBUUUUUBUUUBBBBUUUUUBBBBUUBUUUUUUUUBUU
UUUUUUUUBBBUBUUBBUUUUUUUUUBUUUUUBUBUUUUUUUBBUUUBUBUBUBBUUBBUUUBUBUBBBUUUUBUUUBBUBBUUUBUUUBBUBUUBBBBUB
UBUUUBUUUUUBUUUBUUUUUBBUUUUUUBUUUUBBUBUUUBUUUUUUUBBUUUUUUBBUUUBUBUUBUBBUUBBBUUBBUBUBBUUBUBUBUBBUUUUUU
UBBUUUUUBUUBUBBUUUUUUUUBUUUBBBBBBBUUUUBUUUBUBBUBBUUUUUBBBUBUBBBBBBUUBUUUUUUBUUUUBUUUBBUUBBUBUBUUUUBUU
UBBBUUUBUUUUUUUBBBBUUBUUUUUUUBUUUUUUUUUUUUUBBBBBBUUUUBUUBUBUBBUUUUUBBBUUUUUUUUUUUBUUUUUBUBBUUUBUUBBBB
UUUUUUUUUBUBBUBUUUBBBUUBBUUUBUUUUBUUUBBUUUUBBUBUUUUBUUUUUUBBUUUBUUUUUUUUUUBUBUUUBUUBUUUUUBUUUBBBBUBUU
BUUUBUUBUBBUUUUUUBUBBUUUBUUUUBUUUBUUUUUUBBBUBUUUUUUBUUUBBUUUUUUUBUUUUUBUUUUUUUBBUUBBUBBUUUBUUUUUUBUUB
UUBUUUBUBUBBBBUUUUUBUUUUUUBUUUBBUUUUBUUUUUUUBUUUUBUUUBBUUBUUUUUUBUUUBBBUBUUBUUUBUUUUUUUBUBBUBUUBUUUUU
UBUUUUUBUUUUUUBUUUUUUUBUUBBBBUUBBUUUUUBUUBUUBBUUBBUUUUUUUBUUUUUUUUUBUUUBBUUUBUUBUUBBUUUBBBUUUUUUUBUBB
UUUUUUBBUUUBUUUBBUUUUUUUBBUUUUUBUUBBUUUBBUBUBUBUUUUBUUUBUUUUUUBUUUUBBUUUUUBUUUUBUUUUUBUBUUUUUUUBUBBUU
UBUUUBUUBBUUUUUUBUUBBBBUUUUBBUUUBUUUBBBUUUUUUBUBBUUBUUUUBUUUUUUUBBBUUUUUUBUBBUUBUUUUBUBUUBUUUUUUUBBUU
UUUUUUUBUUUBUUUUUUUUUBUBUBUUUBBUUUUUUUBUBUBUUUBUUUUUBUUUUUUBUUUUUUBBUUUUUUUUUUUUUUUUUUUUBUBUUBUUUUUUB
BUUBBUUBBUUBUUUUUBUUBUUBBUUUUBUBUUUUUBBUUUBBUUUUUUBUBBUUBUUBUBUUBBUUUUBUUBUUUUBUUBUUBBUBBUUBUUUUUUUUU
BUUBUBUUUUUUBUBUUBUBBBUUUUUUBUUBUBUBUBUUUBUUBBUBUBBUUUUUUBBUUBUBUUUUUBUUBUUUUBBUBBUUBUUUUUUUUUUUUBUBU
BUUBUUUUUUBUBBUBUUUBBBUUUUUBUUUUUUUUUUUUBUUUUBUBUUBUBUBUUBBUUBUUUUBBUUBUUUUUBUBUBBBUBBUUUUUUUUBUBUUUU
BBBUUUUUBBBBBBBUUUUUBUUUUUUBUUBBUBUUUUUUUUUUUUUUBUUUUBUBUBUUUUBUUBUBUUUUBBBUUUBUUUUUBUUUUUUUBUUUUBUUB
UUUBUUUBBUBBUUUBUBBUBBUUUBUUBBBUUUBUUBUBBUUBUUUBBUUUBUUUUUBUUUBUUBUBUBUBUBBBUBBUBUUUUUUUBUUUUUBUUUUUU
