UUUUBUUBUBUBUUBUUUUBUUUUUUUBUBUUUUBUUUBUUBUUBUUBUUBBBUUBUUUUUUUUUUUUBUUBUBBBUBUUUUBBBUUUUBUBUUUBUUUUU
UUUUUUUUUUUBUUBBUBBUUBUUUUUUUBUUUUBBUUBBBBBUUUBBUUUBUBUBUUUUUBUUBUUBUUBUBBBBUUBUUUUUUUUBUBUBBUUUBBUUB
UUBBBUBUUUUUBBUUUUUUUBUUUUUUUBUUUUUUUUUBBBUBUUUUUUUUUBUUBUBUUBUUUUUBUBBUUUUUUUUUBBUUUBUUBUUUUBBUBBUUU
UUUUBUUUUBUBBBUUUUUUUUUUUUUUBBUUUUUUBUUUBUUUUBUBUUUUUUUUUUUUUUUBBUBBUBUBUUUUBUUUUUBBUUUUBUBBUUUBUBUUU
UBUUBBUUBUBUUUUUUUUUUUBUUUUUUBUBBUUUUUBUUUUUUUUUBUUBBBUBUUUUUBUUBUUUUBUUBBBBBUUUBUUBUUUUUBUUUUUUBUUUU
BUUUBUUBUUUBUUBBUBUUUUUUUUBUUUUUUBUUBUUBUUUUUUUUBUUUUUBUUUBUUUBBBUUUUBUUUUUUUBBUUUUUUUUUBUUUUUBUUUUUB
BUUBUBBBUUUBBUUUUUUUUUUBUUBUUBBUUUBUUBBUUUUUUUUUUUUUUUUUUUUUUUUBUUBUUUUUBBUUUUUUUUUUUUUBUBUUBBUUUUUUU
UUUUUUUUUUUUBUUUBUUUUUUUUBUBUUBBUUUUUUBBUUUUUUBBUUBUUBUUUUUUUUUUUUUUUUBUBUBUBUUBUBBUBUBUUUUUUUUUUUUBB
UBUUBUUBUUUUBUBUUBUUUUUBBUUBBBBUBUUUUUUUUUUBUUUBUUBBUBBBUUUUUBUUBBUUUBUBUBUUUUUUUBBUBUUUBBBBUUUUUBBBU
UBUUUUUUBUBUBUUUUUUUUUBBBBUUBUUUBUBUBUUUUUBUUUUUBBBUUUUUBUUBUUUUUUUUUUUBUUUUUUUBUUUUUUUUBBUBBUUUUUBUU
BBBUUBUUUUUUBBBUUUUUUUUUBUUUUUUBUBBUUUUBBUUUBUBBUUUBUUUUUUUBUUBUUUUUUUUBUBBBUUUUUUUUUUUUUUUUUUUUUUUUU
UUUUUBUUUBUUUBUUUBUUUBUUUBBBUUUUUUUUUBBBUUUUBBBBUBUBBUUBUUUUUUBBUUUUUUUBUUUUBUBUUUUUUUBUUUUBUUBBUUBUB
UBUBBUUUUUUUUBBUBBUUBUUUBUUUUUUBUUUUUUUUUBBUBUUUUBBUBUUBUUBUBUUUUUBUUBUBUBUBUUBBBUUBBUUUUUUUBUUUBUBBB
UUUUUUUUBBUUBUUUUUBUUUUUUUUUBBUBUUUBUBUUUUUUUUUUUBUUBUBUUUUUBUUBUUUBUBUBBUUUUUBUBUBUBUUUBBBUUUBUUUUBB
BUUBUUBUBBUBUUUUBBUBBUUUBBUUUUUUUUUBBBUUUBUUBBUUUUUUBUUUUBUUUUUBBUBUBUUUUBUUUBUBBUBUUUBUBUUBUUBUBUUUU
UUUUUUBUBBUUUUBBUUBUUUUUUUUUUUBUUUUUUUUBUUUBUUBUUUBUBUBBBUUUUUBBUBBUUUUUUBUUUUBBBUBUUUUBBUUUUUBUUUBUU
UUBUUUUBUBUUUUUBBUBBUUUBUUUUUUUUUBUUUBUUUUUUUUUUBBUUUBBUBUUBUBUBUUBUUUUBBUBBUUBUUUUBBBBUUUUBBUUUBBUUU
BUUUUUUUUBBUUUUBBBUBUUUUUUUUBUBUUUBUUUUBBBBUBBUUUUUUUBBUUBUUBBUBUUBUBUUBUUUBUBBUUBUUBUUUUUUUBUUUBUUBB
UBUBBUBUUBBUUUUBBUUBUUBBBUUUUUBUUUBUBBUBUUBBBUUUBUBUBBUUUBBUUBUUUUUUUUBUUBBBUUUUUBUUBBUUUUUUUUBUBUBUB
UUUUBUBBUUUUUUUUUBUBBBUBUBUUUBUUUUUBUBUUBUUUUBUUUUBUUBBBUUUUUBBUUBUUUUUUUUUBUBUBUUUUUBUBBBUUUUUBUBUUU
UUUUBUUUUUUUUUUUUUUBBBBBBBUBBUUBBUUUUUBUUUUUUBBUUBUUUUUBUUUBUBUBUUUUUUBUUBUBBUUBUUUBUUBBBUUUBBUBBUUBB
UUUUUBUBBUUBUUUUUBBUUUBUUUBUUUBUUBUUBUUUUBBUUUUBUUUUBUUUUUUUUUUUUUBUUUUUBUUUUBBUUUUBUBBBUBBUUBBUUUBUU
UUUUUUUUUUBBBUUBUUBUUUUUUBBUUBUUBBUUUBUBUUBBBUBUBBUBUUUUUBBUUUUUUUUUUUUUUUUBUUBUUUUUUUUBUUBUBUUUUUUBU
BUUUBUUBUBUUUBUUUUBUUUUUBUBUUUUBUUBBBUUUUUUUUUBUUBUBUBUBUBUUUUUBUUBUBBUUBBUBBBUUBUUUBUUUBBUUUUUBBUUBU
BUBBUUUUBBUUUUUBUBBBUUUBBBUUBUBUUUUBUUUUBUBBBUUUUUBUUUUBUUUUBUUUUUUBBBUBUUBUBUUUBUUUBBBUBUUUUUBUUUUBU
BBUBUUUUUUBUBUBUUUUBBUUUUBBUUUBBBBUUBUBUUUUUUUUUUUUBUBUBUUUUUUUBUUUUUBUUBUBUBUUUUUUBUUBBUBUBUUUUUUUUU
UUUBUUBUBUUBUUUUUBUUUUUUBUUBUBUUUUUUUUUUUUUUUUUUUUUUUBBUUUUBUUBUBBUBUUUUUUUUUUUUUUUBUBUBUUUUUUBUUBUBU
BUUBUUUUUUBUUUUUUBBUUUUUUUUBUBUUBUUBUUBBUUUBBBUBBUUUUUUUBBBUBBBUUUUBBBUBUUUUUBUUUUUUUBUUUUUUUBBUBBUUB
UBUUUBUUBUUBUUUUUBUUUUBUBUUUUBUUUUUUBUUUUUUBUBUUBUUUUUUUUUUUBUUUUUBUUUUUUUUUUBUBBUBUUBUUUBUBBBUBUBUBU
UUUUUUUUUUBUUUBUBUUUUUUBBUUUBUUUBUUUUBUUUBUUUBUUUUUUUBUBUUUUUBBUUBBBUUUUUUUBUBUUUUUUUUBUUUUUBBUUUUUUU
BUUUUUUUUUUUUBBBBUUUUUBUUBUUUUUUUUUUUUBUUBUUBUUUBBUBUUBUBUBBUBUBUUBUUUUUUUUBUUBUUUBUUUUUBBBBUUUUUUBBU
UUUBBUUUUUBBUUUUUUUUBUBUUBUBBUUBUUBUBUUBBUUBUUBBUUUBUUUBBBUUUBUUUUUUUBUBUBUUUUBUBUBUBUUUBUUUUUBBUBUBB
UBUBBUUUUUUBUUBUUUUUUUUBUBBBBUUUBUUBUUUUUBUBUUUUUUUUBUUUUBUBBUBUBUUBBBUUBUBUBUUBUUUUUUUUUUUUBBUUUUUUB
BBBUBUUUUBBUUUUBUBUUBBBUUUUBUUUUBUUBBBBUBBUUBUBUBUUBUUUBUUUBUBBUUUUUBUUBUUBUBUUUUBBBUUBUUBUBUBBUBUUBB
UBUUBUUUBUUUUBBUBUUUBUBBUUBUUUUBBBUUUBUUUUUUUBUBUBUUBUBBUBBUUBUUBUUUBUBUUUBBBUBBUBBUUUUBBUBUUUUUUUBUU
UUUBUBBBBUUUBUUBBUUBBUBUUUUUUUBUUUUBUUBUUBBUUUUUBUUUBUUUUBBUBBUUBUBUUUUUUUBUUUBUUUUBUUUBBUUUUUUBUUUUB
UUUUUUBUUBBUUUUBUUUUUUBUUUUUUUUUUBUUUBUUUBUUUUBBUUBUUBBUUUUUUBBBUUUUUUUUBBUUUUUUBBUBUBUUBUBUUUBUUBUUB
UBUUBUUUBUUUUBUUUBBUUBUBBUUUUUUUBUUBUUBBUUUUUBBUUBBUUUBUBBUUBUUUUUUUBUUUBBUUBBUBUBBUUUUUUUUUBUUUUUUUU
UUUBUBUUUUBUBUBUUBUUUUUUBUUUUUUUBBUUBBUBBUUUUBUUUUUBBUUUUUUBUUBUUUUUBBUUUUUUUBUUUUUUUBUBUUUUUUBBUUUUU
UUUBUUUUUUBUUUUUUUBUUBUUUUUUUBUUUUBBBUUUUUUUUBUUUUBUBUUUBBBUUUBUUUUBUUBBUUBUUUUBBBUUUBUUUUBUUBUUUUUBB
UBUUUUUUUUBBBUBUBBBUUUUUUUBUBUUUBBBUUUUUBUBUUUBUUBBUUUUUUUUBUUUUUUUUUBUUUBUUUUUUUUUUUUUUUUUBBUBUUUUUB
BBUUUUBUUUUUUUUUUUUBUBUBUUUUUUUUUUUUUUBBUUUUUUUUUBBBBBUUUBUUBUUBBUUUUBUUUUUBBUUBUBUUBUBUUUBUBUUUBUUUU
UUUBUBUUUBUBUBUUUBUUUUBUUUBBUUUUUUUBUUBBBUUBBUUBBUUBUUBUUUUUBUUUUUBUUUBBUUUBBUBUUUBUBUUUBBBBUBBBUBUBU
UUUUBUUUUBBBBUBBBUUUBUUUBUUBUBUBUUBBUBBUBBBUUUBUBUUBUBUUUUUUUBUUUBUUUUUUUUUBUUUBBUUUBUUBUUUUBUBUUUUBU
UBBBUUUUUUUUUUUUUUUUBBUUUBUUUUUUBUBUUBUUBBUUUUBUBUUBUUBBUBUUUBUUBUBBUUBUUBUUUUBUUUUUUUUUUUUUBUUUUUBUU
UUUUBUUUBBUUBUBUUUUUBUUUBUUUUBBBBBBBUUUBBUBUUUUUBUUUUUUUUBBUBUUUBUUUUUUUUUUUUUUBBUUUUUUUBUUUUUUUUUBUU
BBUUUUUBUUUBUUBUUUUUBUUUUUUUBUUUBUBUBUBUUUBUUUUUUUBUUBUUUUBUUUUUBUUUUUBBBBBBUUUBBUBUUBUUUUBUUUUUUBUBB
UUUUUBUUUUUUUBBUUUBUUBUBUBUUUUUBUUUBUUUUUBBBBUUUUBUUUUUBBUUUBBUBUBUUBUUBBUUBUUUUBBUUUUUUUBUBUUBBBUUUU
BUUUBUBBUBUBBUUUBUUUUUBBBUUUUBBUBUUBUUBUUUUUUUUBBUUUBUBUUUUUUUUUBUUBUBUUUBUUUUBUUUUUBUUBUUUUUUBUBUBBU
UUUUUUUBUUUUUBBUBUUUUUBUUBUBUUUUUBUUUBUBUUUUUUUUUUUUBBBUUBUUUBBUBUUUBUUBBUUUBUUUUBBUUUUBUUUBBBUBUUBBU
UUUUUUUUUUUUUBUUUBUBUUUBUBBUBUUUUBUUBUUBUUUBBBUUBBBBUBUBUUUBUUBUUUUUUUUUUBUUUUUBUUUBUBUUUUBUBUBBUBUBB
UBBUUUBBUUUUBUBBUUUBUUUBUBUUUUUUBUUUUBBBUUUBUUUUUUUBUUUBUUUBBUUBUBUUBUUUUBUUUUUBBUUUBUBBBBUBUUUBUBUUU
BBBUUUUUBUUBBUBBUUUBUUUUUBUUUUBUBUUUUUUUUUUUBBUBBBUBUUUUBUUBBBUUBBUUBUUBUBUUBBUUUUBUUUBBUUBUBBUBUUUBU
BUBUUUBUUUBUUUUUUUUUUUUUUUUUUUUUBBUBUUUUBUUUUBUUUUBUBUUBUUUUUUUBBBUUUUUBUUUUUBBBUUUUBUBUUUUUUUUBUBBUU
UUUBBBUBUBUBUUUUUUUBBUUUUUUBBUUUBUBUUUUUUBUBUBUBUUUUBUUUBBUUBUUUBBUUBUUBUUUBUUUUUBUBUBUUUBUUBUUUUUUUU
UUUUUUBUUBUUBUBUUUUUUBUBUUBBBUUUUUUUUUUUBUUUUUUUUBUUBUUUUUUUBUBUBUUBUUBUBUUUUUUUUBBUUUBBUBBUUBBUUBUBU
UBUUUUUUBUUUUBUUUBBBUBUUUUUUUUUUBBUUUBUUUBUUBUBUBUBUUUUUBUBUBUUUBUBBBBUBUUBUBBUUBUUUUUBUUUUUBUUUUBUUU
UUUBUUUUUUUBUUUUUUUUUBUBUBUBUBUBUBBUUUBUUUBUBUUUBBBBUBBUBBUUUUBUUUBUBBBUUBBBUBUUUUUUUBUUUUUBBUUBBUBBU
UUBUUUBUUUUUUBUUBBBUUUUUUBUUUUUUBUUBUUUBBBUUUUBBUBUBUUBUUBUUUBUUUUUUBUUBUUBUUUUUBUUUBUUUUBBUBUUUUBUBU
UUBBUUUUUUUUUUBBBBUBUUUBUUUUBUUUBUUUUBUUUUUUUUUUUUUUUUBBBBUBUUBUUBUBBUUUUUBUBUUBBUUBUUUUUBUBBUBUUUUUB
BUBUUUBUUBUUBBUBUUUUUBBBBUUBBUBUUBUUUBUUUBUUUBBUBUBBUBBUUUUBUBBBUBBUBUUUUUUUUUBUUBUUBUUBUUUUUBUBUUUUU
UUUBBBUBUBBBUUUUUUUUBUBBUUUBBUBBUBBUUUBUBUUUBBUBBBUBUBUUUUBUUUUUBUUUBUUUBUBBUUUUUUUBBUBUBBBUBUBUUUUUU
BUUUUUBUUBUUBUBUBBUUUBUBUUBBBUUUBBUUUUBUUUUUUBUUUBBUUUUBUBBBBBUUUUBBBUBBUUUUUBBUUUUBUUUUUUUBUBBUUBUUU
UBUBUUBBBUUBUUBBUBUUUUUBBBUUBBBUUUUBUBUBBUUBUBUUBUUUUUUBUUUUBUUUUUBUUBBUUUUBUUUBUBUBUUUBUUUUUBUUUUUBU
BUUUUUBBUUBUUBBUBUUBUUUUUBUBUBUUUUUUBBUUBUBUBBUUUUBUBUUUUUUUUUUBUUBUUUUUUUUUBUBUBBUUUBBUUBBBUUUBUBUUB
BUUBBUUUUBUUUBUBBUUUUUBBBUUBUUUUUUUBUBBUBBUUUUUUUUBUUUUUUUUUBUUUBBBBUUUBUUUUBUBBUUUUBUUUUUUUUBBBUBUUB
UUUUBUBUUUUBUUUUBUUUUUUUUUUUUBUUBBUUBBBBBBUUUUUUUUUUUUUBBUBUBUUBBUUUUBUUUUUUUUBBBUBUUBUUUUUUUUBBBBUUB
UUBUUUUBUBBBUUUUUUUUUBBBUUUBBUUBBUUUBBUUBUUUBUBUUBUUUUUUUUBBUBUBBUUUUUBBUBUUBBUUUUUUUUBBUUUUUUBUUUUBB
BUUBUUBUBBUUBUBUUUBUUUBUBUUUUUUUBBUUUBUUUUUUBBBBUUUBUBBUBUUUBBUUUBBBUUUUBUUUUUUUUUBUUUUUBUUUBUUUUUUBU
UUBUUUUUUBUUUUUUUUUUUUUBUBBBUBUBUBUBUUUUUBBBUUBUBUUBUUUUUUBBUUUUUBBBUBUBUUUBUUBUBUUUUBUUBBUUUUUUUUBUU
UBBBUBBUUBBUBBUUBUUUUUBBUUUUBUUBUUUUUBUUUBBUUUUUUUUUBBUBUUBUUUBUUUUUUUUUUUUUUUUBBUUUUUUBUUBUBBUUUUUUU
UBBUUUUUUUBUUUBBUUUBUUBUUUUBBUUUUUUUBUBUBUUBUBBBBBUUUUUUBBUUUUBUUBBUBBUBUUUUUUUUUUBBUUUUUBBUUUBUBUBUU
UUUUBUUBUUUUBUBUUUUBUUBUUUUBBUUUUUUUBBUUUUUUUUUUUUBUBUUUUUUUUUBUBUUBUUUBUUUBUUUUUUUBUUUBUUUUUBBBBUUUU
UUUUUBBBUUUUBUUBBUBUBBUUBUUUUUUUBUUUUUUUUBBUUUUUUBUUBBBUUBUBUBBUUUBUUBUUBBUUUUBUUBUUUUUUUUUUUUBUUBUUB
BBUUUUUUUBBUUBUBUUBUUBUBUUBUBBUUUBBUUUUUUUBUUUBBUUUUUBUUUUBUBUUBUBUUUUBBUUUUUUUUBUUUUUUBUUUUBBUUBBUUU
UUUBUUUBUUBBUUUUUUBUUUUUUBUBUBUUUUUBBUUUUUUUUUUUBUUBBBUUUBUUBUBUUUBUUUUBUUUBUUUUUUUUUBUUUBUUUBBBUUUUU
BUBBUUBUBUUUUUBBBBUUUUUBUUUUUUBUBBBBUBBBUUUUBUUUBUUUUBUUBUUUBBUBUUUUUUUUUUUBUBUBUBUBUBUUBBUUUBUBUBBUU
UUUUUUUUUBUBUBBUUUBUUUBUBUUUUUUUBBUBBUUBBBBBUUUUBBBUUUUUUUBUUBUBUUUUUBUUUBUUBUUUUUUUUBUUBBUBUUUBUUUUB
UBUUUBUUBUBBBUUUUUUUUUUUUBBBUUUUBBUUUUBUBUUUUBUUUUBUUUBUUUUUUUUUUUUBBBUUUBUBUBUUBBUUUUUUBUUUBUUBUUUBB
UUUBUUUBUUBUUUBBBUUUUUBBBUUUBUUUUBBUUBUBUUBUUUBBUUUUBUUUUUUUBUUBUUUUUUBBBUUUBUUBUUUBUBUUBUBBUUUUBBBBU
UUBBUUUUUUBUUBUBUUUUUUUUUBBUUBUUUUUUUBUUUBUUUUUUUUUUBUUUUUUUUUBUUUUBUBBUUBUUUUUUBBBUUUBUUUUUBUUUUBBBU
UUUBUUBUUUUUBBUBBBBBUUUUBUUUUUBUUBUUUUUBBUBUUUUUBBUUBBUUUUBUUUBUUBBBUUUUUUUUUBUUUUUUUBUUUUBBUUUUUBBBU
UBBUUUUUBBUUUUUUBUBUUUBBUUUBBUUUBUUBUBBBBBUUBUUBBBUUUUUUUBUUUUUBUUUUUUBUUUUUUUUBUUBUUUUBUUUBUUUUUUUUB
UBUUUBUBBBUUBUBUUUUUUUUUUBUBUUUUUBBUUBBUUUBBUUBBUBUUBUUBUUUUUBUUUUUBUUUUUUUBBBUUUUUBUBBUUUUUUUBUUUBBU
BBBUUUUUUUUUBUBUBUUUBUUBUUUUUBUUUUUUUUUUBUUBUUUUBUBUUBUUUUUUBUUUUUBUUUUUBBBUBBUBBUUBUUUUUUBUUBUUUUUUB
BUBUUUUBUUUUUBUBUUUUUUUUBUUUUBUBBUBUUUUUUBBBUBUUBUUUUUUUUUUUUUUBUBUUUUUUUBUBUBBBUUUUUBBUUBUUUBUUBUUUU
BUUUUBUUUUBBUUUBBUUBBUUUUBBUUBBUUUBUBUUUBBBUUBBUUUBUUBBBUUBBBUUBUUBUUBBUBUUUUBUBBUUBUBBUUUBUUUUUBUUUB
BBBUUUBUUUUUUUUUBUUUUBUUBUUBUUUUBUBBUUUUUBUUUUUBUUUUUUUUUUUUUUUUUUUUUUUBUUUUUUBUUBUBUUUUUBUUUBBUUUBUU
UUBBUUBBBUUUUBUUUUBUUUUUUUUBUUUBBBBUUUUUUUUUUBUUUUUUUUUUUBUBBBUBBBUUUUUBBUUBUUUUUUBBBUUBUBBUUUUUUUUBU
UUUUBUBUUUBUUBUUBBBUUUUUBUUBBBBUBUUUBBBUUBBBUUUUBBBBBUUUUUUUUUBUUUUUBUUUUUBUBUUBUUUBUBBUBUBUUBUUBUBUU
BBUUUBUUBUUUUUBUUUUUBUUUUUUBUUUUUUBUBUUBBBUUUUBUUUUUUUUUUBUBUUUUBUUUUUUBUBUBUBUUUUBUUBUUUBUUUUBUUUUUU
BUUUBUUUUUUBUUUBBUUUUUUBUUUBUUUBBUBUUUBUUUUUUUUUUUUBUBUUBUBUBUBBBUUUUBUBBUUUBUBUUUUUBBUUUUUBUUBBUBBUB
BUBUUBBBUUUUUBUUUUUUUUBUUUUUBUUUUUUUBUUUBUUBBUUUBUUBUUUUUBUBUBUUBUBUBBBUUBUUBBBBBUUUUUUUUUUUBUUBBUUUB
BBUBUUUUUUUUUUUUUBUUBUUBUUUBUUUUBUUUBBBBUUUBBBUUUUBUUUBUUUBUBUUUUUUUBUUUUUUBBUUUUUUUUUUUUUUUUUUUUBUUU
UUUUUUUUBUUBBUUUUUUUBUUUBUUBUUUUUUUUUUUUUUUUUUUUBUUUBUUUUUUUUBBBBUUUUBBUUBBUBBUUBUUUUUUUBUBUUUUUBUUUB
UUUUUBBBUUUBUUUUBBBUUUUUUBUUUUBUUBUUUBUUBUBUBBUBUUUBUUUBUUUBUUUUBBUUUUBUUUBBBUUBBBBUUBBBUBUUUBUUUUUBB
UBUUBUBUUBUUBUBBBUUUBUUBUUUBBUUUUUBUUUUUBUBBUUUUUUUBUBUBUUUBUBUUUUUBUBUUBUUUUUUUBUUUUUUBBUUUUUUBBUBUU
BBUBUUUUUUBUUUBBUUUUUBUUUBBUUUUBUBUBBUUUUBUUUUUBUUUBUUBUUBBBUUUBUUUUUUBUUUUUUBUUUUUUUUBUUBBUBUBUBUUUU
UUUUUUUUBUUUBUBUUBUBUBUBUUBUUUUUUUUBUUUBUBUUBBUUUUBUUBUUBUBUBBUBUUUBUUBUUUUUUUUBUUUUUBBUUUBBBUBBBBBUB
UBUUUBUBUUUUBBUUUUBUUUUUUUUUBUBBUUUUUBUBUBUUUUBUUUUUUBUBUUBUUUUBUUUUUBBUUUUBUBBUUBUBUUBUUUUUBUUUBUUUU
UUUUUBUUUUBBBUUUUUUUUUBUUUUUUUBUUBBUUUUBUBUUUBUBUBBBUUUBUBUUBUBUBUUBBUUUUBBUUBBUUUUUUUUUUUUUUUUBUBUUU
