UUUBBBBBBBUUUUBBUBBUBUUBUUUUUUUUUBUUUUBUUUBUBUBBUBUUBUUUBBUBBUUUUUUUUUUUBBUBBUUUUUUUBUBUUUUUBUUUUUUBU
BBUBUUBUUUBUBUUUUUBBBBUBBUUUBBUUUUBBUUUUUUUBUUUBUUUBBUUBBBUBUUUUBUBUUUBUBUUUBUUBUUUUUUUUUUUUUUUUUUUUU
UUUUUUUUUUUUUUUUUUBBBBUUUUBBUBUUUBBUUUUBUBUUUUUUBUBUUUUUUUUBUUUUBUUBUUUBUUUUUUUBUUUUUUUUUUUUUUUUBUBUU
BUUUUBUUUBUUUUBUUUUUUUUUUUBBBUUUBBBBUBUUUBUBBUUUUUUBUBUBUUUUUBBUUUUUUUUUUUUUUUBUUUBUUUBUBUBUUBUUUBUUU
UUUUBUUUUUBBUUUBUUUUBUUUUUUUUUUBUBBUBBUBUUUUUBUUUBUBUUUUBUBBBBUBUBUUUUUUBUUUUBBUUUUUUUUUBUBBUUUUUUUBU
UBBUUUBUUUUBUUUUUUUBUUBUUUBUUBUBUUUUUBBBUUBUBUUUUBUBUUBUUUUBBUBBUBBUUBBUBUBUUUUBUBUUUUBBUUUUUUBBUBUUU
UBUUUUUUBUUUUUUUBUUBUUUUBUBUUUUUUUUUUUUUUUUUUUUBUUUUUUUUUUUUUBBUUUUBUUUUUBUUUUUUUBBUUBUBBUUBBUBBBUUUB
BBUUUBUBUUBUUBBUUUUUBUUUBBBBUBUBUBBBUUUUUBUUBBUUUUUUBUUBUUUUBUUUUUBUBUBUUBUUBUUUUUUUUUUUBUUUUUBUBUUBB
UUUBUBUBUUBUUUUBUBBUUUUUUBUUBUUBBBUBUBUUUUUUUUUUUUUBUUUUBUUUUBBUUUUBUUUBUBUUBBUUUUUBBUBUUUUUUUUUUUUUB
UUBUUBUUBUUUBBUBUBBUUUUUBBUBBUBUBUUBUUUUBUUBBUBUUBUUBBUUUBBUUUBBBUBBUBUUUUUUUUUUUUUBUUUBBBUUBUBUUUUUB
UBUBUUBUBUUUBUUUBUUUUUUUUUBUUUUUUUUBUUUBUUUBUBUUUUUUUUUUUUBBUUUUUUUUUBUBBUUUUBBBBUBUBUUBUUUBUBUUUBUBB
BBBUUUUUUUUBBBUBBUBUUUUBBUUUUUBBBUUUBUUUBUUBUUUBUUUUBUBUUBUUBBUUUUUBBUUUUBBUBBUUUBBUBUUBBBUBBUUUUBUUU
UUUBUUBUUUUUUUUBUUUBBUUUUUUUUUUBUBUUUUUUUUUUUUUUUUBUUUUUBBUUBBBUBBUUBUUUBUUBUUUBUBUUBUUUUUUUUUUUUUUUU
UUUUUUUBUBUUBUBUUBUUUUBUBUUBUUUBUUUUUUUBUUBUUUUUBBUUUUBUBBBUBBUUUUBUUUBUUUBBUUUBUBUUUUUBBUUBUUBUUUUUU
UBUUBUUUUUUUBUBUUUBBUUUBBUUBUUUUUUBUUUBUUBUBBBBBUUUBBUBUUBUUUUUUUBUBBBBBBUUBUUUBBUBBUUBUUBBUBBUBBUUUU
UBUUUUUBUUBUUBBBUBBUBUUBBUUUBBUUBUBUBUUUUUUBUUUUUUUUUUUUBBUBUUUUUBUBUUUUUBBBBUUUUBBUUUBBUUBBUBUUUUBUU
BUUUUUBBUUUBUUUUBBBUUUBUUUUUUUBUUUBBUUBUUUUUUUUUUUBBUUUBBUUUBBUUBUUUBUUUUUBBUUBUBUUUUUUUUUBUBUUUUUUUB
UUBUBUUUUBBBUUUUUBUUUUUUBUUUBBUUUUBUBBUUUUUUUUUBUUUBUUUUUUUUBUUUUBUUBUBBBUUUBUUUUUUUUUBUBBBUBUUUBUUBB
UBUUUUBUBUUUBUUBUUUUBUBUUBUUUUBBUBUUBBUBBUUBUUUUUBUUBUBUUUUUUUUUUUUUUUUBUUBUUUBUUUUUBBBBUBBBUUUUUUUUU
BUUUBUBBUUBUUUUBBUUUUUUUUBUBUUUUUUUBUUUBUBUUBUBBBUUUUBUUUBUUBUUBBBUUUUBUUUBUBUBUBBBUUUUUUUBBBUUUBUUUU
UBBUUUUUBUUUUBUBUUUUUUBBBUUUBUUUBUUUUUBBUBUBUUBUBBUBBUBUBUUUUUBUUUUUBUUBBUUUBUUBUBUBBUUUUUUUUBBUUUUBB
UUUBUBUUBUBBBUUUUUUUUUUUUUUUBBBUBUUUUBUBBBUUUBUUBUBUBUUBUUBUUUUUUUBUUUUUBUBBBBUUUUUUUUBBUBUBBBUUUUUUB
UBUUBUBUUUUBBUUUUBBBBUBUUBBUUBBUUUBBUBBBUUUUUUUUUUUUUUUUBBUUUUUUUUUUBUUUUUBUBBBBUUUBUUUBUUUUBUUUUBUUB
UUBBUBBUUUUUUUUUUUUUBBBBUUUUUBUUBBUUUUUUUUUUUBUBUUUUBUUUBUBUUBBUUBUBUUUBUUUBUUUBBBUUBUBUUUUUUBUBUUUBU
BUBUBBBUUUBUUUUBUBUBUUUUUUUUUUUUUBBUUUBUUBUUUUBUBUUUUUUUUBBUBUBBBUBBUUUUUUUUUUBUUUBUBUUBUUBUUUUUUUUBU
UUBUBUUUUBUUBUUUUUBUUUUBBUBUBUUBUUUUUUUUUUBUUUUUUBBUBUBUUUBUUUBUBUBUUUBBUUBBUUBUUBUUUUBUUUUUBUUUUUUUB
UUUUUUUBBUBBUUUUBBBBBUUUBBBBUUUBUBUBUUUUBUUBUUBUBBUBUUUBUUUUUBUUUUUUUUBUBUUUBBUUBUUUUUUUUUBUUBUUUBUUB
UUBBUBBBBBUUUUUUUUUUBBBUUUUUBUUUUBBBUBBUBBUUUUUUUUUUUBUBBBUUUUUUUBUUBUUUUBUUBUUBUBUUUUUUUBUUUUUBUUUUU
UUBUUUUUUBUUUUUUBBBBUUUUUUUUBBUBBUUUUUUUUUBUUUUUUUUUBUUBUUBUUBBUUUUBUUUBUUUUUUUUUUUUUUBBBUBUUUUUUUUBB
BBBBUUUUUUUUUUUUUUBUBUBBUBUUBBUUUUUUUUUUBBUBUUBUUUUUUUUUUBUUUUBUUBUUBUUBBUUBUUUUUUUUUBBUBUBBBUUUUBBUB
UUUBBUUBBUUUUBBBBUUUUUUUUUBUUBBUUUUUUUUUUUBUBUUUUBUUUUBUBUUUBUUBBBBUUUUUUBUUUUUUUUBUBUBBUUUUUUUBUUUUU
UUBBBUBBUUBUUUUUUUBUUUUUUUBUUBUUUUUUBUUUUBUUUUUUUBBUUUUUUUBUUUUUUBUUBUUUUBUUUBUBBUUUBUUBUUUBUUUBUBBBB
UBUUUBBUBUUBBUUUUUBUBUBUBUUUUUUUUUBUUUUBUBUBUUUUBBBUUUBUBBUBUUBUUBBUUBBUBUUUUUUBBUUBUUBBUUUBBBBBUUUUU
UUUUBUUUBUUUUBUUUUBBUBUUUUBUUUBUUUUUUBUBBUUUUUUBUUUUUUBUUUUUUUBUUUBUUUBUBUUUUUBBUUUBBUUBUUUUUBUBUUBUB
BUUBUUUUUBUBBUUBBBUUBBUUBUBBUUBBUBUUBUUBUBUBUUUUUUBBUUUUBUBUBUUBUUUBBUBUUUUUUBUBBBBUBUBUUUUUBUUUBUUUU
UUBBBBBBUUBUUBUUUBUBUUBUUUUUUBUUBBUBBBUBUBUBUBUBBUBBUUUBBUUUBUUBUUBUUBUUUUBBUUUUBUUUBBUBUUBBUBUUBUUUB
UUBUBUBBUUUBUUUUBBUUUUUUUUBUUUBUUUUBBUUUUUUUUBUUUBBUUBBUUBUUUBBUUUUUUBUUUUBBUUUUUBUUBUUUBUUUUUBBUUUUB
BUBBUUBBBUUBBUUUUUBUUUUBUBUBUUUUUBBUUUBBUUUBUUBUUBUUUUBBUUUBUUBUUUUUUUUUBBUBUUBBUUBUBBUBUUBBUBUBBUBUU
UUUUBUUUUBUUUUUUUUBBUUUUUUUUUUUUUUUBBBUUUUUUUUUUUUUBUUUUBUBBBBUBBBUUUBUUUUUBBUUBUUBUBBBBUBUBUUUBUBUUU
BUUUUBBUBUUUUUUUUUUUUUBUUBUUUUUUUUUUBUUUUUUUUBUBUUBBUUUBUBUBBBUUUUBUBUUUUBUUBUUBUUUUUUUUBBUUUUBBUUUBU
BBUUUUUUUBUUUUBUBUUUUUUBUBUUUUUBUUUUBUUUUUBUUUUUUUUBUBBBUUUBUUBUBBBBUUUUBBUBBBUUUUUUUBUBBUUBUUUUUUUBB
UUUUUBBUUUUBBUBUUUBUUUUUUBUBUUUUUBUUBBUUBUUUUUUBBBBBUUBUBUUBUBUUUBUUUUBUUUUBUUUBUUBBBUUUUUUBBUBUUUBUB
UUBBBUUUUUBBUUBUBUBBBUUUUBUBBUUUUUUUUUUUUUUBUUBUUUUUUUUUBUUUUUUUUUUBBBUBBUBUBUUUUUUBUUUBUBUUUUBBUUUUU
BBUUBUBUUUUBUBUBBUUUUUUUUUBUUUUUUUUUUUBUUUUBUBUUBUBBBBUUUBUUUBBUBUUUUBBUUUUUUUUUUBUBUBBBUUUUUUUBBBUUU
BBUUUUUUUUBBBBBUBUUBBUUBUUBBBBBBUUUUUBUUBUBBUUUUUUBUBUUUBUBUUBBUUUUBUBBUUUUBUBBBUBBUBUUBUUBUUUUUUUUUU
UBUBUUBUUUUUUUUBUUUUUBUUBUBUBUBUBUUUBUUBUBBUBUUUUBUUUBBUUUUUUUUBBUUUBUUUUBUUUBBUUUUUUUUUUUBUUUBUUUUUU
UUUBUUUUUBUBBBBUUUUBBUUUUUUUUBUUUUBBBBBUBUBUUBUUUUUBUUUUUUBBUUUUBUUUBBUUUBUBUUUUBBBUUUBBBUUUUUUUBUBUB
UUBUUUBUBUBUUBBUUBUUUBBUUUUBUBBUUUBUUUUUUUUUUUUUBUBUBUBBUUUUUUUBUUUUUBBUUUUBBBUBUBBUBBUUBUUBBUUUUUUBB
UBUUUBUUBBUBUUUBUUUUBUUBUBUBUUBBBUBUUUUUBUUBUBUBUUUBUUBUUUUBBUUUUBUUUBBBBUUUBUUBBUUUUUUUUUUUUBUBUBUUB
UUBUUUUBUUBBUUBUUBBUUUBUUUUUBBUUUUUBBBUUBBBUUUBUBUUUBBUUUUUBBUUUUBUUUUUUBBUBBUBUBUBUBUUUUUUUUBUBUUUUU
UUUUUUUUUUUBUUBUUUUUBUBUUUUBUBUBUUUUUUBUUUBBUBUUUUUUUUUBUUBBBUUUUUBBBUBUUUUUUUUUUUUUBBUUUUUBUUBUUBBBU
UUBUUUUUUUBUUBUUUUUUUUUBUUUUUBUBUUUUUBBUUUUBUUBUBUBUUUBUBUUBBUUUUUUUBUBUUUBUUUUUUBUUUUUUUBBUBUUBUUBBB
UBUUUUUUBUUBUUBUUUUUUBBUBUUUUBBUUUUBUBBUBUUUUUBUUBUBBUBUUUUBUBUUBBUUUUBUUUUBBUUBBUUUUUBUUUBBUUBUUBUUB
BUBUBUUUUUUUUUUBUUUBUUBUBUBBBUUUUUUUUUUUUBBBUBUUUUBUBUBBBUUBBUUBUUBBUUUUUUBBBUUUBUBUBUUBUUBBUUUUUUUUU
UUUUBUUUBUUUUUBBUUBBUUUUUUUUBUUUUBUUUUUUUBBUBUUUUBBUBUUUUBUUUBBUUUUBUBBUUUUUBUUUBUBBUUUUUUUUBUUBUUBBB
BBUUUUUBBUBUBBUUUUUUBUUBUBBUUUUUUBUUUUUUBUUUUBUUBUBUBBUBUBBUUBBBBBBUBUUUUUBBBBBBUBUUUBBUUUBUUUBUUBBBB
UUBBUUUBUBUUUBUUUUUUUUUUUUUUUUBUBUUUUBUBUBBUUBUUBUBUUUBUUUUUUUUUBBBUUBUUBUBUUUUUBUUBUUBUUUUBUUUBUUUBU
BUUUUUUUBUUUBUUUUBUBUBBUUBBUUUUBUUUUBUUBUUUUUBBUBUUBUUBUUUUBUUUBBUUUUUBUUUBUUUBBUUUUUUUBUUUUUBBUBUBUU
BUUUUUUUUBUUUBBUUUBUUUBUUBUUUUUUUUBBBUUUBBUUUBBUUUUBUUUUUBBUUUUUBBUUUUUUUUUBUUUUUUUUUUBBUUUUBUUUUUUUU
BUBUBUUUBBBUUUUUUUUUUUUUUUBUBUBUBBUUUUUUUUBUBUUBBUUBBUUBBUUUUUUUUUUUBBUBUBBUUUBUBBUUBBUBUUBUUUUUUBUUU
UBBBUUBUUUBUUUBBUUUBUBBUUUUUUBUUUUUUUUBUUUUBBUUBUUBUBUBUBUUUUBUBBUUUUUBBUUBUUUUUUBUUUUUBBBUBUBUUBUUBU
BUBBUUBUUUUUBUUUUUUUBUUUUUUUUBUUBUUUUUUUUBUUUBBUUUUBUUBBBUUUUUUUBBUBUUUUUUUUUUBUUBUUBUUBUUUUUUUUUBUBU
UUBUUBBUUBUBBUUUUUUUBBBBUBBUBBUUUUUBUBUUUBUUUUUUUUUUUUUUUUUUUUUUUUUUBUBBBUUBUUBUBUUUUBBBUBUUUBUUUUUUU
UBUUUUUBBUBUUUUBUUBUBUUUUUBUUUUUUBUUUUUUUUUUUUUUUBUBUBUBUBUUUUBUUBUBUBUUUUUUUUBUUUBUUUUUBUUBUUUUUUUUU
UBUBBUBUUUUUBUUUUUUUUUUBBUUUUUUBBUBBUBUBUUUUBUBUBUUUUBBUUUUBUBBUBUUBBBUUBUUUBUBBUUBUUUUBBBBUBBUBUBUUB
BUBUBUUUUBUBUUUBBUUUBUUUBUBUUBBUBBUUBBUUUUBUBBUUUUUUUUUBUUBUBBUUBBBUUBUUBUUUUUBUBUBBBUUUBBUUUBUBUUUBU
UUUUUUBUBUUUBUUBUBUBUUUUUUUUUBUUUUUUUBUUUBUBUUUBUUUUUUUUBBUBUUUUBBUUUUBUUBUUBUUUUBUBUUBBBUUBUUUUUBBUU
UBBBBUBUBUUUUUUUUBUUUUUUBUBBBBUUUUUBBUUUBUBUUUUBUUUUUUBUBBBUUUUBUUBBBUUUUUBBUUUUUUBBBBUUBBUUUUUUUBUUU
UUUBUUUUUUUBUUUUBBBBUUUUUBBUUUUUUBUUUUUUUUUBUUUBUBUUUUBBUUUUUUBUUBUBUUUUUUUBUUUBUUUUBUUBUUUUUBBUUUUBU
UBUUBUUBBBBUBUUUUBUUUUBBBUUUBUUUUUUUBUUUUUUUUBUBUUBUUBUBUBBUUUUBUUUUBUUBUBUBUUUUBUUUUUBBUUUUUBBBUUUBB
UUUUUUUUUUUUUBUUBUBBUBUUUUUBBUBUUBUUUUUBUUUBUUBBBUUUUUUUUBUBUBUBBUUUUUUUUUUUUBUBUUUUBUUBBUUBUUBUBUUUB
UUUUUBBUUUUUUBUBBBUBUUUUUUBBBUUUBBUUBBBUBBUUUUUUUUUUBUUUUBUBUUBBUUBUBBBUUBUUUBUUUUUUUUUBBUBUUUUBUUUUB
UUUUBBBUUUUUUUBBUUUUUBUBUUUUUUBBUUBUUUBUUUUUUBUUBUUUBUBBUUBUUBBBBUBUUUBUUBUBUUBUUUBBUUUBBUUUUBBBUUUBB
UUUUUUBUUBBUUUUUUUUUBUBBUUUBBBBBUUUBBBUBUBUUUUUUUUBUUUBUBUBBUUUBBUUBUUUUUUUUUBBBUUBUBUUBUBBBUUUUUBBUU
BBUUUBBUBUBUUUUBUUUUUUUUUBUUUUUUUUBBUUUUBUUUUUUUBUUUBUUUBUUUUUUUUUUBBUUUUBUUUBUBUBUUUUUBBUUUUBBBUUUUU
BUUBUBUUUUBUUUUUUBUUUUUUUBBUUUUUUUBBUUUUBUBBBBBUUBUBUBBUUBUUUUUBUUUUUBBBBUBUUUUUBUUBBUUBUBUUUUUBUUUBU
UUUUUUBUUUBUBUBUBUUUUBBUUBUUBUUUUBUUBUUBUBUUUUUUUUUUUUBUUUUUUBBUUUUUUBBUUUBUUUUUUBUBUBUUUUUBUUBUBBUUU
UUBBBUUBBUUUUUBUUBUUBUUUUBBBUUUUBUUUBUUUUUUBUUUUUUUUBBUBUBBUBUUBUBUUUUBUUUUUBBUUBUBUBUUBBUBUUUUUBUUBB
BUUUUUUBBBBBUBUUBBUUBUBUUUBUBBUUBBUUUUBBBUUBUBUUBBUUBBUBBUUBBUUUUBBUUBBUBUBUUUBBBUBUBBUUUUUUUUUUBUUUU
UBUUUUUUUUUUBUUUUUUUUUUUBUUUBUUUBUUUUUBBUUBBUUBUUBUUBUUUUUUUBUUBBBUBUBUBBUUUUBBUBBUUUBUUUUUUBUUUUUUUU
UBUBUUUUBUBUUUUUUBUUUUUBUBUUBUBUUUUUUUBUUBBUBBUUUUUUUUUUBUUUUBUBUUBUBBBUUBUUBUUUUUUUBBUUUUUUUUUUUBUUU
BUUBUBBUUBUUBUUUBBUUBUBUUUUUUUUUUUUUBBUBUUBUUBUUBUUBUBUUUUBUBUBUUBUUUUUUUUUUUUUBBUUUUBUBBBUUUUUUBBUUU
UUUUBBBUUUBUBUUUUBBUBUUUUUBUUBUBUUUUUUBUUUBBUUUUBBUUUUUUUUUBUUUBUBUUBUUUBUBUUUBUUUUUUUUBUUUBUUUBUUUUU
UBUUBBBUBUUUBUBUBUUUUUUUUUBUUBUBBUUUUUUUUBBUBUUUUUUUUUUBUUUBUBUBUUBBBUUUBBBBUBUBUUUBBUUUUBUUUUUBUBUUB
BUBUUBBBBBUUUUUBUUBUUUBBUUBBUUUUUUUUUBUUUUUUUUBUBUUBBBUUUBUUBUBUUUUUUBUUBBUUUUUUUUUUUBBUUUBUUUBBUUUUU
UUUUUUBUUUUUUUUBUUUUBUBUUUUUUUUUUUUUBUUUUBUBUUBUUBUBBBUUBBUUUBUUUUUUBUBBBBUUBBUUUUUUUUUBUUUUUUBUUBBUB
UUBUUBUBBUBUBBUBBBUUUUBUBBBUUUUBUUUBUUUBUUBUBBUBUUUUUBUBBUBBUUBUUUUBUUUUUBBUUUUBUUBUUUBUBBUUUBUUUUBUU
BUBUUUUBBUBUUUUUBUUUUBUUUBUUUUUBBBBUBBUUUUUUUUUUBBUUUUBUUUBUUUUBBUUUUUBUUUUUUBBUBUBUUUUUUUUUBBBBUUUUU
BUUBUUUUBUUUBUUUBUBUUBBBBUBUBUUUBBUBUBUUBUUUBUBBUBUUUUUBUBUUUUUUUUUBUUUBUUUUUBBBUBBUBBBBUUUUUUBBBUUBU
UUUBBUUUBUUUUBUUUUUUBBUBUUUUUUUBBUUUBUUUUUUUUBBBBUUUUUUUUUBUUUUUUUBBUBUUUBBBUUUUUUUUBUBBUUBUUUUUUBBUU
UBUUBUBBUUUUBUUUBUUBUUUBUUBBUUUUUUUUBBUUUBUUUUUUBUBUUBBUUUUBUUUUBUBUUUUUUUBUUBUUBUUUUBBUUUBBUUUUUUUBU
UUUUBUBBUUUBUUBBUBUBUBUBBUUBBUUUUBUUUUBUUBUUUUBUUUBUUBUBBUUUUUBUBBUUUUBUUUUUUUUUUUUBUUUUUUUUUUUBUBBUU
UUUUBUBUUUUUBUUUUUUUUBUBUUUUUUUUBUBUUBUUUUUUUBUUBUUUUUBUUBUUBBUUUUBUUUUUUBBBBUUUBUUUUUUUUBUUUBUUUUBUB
BUUUUUUUUUBUUUBBUUUBUBUBBUUUUUUBUUBBBUUUUUUUUBBUUUUUBUUUBBBUUBUBBUBUUUBBBUUBBBUUUBBBUUBBUUUUUBUUUBBBU
UUUUBUUBUBUUUUUUBUBUBBUUUUUBUUUBBUBBBUUBUUBBUUBBUUUBUBUUBUBUUBBBUUUUBUUUBUUBUUUUBUUUUUBBUUUBUUUBBUBBU
BUUUBUUUBUBUUBUUBUUUBUUUUBBUUUBUUUUBUBUUBUUBUBUUUUUUBBBBUUUUUUUBUBUUUBUUBBUBUUUUUBUUUUUUUUUBUUUUUBUUU
BBUUBUUBUUUBUUUBUBUBUBUUUUUBUUBUUUUBUBBUBBUUUUBBUUUUUBUUUUUUUBUUUUBUBBUUBUBUUUUUUUUUBUUBUBUUBUUUUUBUU
BBBUUUBBUUUBUUUUUUUBUUUUBUUUUUUUBUUUUUBBBUUUUBUBUUUBUUUUBUBUUBBUUUUUUUBUUUUUBBUUUBBUBUUUUUUUUUUUUUUUU
UBBBUUBUUUUUBUBUUBBBUBUUUUUUUUUBUUUUUUUUBUUBUBUBBUUUBBUUUUUUBBUBBUUBUUUBUBUUUUBUUBUBBUUUUUBBUUUBUBUUB
BUUBUUUUUBBUBBUBUBUUBBUUBUBBUBUBUUUUBUBBUUBUUUUUBUBUBUUUUUBBUUBUBUBUUUUUUUBBBBUBUUBUUUUUUUUUUBBUUUUUU
BUBBUUUUBUBUBUBUUUUUUUBUUBBUBBUUUUUUUBUUBBUBBBBBUUUBUUUUUBBUUUUUUBUUUUBUBUUUUBBUBUUUUUBUUUUBUUBBUUUBU
