UBBUUUUUBBUUUUUUBUBUBBUBBUUBBUBBUUBBUUUBBUUUUBUUBBBUUBUBUUUUUUUUUUUUBBUUUUUUUUUBUBUBUUUUBUUBUBBBUUUBB
UBBBBBBUUUBUBBUBUBUUUUBUUUUUUBUUBUUBUUUUUUBUUUUUUUUUUUUUUUUUBUBUBUUUUBUBUBUUUBUBUBUUUBBBUUUBBUBUUUUBU
UUUBUBUUUBUBUUBUBUUUUBUUBUUUUUUUUUBUBUUUBUUUBUBUUUUUUUUUBUBUUUBUUUUUUBUUUUBUUBUUUUUUUUUUUUUBUBUUBUUBB
UUUUUBUUUUBBUBUBUBUUBBUUUUUUUUUUUUUBBUBBUBBBUUUUUUUUBBUUBUBUUUUUUBUUBUUUBBUUUBBUBUUUUUBUBBUBBUUBUUUUU
UUUUUBUUUUUBBBUUUUUUUUUUUBUBUUUBUUBBUUBUUUUBUBUUBUUUBBUBBUUUUUBUUUUUUBBBUUBBBBUUUUUUUUUUUUUUUBUUBUUUU
UUUUUBBUUUUUUUUBUBUUUUBUUUUUUUBUBUUUUBBUUUUUBUBUUUUUUUUUUUBUUUUUUUBBUBBUUUUBUUUBUUUBUUBUUBUUBBUUBBBBU
UUBUUBBUUBBUBUBUUUUUBUUBBUUBUUUUUUUBBBBUUBBBBUUUUBUUUUUUBUUUUUUBUUBBUUUUUBUBBUBBUUUUBUBUUUUUBUUUBUUUU
UBBBUBUUUUUBBBBUBBUBBUUUUUBBBBBUUBUBBUBUUUUBUUUBUBBBUUUUUBUUUBUUUBUBBUUBUUUUUUUBUUUUUBUBUUUUUUUUUBUUB
UUBUUUUBUUUBUUUUUUUUUBBBUUUUBBBBBUUBBUUUUBUBUBUBUUUUUBUBBUUUBUBUUUUUUUUUUUUUBUUBBBUBUBUUBUBUUBUUUUUBU
BUUUUUBUUUBBUUUUBUUUUUBUUBBUUUBUUUBUBUUUBBBUUUUUUUUUUBBBUUBUUBUUBUBBUBBUUBUUUUBBUUBUBBBUUBBUUUUUUUUUB
UBUBUBBUBUUUBUUUUUUUUUUUUUUBUBUBUBUUUBUBUUUUUBUUUUUUUUBUUUUUBUUUBUUBBUBUBBUUBUBUUUUUUBBUUBBBUUUUUBUBU
BUUBUBUBBUUUUUUUUUUBUBUUUUUUUUUBUUUUUBUUBUUUBBUUUUUUBUUBUUUUBUBUUUUUUBBUUBUBUUUBUUBUUUUBUUUUUUUUUUUUB
UUUUUBUUBUBUBBBUUBUUUUUUBUUBUUUBUBUUUUUUUBUUBUUBUUBUUUUBBUUUUUUUUUUUUBUUUUUBBUUUUUUUUBUBUUUUBUUUUBUBU
BUUUUBUUBBUUUUUUBBUUUUBUUUBUUBUUUBUUUUBUUBBBUUBUUUUBBUUBUBUBBUBUUBUUUUUUUUBUBUBUUUBUUUUBBUUUUUUUUUUUU
BUBUBBUBBUBUUUBUUUUUBUUBUBBUUUUUUBUUUUUUUUBUBUUUUBUBBBUBUUUBUUUBUBUUUUUUUBUBUBBUBBBUUBUUUUUBUUUUBBBBB
BBUUUBUUUUUUUUUBBUBUUBUUUUBUBBBUBUUUBUBUUUBUBUUUUBUBUBBUBUBUUUUUUUUUUUUUBUUBBUUBBUUBUBUUBUUUUBUUUBBBU
UUUBUBUUBBBBBBBUUUUUUBBUUUBUUUUBUBBUUUBUUUUUUUUUUUBUUBUUUUBUBBUBUUUUUBUBBUUUUUBBUBUUBBUBUUUBBUUUUBUUU
UUUBUUUUUUUUUUBBUUBUUUUUUUUUBBBUUUUUUUUBUUUBUUUUBUUUUUUUUUBUUUBUBUUUBBBUBBUUBBUBUUBUBUUUUUUUUUBUBBUUU
UUBUUUUBBUBUBBBUUBUUUBUBBBBUUUUBUBBUBBUBUUBUUUUUUUBUUUUUUUUUUUUBBBBUUBBUUBUUUUUUUUUUUUBBUUBBUBBBBUUUU
UUUBUUUBBUBUUUUBUBUUUUBBBUUUBUUUUUBUBUUBUUUUUBUUUUBUBUUUUUBUUUUUUUBUUUBUBBUUUBUUUBUUUBBUUUUUUUUUUUUUB
UUUBUUBUUUUBBBUBUBBUUBUUBUUUUBUUUUUUUUBUUBUBBUBUUUUUBBBUUBUBUUUUUUUUBBUBUBUUBUUUBBUUBUUBUUUBUUBBBUUBB
UUUBUUUUUBUUUBUUBUUUUUUUBUUUUUUUUUUUBBBBUBUBUUUUBUUUBBUUBUUBUUBUUBBUBBUBUUUBBUUUBUUUUUUBUBBUBUUBUUUBU
UUUBUUUBUUBBUUBBUUUUUUUUUUUUUUUBUUUBUUUUBUUUUBUBBBUUUUUBBBBUUUBBUUBUBUUBUUUUBBUUUUUUBUUBBUUUBUUUBUUBB
BUUBUUUUBUUBUUBBUUUUBUUUUUBUUUUBUBUUBUBUUUUUUUUBBUUUUUUUUUUUUBBUUUUUBUUBBUUUBBUUBUUUUUUUUBUBUUUUUBBBU
UUBUUUUBUBUUUUUBUUUUBBUBUBUUBUBBUBUBUUBUBUUUUUBUUUUUUUUUUUBUBUUUBUBBUUUUUBUUBUUBUUBBUUBUUUUUUBUUBUUBU
UBUBBUUUBBBBUBUBBBUUUUUUBUBUUUUUUBUUUBUUBUUUBBUUUBUBUUUUUBUBUUBUBBUBUUUUUUUUBUUUUUBUUBUUUBUUUUBUUUBUU
BUUBUUUUBUUUUUBUUUUUUBBUBUUUUUBUBUUBUUUUUUUUBUUUUUUUBBBUUUUUUUBUUBBUUUUUUBBUUUUBBUUUUUUUUUBUUUBUUUUUU
BUUUUBBUUUUBUUBUUUBBUUUUUUBBUUUUBBUBUBUBUUUUBBUUUUUUUBUBUUUBBUUBUBBBBBUBBUUUUUUUUUUBBUUUUUUUUUUUUUUBB
BBUUUUUUUUBBUUUUBUUBUUBBUBUUBUUUUUUUBBUUBUUUUUUUBUBUBUBUUBBBBUBBUUUUUUBBUUBUUBBUUUUUUUUUBUUUBBUBUUUBB
UUUUBUBUUUUUUUBUUUUBUBBUUUUUUUUBBUBBUBBUBUUUUBUBUUBBBUBBUBBUUUUUBUBBUBBBUUBUUBUUBBBBBUBUUBBBUUUUUUUUU
BUUUBBBBUBBUUUUBUUUBBUUUUUBUBUBUUBUBUUUUUUBBUUUBUUUUUUBUUUUUUUUUUUUBUUUBUUBUBUUUBBUUUUUUUUUUUUBUUUUUB
UUBBUUUUUUUUUBBUUUUUUBBBBUUUUUUUUBBBBUUBUUBBUUBUBUBUUBBBUUUUBUBBUUBBUUUUUBBUUUUUUUBUBUBUUBBBBUBUUUUBU
UBUBUUBUBUUBUUBUUUUBBUBUUUUUUUUUUUUUUUUUUBUUUUBUUUUUBUUBUUUUBUBUUUUUBBUUBUUBUUUUUBUBUBUUUBUUUUBUBUBUU
BUUBUBUUBBUUBUUUUUBUUUUBBUUUBUUUUUUBUUUUUUUUUUBUUUUUBUUBUUUUUBUUUUUUUUBUBUUBUUUUUBUUUUUBUBBUUUUUUUUBB
BBUUBUUUBUUBUUUUBUUBUUBUBUBUUUUUUUBBBUUBBUUBUUBBBBBBUBBUBUBUUUUUUUUBUBUUBBUUUBBBBUBUUUUBUUUBUUUBUBUBB
UUUUUBBBUBUUUUUUUUUBBUUUUUUUUBUUUUUUUUUUUUUUUUUUUBUBBUUUUUBUUBBUUUUUUUBUUUUUUUBBUUBUUUUBUUUBUUUBUBBBU
UUBUUBUUBUBUUUBUUUBBUUBUUBUUUBUUBBBUBBBUUUUBUUBBBBBUBUUUUUBUUUUUUUBUUUUUBBUUUBUBUBUUUBUBBBUUUUUUBUUUB
BUUUBUUBUUUUBBUUBUUUUUUBUUBUUUUBBBBUUUBUUUBUUBUBBBUUUUUBUBBUUBUBUUUUUBUBBBBBBUUUBBBUBUUUUBUBUUUUUUUUU
UUUBUUUUUUBUBUUUUUUBBUUUUUBUUBUUUUUUUUUUUBUUBUBUUUUUUBUUUUUBBUUUUBUUBUUUUBUBBUUBUUBBUUUUUBUUBBUUUUUUU
UBUUUUUUUUUUBBBUUBUUUBUUUBUUBBUUBUUUUUBUUUUUUUUUUUUUUBBUUUUBUBUBUUBUUUUBUUUBUUUBUUUUBUUUUUUBBUBBBUUBU
UUBUUUUBBUBUUUUUUUUUUUUUUUUBUUUUUUBBUBBUUUUUUBUUUUUBUUUUUUUUUBUUUUUUUUUUUUBUBBUUBUUUUBUBUUUBBUUUUBUUU
BBUUUUUUUUUBUUBUBBUUBUUBUBUUUBUUBUBUUUUUBBBBUBUUBUUUUUUUUBBUUBUUUBBUBBUUUUUUBBUUUUUUBBUUUBBUUUUBUUBUU
BUBUUUUBBBBUBUBUUUUUUUBBBBUUUUUUUUBUBUBUUUUUBUBUBUUBUBBUBBBUBUUBUUBUUBBUUBBUUUUBBUBUUUUUBBBUUUUUBUBBU
UUUUUUUUUUUUUUUUUUUBUUBBUUUUUBUUUBUUUBUUUBUUUBUUBUBUUBUUUUUBUUUUUUBBUBUUUUBUUBUUUUUUUUUUUUUUUUBUBBBUB
UUBUUBUUUBUBUUUUBUBUUUUBUUUBUUUUUBBUUUBUUUUUBUUUUBUUBBUBUUBUUUUUBBUBUUUUUUUUBBUUUUUUUUBBBBUUUUUUBUUBB
UBUUUBUUUBUUUBUUBUUUUUUBUUBUUUUUBUBUBUBBBUBUUUUBUUUUUBUUBUBUUUUUBUUBUBUUBUUUUUBUBBUBBUBBBUBBUUBUBUUUU
UBBUUUUUUUUBBUUUUUUUUUUUBUUBUBBUUBUUBBUUBUUUUUUUUUBUUUUUUUBUUUUUUUUUUUBBBUBUBBBUBBBBUUUBBBBUUUUUUUUBU
BUUUBUBBUBBUUUUUUUUUUUBUUUUUUUBUUUUBBUUBUUUUUUUUUBBUUUBUUUUBUBUBUUUBBBBUUUBBUUUUUBUUUUUUUBUUBUUUUUUUU
BUUUBUUUBBBUUUUUBUUUUUUUUUUBBUUBUUUUUUBUBUBBBBUUUUUUUBUBUUUBBUUBBBUBUUUUUBUUUUUBUBUBUUUUUUBBUUBUUBBUU
UUUUUUUUUUBUUBUUUUUUBUUUBUUUUUUUUBUBUUBUUUBUBUUUUUUUUBUBUUUUUUUUUUUBUBUBUUUBBBUUBUUUBUUUUUUUUUUBBBBUU
UUUUUUBUUUBBUUUUUUBBBUBBBUUUUBUUUUUUUUUUUUUUUBUBUBUUUUUBUBBUUUUBBUBUUUUUUUUUBBBUUUUBUUUUUUUBUBUUUBBBB
UUUUUUUBUUUUBUUUBUUBBUUBUUUUUBBBUUUUUBBBUUBUUUUUUUBUBUUUBBUBUBUBBUUUUUUBUUBUUUUUUBUUUUUUUUUUBUUUUUBBB
BUBBUBUUUUUUUUUBUBUBBBUUUUUUUUUBUUUUUUUBUBUUBUUUBUBUBBUBBUBUUUUBUUUUUBUBUBUUUBBUBUBUUBUUBBUUBUBBBUUUU
UUBUUBUUUBUUUUUUBBBBUBUUUUBUUBBBBUBUUUBUUUBBBBUUUUUUUUBBUUUUBUUUUUBUUUBBUUUUUBUBUUUUBBBUUUUUUUUUUUUUB
UUBBBUUUUUBUUBUUUUUUUBUUBBBBBUUUUUBUUUUUUUUUUUUUUUUBUUUUBBUUUBUUUUUUUUUUBUUUUBBUBUUBUBBUUUUUBUUUBBUUU
UUUBUUBUBUUUUUUBUUBUBUUBUUUUUBBUBUUUUUUUBUUBUUUUBUUUUUBUUUBUUUBUUUUBUBUUUUUUBUBUBUUUUBUBBBUUUUUBUBUUB
BUBBUUBUUUUUUBUBBUBUBUUUUUUUUUUUUUUUUUUUUUUUBBUUUUUBUBBBUUUUUUUBBUUUBBUBUUBBBUUUUBBUUUUBUBUBUUUBUUUUU
UUUBUUBBUUUUUUUUUBUBUBUBUUUUUUBBUUUUUUUUUUUBBUUBBUUUUUUUUUBUUUUBBUBBBUBUBBUUUBUUUUBBUUUUBBUUUUBUBUBBB
UUUUUUUBUUUUUUUBUUUBBUUUBUBUBBUBUUUBUUUUBBUUUBUUUUBUBUBBBUBUUUUBUBUUUBUBUUUUUUBBBUUUUUUUBBUUUUUUUUUBU
UUUBUUUUUBBBUBBUUUUUBBUUUUUUUUUBUBBBUUUUUUBUUUUBBUUUBUUUUUUUUUUUUUUBUBUUUUUUBBUUBBUUUUUBUUBBUUBBUUUBB
BUUUBBUUUBUUUUUUUUUUBUUUUUUBUUUUUUBUUUBUBUUUUBBBUUBUUUUUUUUUUUUBUBUUUUUBUUUUUUUBUUUUUUBUUUUBUUBUUUUUB
UBBUUUUUUUUUBBUBUUUBBUUUUBUUBUBBUBUUUUBUUUUBUBUBBUBBUBUUUUUBUBUBUBUUUUUBBUBUUUUBBUUUUUUBBUBUUUUUBBUBU
UUUBUUUUUUUUUUUBUUUBBUBUUBUBBBUBUUBUUBUUBUUBBUUBUUBUBBBBUUBUUBBUUBUBUUUUUUUUBUBUUBUBUBUBUBUUUUUUUUUUU
UUUBUUUBBBUUUBUUBBUBUUBUUUBUBUBUBUBUUUBUUUBUUBBUUUUUUUUBUUUBBBUUUBBUBBUBBUBUUUUUUUUUUUUUUUUUBBBUUUUUU
UUBUBBUBBBUUUUUBUBBBUUUUUUUUBUUBUUUUUUUUUBUUUBBUBUUBUBUBUUBUUUBUBUUUUUUUBBBUUUBUUBUBUBBUUBUUUUUBUBUUU
UUUUUUBBUUBUUUBBUUUUUUUUUUUUUBUBUUUUBUBUUUUUUUBUBUUUUUBUUBUBBUUUUBUUUUBUUUBUUUUBUUBBBBUUUUUUUUUBUUUUU
UBBBUUBUBUBUUUBUUBUUBBBUUUUUBUUBUBBBUUBUBUBUUUUBUUBUUUUBUUBBUBUUUUUBBBUBUBUUBUBBUBBUUUUUUBBBUUUUUBUBU
UUBBBBUUUUUUUBUUUBUUBUBUUUUUBBBBUBUUUUUUUUBUUUUUUUBUUUUUUBUUUUBBUUUUUUUUBUBUUUUUBUBUUBBBUUUUUUUUUUUUU
BBUUUUUUUUUUUUBUUUBUUUUBBBUUUBUBUUUUBUUBBUUBBUUUUUBUBBUUUBUUUBBUUUUUUBBUUUBUUBBUUUBUUUBUUUUUUUUUUUBUU
BUUUUUUUUUBBUUBUBUUUUUUUBUUUUUUUUUBUUUUUUUUUUBUUUBUBUBUUUUUBUUBUBUUUUUUUUUUUUBBUUBUBUBUUUUUUUBBBUUUUU
UBBUBUBBBUUUUUUBUUUUUBUUUBUUUBUUUUUUBUUUBUBUBUUBUUUUUUUUUUUBBBBUBUUBUUUUUUUUBUUUUBBUBUBUBUUUUBUUBUUBU
UBBBUUBBBBUBUUUBBUUBUUUUUBUBUUBBUUBUBUUUUBUUBBBUUUUUUUBUBBBBUUBUUBUUBUBBBUUUBBBBUUUUUBBBUUUUUBBUBBUUB
UUUUUBUUUUUUUUUUUUUBUUBBUUUUUBBBUBUUUUUUUUUUUBBUUUUBUUUUUBUUBUBBUUUUBUUUUBUUUUUBUUBBBUUBUUUUUBUBUUUUU
BUUUBUUBUUUBBBUUBUUBUUUBUUUBUBBUUUUUUUUBUUUUBUUUUUBUUBUBUUBUBUBUBUBUUUUUUBUBUUBUUUUBUBUUUUUUBUUUUUUUU
UUBBUBUUUUUBUUUUBUUBBUUUUUUUBUUBUBUUUUBUBUUBUBBBUUBUUUBUUUUUBBUUBUUUBUUUBUUUUBUBUUUUUUBUUUUUUBUUBUUUU
UBUUBUUUBUBUUUUUUUBUUUBUUUUUUBUUUBBBUBUUUUUUBUUUBUUUUBBBUUUUUUUUUBUUUUUUBUBUUUUUBUUUBUUUBUUBUBUUUBUBU
UUUUUUUUBUUUBBUBUUUUUUUBBUUUUUUBUUUBUUBUBUUUBUUBUBBUUUBUUUBUUUUUBBUUBBBBBUUUBBUBUBUUUUBUBUBBUBUUUUUUU
BUBBUUBUUBBUUUUUBUUUBBUBBUUBUUUBUUUUUUUBUBUUBBBUBUUUUBUBUUUUUUBUUUUBBBUUUUUUUUUBUUUUUUUBBBUUUUBUUUUUU
UUUBBUUUUBUUBUUUUBUUUUUUUBUUUUBUBBUUBUUUUBUUUUUBUUUUUBUBBUUUUUBUUBUBBBUUUUBBBUBUBBBBUUUUUUUUUBUUUBUUU
UUUBBBUUUUBUUUBBBUBUUUUUBUUUUUUUUBUUUUUUBUBUUUUUBUUBBUBUUUBUUUBUUBUBUUBUUUBUBBUUUUUUUUUBBBUUUBUUUBUBB
BBUUUUBUUUBUUBUUUUUUUUUBUBUUUBUUUUUBUUUBBBUUUBUBUUUUUBUUBBUBUUUUBBBBUBUBUUUUUUUUBUUBUBUUUUBUBUBBBUUUU
BBUUUBUUUUUUBUUUBUUUUBBUBUUUUUBUUBUUUUBUBUUUBUUUBUBUUBBUBUUUUUBUUUUUBUUBUBUBUUBUUUUBUUUUUUBUUUUUUBUBU
UUUBBBUUBUUUBUBUUUBUUBUBUUBUUUUUUBUUUUBUUUBBUUUUUBUUUBBUUBUBUBBUBBUBUBBUBUUUBUUUBBUUBBBUUUUUBUBUBUUBU
UUUBUBUUUUUUUUUUUUUUUUUUUBBUBUUUBBBBUUUBUUBUUUUUUUBUBBUUUUBBUBBUUUUUBUUBUUUBUUUBUUUUUUBUUUBUUUUUUUBUB
UBBUUUBUUUBUUBUUUUUUUBBBBUBUUBBBUUUUUUUUUUBUUUUUUBUUUBUBBBUUUUUUUUBUUUBBUUBBUUUUUUUBUUBUUUUUBUUUUUUUU
BUUBBBBBUUUUUUUUUUUUUBUUBBUUBUUUUUUUBUBBUBUUUUBBBBBBBBBUUUUUBUBBBUUBUUUUUUUUUUBBUUUUUUUBUUBBUUUUUUBBU
UBBUBUBUUUBUUUBUUBBUBUUUBUUUUUUUBUBBBUBUBUUUUBUBUBBUUUUBUUUBBUUUUUUUUUUUUBUBUUBUUBUUUBUUBUUBUUUBUBBUU
UUBUUUUUUUBUBUBUUUUBBBBUUUBUUUUBUBUUBBUUBUUBUBUUUBUBBBBUBUUBUUUUUBBUUUUUUBUUUBBUUBUBUUUUUUBBUUUUUUUBU
BBUUUUUUUUUBUUBUUUBUBBUUUBUBBUUBUUBUBUUUBUUUUUUUUUBUUUUUUBBUUBUUBUUUUUUUBBBBUBUUBBBUBBBUUUUUBUBUBBUUU
UUBUUBUUBUUUBBUUUUUBUUBUUUUUBUUBUUUUUUBUUUUUBUUUUUBUBUBUBBUBUBUBUBUUUBUUUBBUUUUBUUUUUUUBBUUBBUUUUUBUU
UBUUBUUUBUBUUBUBUUUUBUBBUBUBUUBUUUUUUUUUUBUUUUUUUUBUUUUUUUUBUBBUUUUUBUBUUUBUBUBUUBBUUUUUUUUBUUUBUUUBB
BUUUUBBUUBUUBBBUUUBUUBUBUBUBUBUBUBUUUUUUUUUUUUUUUBUUBBUUUBUUUUUUUUBUBUUBUUUBUBUBUUUUUBBUUUUUUBUUUBBUU
UUBUUBUBUBUBBUBUUBUUUUUBUUUUUUUBUUUUUBUBUUUUUUUUUBUBBBUBUUUUBBBBUUUBBUUUUUUUUUUUUUUUBUUBUUUBUUBUBBUUU
UUBUUBUUBBBBUUUUBUUUUUBUUUUUUUBUBUUUBUUUBUUUUUUBBUUUBBBUUUUUUBBUUUUBUUBUUUBBUBBUUUBUUUUBUUUUBBBUUUBUU
BUUBUUBUUUUBUUUUBUBUUUUBUUUUUBBUBBBUBUUBBUUUUBBUUUUBBUUUBUUBUUBUBUUUBUUBBBBBUBUUUUUUUUUBUBUBBUBUBBUUU
UUUUBUUBUBBUUBUUBUUBBBUBBUUBUUUUUUBUUBBUUUBBUUBUUUUUUUUBUUBBUUUBBBUUUUUUBUUUBUUUUUUUBUUUUBUBUBBUBUUUB
BBUUBUUBUBUUUUBUBUBUUUBBUUUUUUBBBBUUUUUUUBBUUBUUUBBUUUBUUUUUBBUBUBUUBUUBBUUUBUUUUUBUUUBUUBUBUBUUBUUUB
BUUBBBUUUUUBUUBBUUUUBUUUUUUUUUBUBUUBBUBBUUBUBUBUUUUBUUUUUUUUBUBUUUUUBUUUBUUBUUUUUUBUUBBBUUUUBUUUUUUUB
UBUUUBUBUBUUUUBUUBUUUBBUUBBUUBUBUUUUUBBUUUUBUUBUUUBUUUBUUUUUUUUBUBBUUUBUUUBUBBUUUBUUBBBUBBUUUUUBBBUUU
UUUBUUBUUUBUUUUUUUUUUBUBUUUUUUUUUBUBBUBBUUBBBUBUUUBBBBBUUBUUUUUBBUUBUBUUBUBUUUUUUUUBBUUUUUUUUUUBBBUUU
BBBBUBBBUUUUUUUBUUUUUUBUBUBBUBUUUUUBUUUUUBBUBUUBBBUUUUUBBBUUBUUUBBBUUUBUBBBUBUUUBBUUBUUBUUBUUBUUUUUUU
