UUUUUBUBBUUUUUBUBBUUUUBBBUUUUBUBUUUUBBUUUUUUUBUBBUUUBUUBUBUBUBUUUUUBUUBUBUBUBBUBBUBUUBUUBUUUBUUUUUBUU
BUUUUUUBUUUBBBUBUBBBUBUBUBBBUBBUUBUUUUUBBUBUUUUUUBUUBUBUUUUBBUUUBUUUUUUBBUBUUUUUUBUUUUUUUUUUBUUUBUUUB
UUUUUUBUBUUUBUBUUUBUBUUUUUBUUBUUUUUUUUUUUUBBUUUUBBUUBUBBUUUBUBUUBBBUUUUUUUUUUUBUUBUUUUUBUUUUUUUBBBUUU
UUBUUUBUUBUUBUUUBUUBBUUUUUUBUUBUBUUBBBUUBUUUUBUUUUUUUUUBUUBUBUUUUUUBBUBUUBUUBUUUBUUUUUUUUUUUUUUBUUUUU
UUUUBUUUUBUUUUUUUUUUBUBUUUUUBBBUUBUUBUBUUBUBBBUUUUUBUBBUUUUUBBUUUUUUBUUBUUUBUUBUUUUUUBBUBUUUBUUUUBUUU
UUBUUBUBBUUUUUUUBBBUUUBUUUBUUUBBUUBBBBUUBUUUUUBBUUBUUBUUUUUUUUUBUUBUUUUUBBUUUUUUUUUBUUBUUUBUUUUBUUUBU
UBUUUUUBUBUUUBBUUUUUUBUUUUUBBUUBBUUUBUUBUUBUBUUUUUBUBUUBUUUUBUUUUBUUUUUBUUBBUUBBBUBBBBUBUUUUBUUBUBUBU
UUBUUUUBBBUUUBUBUUUUUUUUUUUUBUBBUUUBUUUBUUBUBUUUBUBUUUBBUBUUUBUBUUBUUUUBBUUBBBUUUUUUUUBUUUBUUUUUBUUUU
BBUBUBUUBUBUBUUBUUBBBBUBUUBBUBUBBUUBUUUUUUUUBUUUBUUUUUUBUUBUUUUBBUBUUUUUUBUUUUUUBUBBUUBUUUBUBBUUBBUBB
UUBUBUUUUUUUUBUBBBUUUUUUBUBUUUUUBUBBUBUBUBUBBBUBBUUUBUUUBUUBBUUBUUUBUUUBUUUUBUUBUBBUUUUUBUUBUBUUUUUBU
UUUUUUUUUBBUUBUUUUUBBUBUUUBUUBUBUUBUUUUBUUUBUUBUBUBUUUUUUUBUUUUBUUBBBUUUBBUBUBUUBBBUUBUUBUBBUUUBUUUUU
UUUUBBUBUUUUBUBBBUBUUUBUUBBUBUUBBUUUBUUBUUUUBUUUBBUUUUBUUBUUUUUUUUUUUUUBUUUUBUUUBUUUUUBUUUUUUUUBBUBUB
UBUBUUBUUUUUBBUUBUUUBUUUUUUBUUUUUBBBBUUUUBUBUUBUUBUBUBUBUBUBUBBUUUUUBUUUBBUBBBUUUUUUUUBBUUUUUBUUUUUUU
BBUBUUBUBUBUUUUUBBBBBBUUUUBUUBUBUUBUUBUUUBBUUUUBBBUUBBBBUUUBBUUUUUUUUUBBUUBBUUBUUBUUUUUUUUUBUBBUUUUUU
UUUBBUUUUUUUUBUUUBBUUUUBUBUUBUBUUUUBBUUUUUBUBUUUUUUBUUUUUUBUBUUUUUBUBUUUBUBUUUUUBBBBUUUUUBUUBBUUUBUUU
UUUUUBUUUUBUUUUBUUUUUUBUUUBUBUBUUUUUUUUUUUUUBUUUUBUUBBUUUUUBUUUBBUUBBBUUUUBUUUUUUBBUUUUUUUUUUBBUUBUUU
UUBBUBUUUBUBUUUUUUUUUBUUUUBBBUUUUBUBBBBBUUUUBBBUUBUUUBUBUUUUBBUBUUUBBUUUUUUUBUUUUBUBUUUUUUUBUBUUUUBBU
UUBUBBBUUUUUUBUUUUUBUBUUBBUUUUUUUBUUUUUBUUUUUUUUUUUUBUUUUBBUUUUUUUUBBBUUUUUUUUUUUUBBUBUBUUUUUUUBUUBBU
BBUBUBUUUUBBBUBUBUBUUUUUUUUUBBBUBBBUUUBUUBUUUBBUUUBBUBUUUBUBUUUUUBBUBUUBBUUUUUUUUUUBUUUUUUUBUUBBUUUUU
UUUBUBBUUUBUUUUBUUUUUBBBUUUUUUUBUBUBUUUUBUBBUUUUUUBUBBUUUBUUUUBUUUUUUUUBUUUBUBUUUUUUUUUBUUBUBUBBUUBUB
UUUUUUBBUUUUUUUUUUUUUBUUBBBBUUBUBUBUBBBUUUBUUBUUUUUBUUBBBUUUUUUUUBUUBBUUUUUUBBUUUUBUUUUUUUUBBUUBBBBUU
UUUUUUBUBUBBUUUBUBUUBUBUUUUUUUUUUUBUUUUBBUUBUUUUUUUUBUUUUUBBBBUBBBUBUBUBBBUBUUBBBBUUUBUUUUUBUUUBUUBUU
UUUUUUUUUUUUBUUUUBBUBUBUUUUBBUBBBBBUUUUBUUUUBUUBUUBUBUUUBUUBUUUBUBUUBUBUUUUUUUUUUUUUUUUBBUBBBUUUBBBUB
UUUBBBUBUUUUBUUUUUUBUUBBUUUUUUUUBUBBUBBBBUUBUUUBUBUUBUBUUBBUBUUUUUUUUUBUUUBBUBBUUUBBUUBUUUUBUBUUUBUUB
UBUUUUUUUUUUUBUUUUUBUUUUUBUBUUBUUUBUBUUUUUUUUUUUBBUUUUUUUUBUUUBUBBBUBUUUBBUUUBBUBBUUUUUUUUUBUUUUBUUBU
UUUBUUUUBBUUUUUUUUUBUBUUUUUUUUUUBUUBUUUBBUBBUUUUUBUUUUUUUUBBUUUUUUUUUBUUUBBUUUBUUUUUBUUUUUUUUUUUUBUUU
UUUUUUUUUUUUUUBBUUUUUUUUUUBUUUBUUUBUBUBUUBUUBUUUUBUBBUUBBUUUBBBUBUBBUUUBBBUBBUUUBBUBBUUUBUBUUUBUUUUUU
UBBUUUBUBUUBUBUBUUUUUUBUUUBBUBUUUUBBUBUUUUUUUUUUUUUUBUBUUUUUBUBUBBBBBBUUBBUBUBUUUUUBBBUUUUUBBUUBUUUUU
UBUBUUUUUUUUUBBBUUUUUUBUUUUUBUBUBUUUUUBBBUUBBUBUUBUUUBUUUUUUUUUUBUUUUBBUUUBUUBUBUUUUUBUBUUUUUUUUUUUUU
UUBUUUUBUUUUUUUUUBBUUUBUUUUUBUBUBBUBUUBUUBBUUUBUBUUUUUUUBUBUUUUUUUUBUUUUUBUBBBUUUBBUUUBUBBBBUUUUBUBBU
BUUUBUUBUUBUUBUBUUUUUUBUUUUBUUUUUUBUUUUUUUUUBUUUUUUUBBBBUUBUUUUUBBUUBUBUBUBBUBUUUUUBUBUUUUUBUBUBUUBUU
UUUUBUBBBUUBUUUUUBUUUUUUUBUBUUUBBUUUBBUUBBUBUBUUUBUUBBBUBBUBBUBUUBUBUBUBUUBUUBUUUUUUUUUUBBBBUUUUUBUBB
BUBUBUBBUUBBUUBUBUUUUBUUUUUUUUBUBUUUUUBBBBUUUUUUUBBUUUBUUUBUUUUUBUBUUBBUUBUUUBUBUUUUUUUBUBBUUUUUBUUUU
BBBBBUUUUUUUUBUUUBUUUUUUUUUUUBBUUUUUUUUUUUUBBUUUBUBUUUBUUUUBUUUUUUUUUUBBUUBBUUUUUUBUBBUBBUBBUUBBUBBUU
UUBUUUUBBUBUBUUUBBBUUBBBUUUUBBUUUBUUUUBUUBUUUUUUUUBUBBBUUUUBUUBUUBBUUUBBUUUUUBUUUBUBBBBBUUUBUUBUBBUBB
BBBUUUUUBBUBUUBBUUBUUUUBUUUUUUUUUBUUUUBBUUUUBBUUUUBUBUUUUUUUUUUUBBUBUUBBBUBBBBBUUUUUUUBUUUUUUUUUUBBUU
UUUUUUUBUUUUUUUUUBUUBUUUUUUBUBBUUUUUBBBUUBUUBUUUBUUUUBUUUBUUUUUUUUUUBUUUUBUUUUUUBUUBUBBUUBUBUUUBBBBBB
BUUBUUUUBUUBBUBBUUUBUUBUUUBUUUUUBUBBBBUBBBUUBUBUUBUBBBUUUUUUBUUUUUBUBUUUUUBUBUUUUBBUBBBUUBBUUBUUUUBUB
UBUUUBBUUUUUUUUUBUBUUBUUUUUUUBBUBUUUBUUBUUUUUUUUUUBUUUUUBUUUBUUUUUBUBBUUUBBBUUUBUBBBBUUUBUBUBUBBUUUBB
UBUBUUBBUBUUUBUUUUBUBBUUBUUBBUBUUBUUUUBBUUUUUUBUBUUUBUUUUUUUBUBUUUUBBBUUUUUUBUUUUUUUBBUUUUUUBUUBUUUUB
BUUUUBUBUUUUUBUUUBUUUUUUUBUUUUBUUUUBUUUUUBUBUUBBUBUUBUUUBUBUBUUUBUBBUBUBUUUUUBUBUUUUUUUBUUBUBUUBUUBUB
UBUBBBUUBBBUUUUBBBBUUUUUBUUUUUUUUUUBBUBUBUUUBUUUUUUUUBUUUBUBUUUUBUBUBUBUBUUBUUUBBUBUUBUUBBBUBBUBBBUBU
UBUUBBUUUUBBUUUUUBUUUUUBUUBUUBUUUBUUUUUUUUBUUUUUBUUUUUUUUUUUUBBUBBBUUUBBUUBBUUUUBBUUUUUUUBUBUUUUBUUBB
UUUUUUUUUUBBBUBBBUBBUUUUBUUBUUUUUUUUUUBBBUUBUBUUBUUBUUBUUUUBUUUBBUUUBUUUBUBUUUUBUUUUUUUBBBUUUUUBBBUBB
UUUUUUBUUUBUUUUUBBUUUUUBBUUUUUUUBBBUUUUBBBUUUBUUUBUBUUUBUUBBBUUBUUBBUBUUBUUUUUUBBBUUUBUUUUUBBUUUUUBUU
BUUUUUBUBUUBBUBBUBUBUUUUUBUBBUUUBUBBUBBUUUBUUBUBUUUUUBBBUUUUUUUUUUUBUBUUBUUBUUBUBUBUBUUBUUUUUUUUBUUUB
UBUUUUUBUBUBBUUBUBUUBUBUUUUUUUBUUUUBUUUUUUUUUBUBUUBUUUUBUUBUUBUUBUBBUUUUUUUBBUUUUUUUBUBUUBBUUUUUUUUBU
BBUUUUUUUUBUUUUUUBUBUUUUUUUUBBUBUBUBUUBUUBUUUUBUUUBBUBBUUBUUUUUUUUUUUUBUUUBUUUUBBBBBBUBUUUUUUUBBUUUUU
UUUUBUUUUUUUBUUUUBUUUBBUUUBUBUBUUUUUUUUBBBUUUUUUUUUUUUUUUUBUUUUUUBUUBUBUUUUUUBBUUUBBUUUUBBBUUUUUUUUBB
UBUUBBBUBUBUBUUBUUBBUUBUUUUUBUUBBUBUBUUUUUUUUUUBUBBUUBBBUBUBUUUUUBBUBBBUUUUBUUBBUBUBBUBUUUUUUBUUUUUUB
UUBBUUUUUUBBUUUUBBBUBUUUBUBUBUUBUBUBUUUUUBUUBUBUUUUUUUUUUUBUBUUBUUUUBBBUBBUUUUUUUUUUUUBUUUUUBBUUUBUBU
BUUUUBUBBBUBUUBUBUBUUUUUUUUUUUBUUUBUUBUBUBUBBUUUUBBUUUUUUBUUUUUUBBUBBBUBBBBUUUBBUUBUUUUUBUUBUUUUBUBBB
UUUUUUUUBBBBUBBUBUUUUBUUBUUBUUUBUBUUBUUBUBBBUUUBUUUUUBBUUUBUBUUUUBUUBUBUUUUUBUUUUBUUUUUUUUUUUBUUBBUUB
UUUUUUBBUUUUBBUUUBUUUUUUUUUUUUBUBBUUUUBUUBUUUBUBUUBBBBBUBUUUUUUUUUBUUBUUBUUBBUUBUUUBBUUBUBBUBBBUBUBBU
BUBUUUBBUUBUUBUUUBUBUUUUUBUBBBUUUUUBUBUUUBUUBUUUUUUUUUUBUBBUUBUUBBUUBUBUBUBUUBUUUUUUUBBUUUUBUUBUBUBBB
BBBBBUBUUBUBUUUUBUBUBBUUUUUBBUUUUUUUUBBUBBUUUUUUUBBBUUUUBUUBUBUUUUBUBUUUUUBBUBBUBBUUUBUUUBUBUBUUUBUBU
UUUUUUBUUUBUUUUUUBBBUUBUUUBUUUUUUUUUBBUUBUUBUUBUUUUUBUUBUUBBUUBUUBUUUUBBUBUUBBUUUUBUUUUBUUBUUUBUBUUUU
UUBUUUUUBUBUUUUUUBUUBUBBUBBUBUUUBBUBBUUUBBUBUBUBBUUUBBUBBUUBUUUUUUUUBBUUBBUUUBBBUBUBUUBUUBUUUUUUBBUUU
UUUUUUUBUUUUUBUUUBBUBUBUUUUBUBBBUUBUUUUBUBUUUUBBBUUUUUUUUUBUUUBUUUBBUUBUBUUUUUUBUBUUBBBUUBUBBBUUUUBUB
BUBUUUBBBUBUBBUUBUBUUBUUUUUBUUUBUUUBBUBBUUUUUUUBBUUUUUUBBBBBBUUBBUUBBBBUBUBBUUUUUUUBUUUBUUBUUBBUBUBBU
BUUUUUBUUUBUUBUUUUUBUUUUUBBUUUUBUUBUUUUUUBUUUUUUUUBUUUBUUUUUUBBUBBBUUBBBUUBBUUBUUUUUUUUUUBBBBUBBUUUBU
UBUUUBBBUUUUUBUBUUBUBUBUUUUUUBUUUBBUBUUUUUUUUUUUUUUUBUUBUBUUUUUUUUUUUBUUUUBUUUUUUUUBBUUBUUUUBUBUUUUBU
UUUBBUUUUBUUUUUUUUUUUBUUUUUBUUBUBUUUUBUBUBUUBUUUBBUUUBUBUUUUUUBUUBBUUUUUUUBBUUBUUUUUUUBUUUBUUUUUUBUUU
BBUUUUUUUBUUBUUUUUUUUUUBUUUUUBUUUBBUUBUUUBBUUUUUBUUBUBBUUUBUUUBBUBBUUUUBBUUUUUUUUBBBUUBUBUUBBUUUUUBUU
UUBBUUBBBUBBBUUUBBUUUUUBUUUBUBUUUBUUUUUBUUUBUUUUUUUUUBUUBUUUBUBUUBBUUUUUBBUUUUUBBUUBBUBBUUUBBUUUUUUUB
UUUUBBBUBUUUUUBUUBUBUUUUUUUBUBBUUUBUUUBUBUUUUBUUUUUBUUUBBBUBUUUBUUBUUUUUUUUUUUBUUUUUBUBBUBBUUUUUUBBUU
UBUUUUUUUBUUUUUUUUBBUBUUBBUBUBUUUUUUUUUUBBBUBBUBBBUUBUBBUUUUUUBUUBUUBBUUUBUUBUUBUBBBUUBUUUUBBUUUUUUBB
UUUUUBUUUBBUUUUUUUBBUBBUUUBUUUBBUUBUUBUUUBBUUUUUUBUUUBUUUUUUUUUUUUBUBUUBUUUBUUUBBUBBUUUUUUUBUBUUBBUBU
UBUUUUBBBUUBUUUBUUUUUUUUUUBBUUUBBUBUUBUBUUUUUUUUUUUUUUUUBUUUUBUUBBUBUUBUUUUBUUUUBUUBBBUUBUUBUUUUBUUUU
UUUUBUUUUUUUUBUUBUUUUUBUBUBUBUBUUUBUUBBBUBBBUBUUUUBUUBBUUUUUBBUUBUUBUBUBBUUUBBBUUUUUBUUUBUBBUBUBUBBUU
UBUUUUBUUUUUUUUUUBUUUBBUUBBBUBUUUUUUBBUUUUUUUUBUUBBBUUUUUUBUBUBUUBUUBUUUUUBBBUBUUUUUBUUUUBUBBBBBUUUBU
UUUBUBUUUBUUBUUUUUUUUUUUUUUUUUBUBUUUUUUUBBBUUUUUUUUUUBUBBUBBUBUUUUUUUUUUUUBUBUUUUUBUUUBUUUBUUBUUUBUBU
UBUUBUUUUUUUUBBUBUUUUUUUUBUUUBUUUUUUBUUUUUBBBBUBBUBUBBUBUUUUUUUUBUUBUBBBUUUUUBUUUBUBUUUUBBUBBUUUUUUBB
UBUUUUUBUUUUUUUUUUBBUBUUBUUBUUUUUUUUUBUUUUUBUBUUUUBUBUUUBUUUBUBBUUUUBUUUBUUUBBBUBUUUBUUUUUBUBUUUUBBUU
UUUUBUUUBUBUUUUUUUUUUUBUBBUUUUBUBUBUUBBUBBUUBUUBUUUUUUBBUUUBBUUUUUUBUBBBBUUUUBUBUUUUBBUUUUUBUUUUUUUBU
UUBUBUUBUUUUBUBBUUUUUUUUUUBUBUBUUUUUBUUUBUUBBUUUBUBUBUUUBUBUUUUUUUUUUUUBUBUUUUUBUUUBBBUUUBBUUUUBUUBUU
UUUUUUBBUUUUUBUUBUUBUUUUBUUUUUBBUUUBUUUUUUBUUUUUBBUBUUUUUUUUUUBUUBBBUUBUBUUUUBBUUUUUUUBUUUBUUBUUUUUUB
UBUBBBBUUBUBBUUUBUUUUUUBUUUUBBBUBUUBUUBUBUUUUBUUUUBBBBUUUUUUUUUUBUBUUUBBBUUBUBUUBUUBUUUBUUUUUUUUUUUBU
UUBUUUUBBUUUUUUBUBUUUUBUUBBBUUUUUUUUUBUBUUUUUUUUBBBBUBUUUUUUUBBUUUBBUBUUUBUUUUBUBBBUUUUUUUUUBBBUBUUUB
BUUBUUUUUBBUBUUUUUUUUBBUUBBUBUUUUUUUUUBUBBBUBUUBUUUUUUUUUUUBUUBUUUBBUUBUBBUUBBBUBUUUUUUBBUUUUUUUUBUUB
UUUUUUBBBUUUUBUUUBUUUUUBUUBUUUBUUBBUBUBUUUUUUUUBUBUUUUUBUBUUUBBBUUBUUUBUUUUUUUUUUUBUUUUUUBUUUUBUUBUUB
UUBBUBUUUUUUUBBUUBBBUUBUUUBUUUBBUUBUUBUBUUUUUBBUUUUUUUUBBBUUUBBUBBUUUUUBBBBBUUUUUUUUUBUBBUUBUUUBUUBUB
UBUUUUUUUUUUUBBUUUBUUBUBBBUUUBUBBUBUUBBUUBUUBUUUUBBUUUUUBBUUUBUUBUUUUUUUUUUUUBBBBUUUUBUUBUBUBUUUUBUUU
UUUUUBUUUUUUUBUBUUUUUUBBUBBBBUBBUUBBBUUUUUUUBBUUUBUUBUBUUBUUUBUBBUUUUBUUUUUUBBUUUUUUUUUUBUUBUUUUUBUUU
UUBUUUUUUBUUUUUUUBUUUUUBUUUBUUBUUUUUUBBUUBUUBBBUUUBBUBUUBUUBBUBUBUUUBUUUBBUUUBBUUUUUUBUBBUBBUBUUUUUBU
BBUUUUBBUUBBUUUUBUUUUBUBBBBUBUUBUUUUUUUBBUUUBUUUUUUUUUBUUUUUBBUUUUUBUBBUBUUUUUUUBUUUUUUUBUUUBBBBBUUUB
BUBBUUBBUUBBUBBUUUUUUBUUUUBUUUBUUUUUUUUUUBBBUUUUUBUUBBUUUBUBUUBBBUUUUUUUBUUBUBBBBUUUUUBUUBUUUUUBBUUUU
BBBUUUBBBUBBBBUBUUUUUUUUUBBUUBUBBUUUUUUBUBBUUUBUBBUUBUUBBUUUUBUBUUBBUUBUUUUUUUBUBBUUBUBUBUBBUBBBUUBBU
BUUUBUUUUBBUUUUUUBBUUUBBUBBUBUBUUBUBUUUUUUUUBBUUUUBUUUUUUUBBUUBBUUBUBUBBUUUBUBUUBUBUUUUUUBUUUUBBUUUUU
UUUUBUUUUBBUUUUUUUUBBBBUUUBUUUUUUUUUBBUUBUBBUUUBUUUUUBBUUBUUUUBUBUUBUUBBUUUUUUBBUUUBUUUUUUUBBBBUUUBUU
UUUBUBUUUBUUUBUUUUBUBUBUUUUUUBBBUBBUBBBUUUUUUUBUUBUUUUUBUUUUUUBUUBUUUUBUBUUUUUUUUUUBUBBBUUUBUUBUUBUUU
UUBBUUUBUUUUBUBUBBBUUUUUUUBUUUUUUUBUBBBUUUUUBUBBUBUUUUUUBBUUBUBUUUBUUBBUUUBUUUUUBBUUBUUUUUBUUUUUUUUUU
UBUUUBUBUBUUUUUBUUBBBUUBUUBUUUUUUUUBUBUBBUUUUUBUBUUUUUUUBUBUBBBBBUUUUBBUUBUBBBUBUBBUUBUBUUUUUUUUUUUUB
BUUBUBBUUUUUUUUUUUBUUUBUUUBUUBUUBUBBUUUUUUUBUBBBUUUUUUBBUBUUUUBUUUUBUUUBUBUUUUUUUBUUBUBUUBUBUUUBUBUUU
BUUUBBUUBUUUBBUBUUUUUBUBBUUUUUUBUBUBUBUUUBUUUBUUUUBUUUUUBUUUBUUUBUUUBUUBUBBUUBUUUBUBUBUUUUUUUUBBUUUUU
UUUUUUUBUUUUBUUUBBUUUUBUUUBBBBBUUBBUBBBBBUUUUUUUBUUUUBBUUUUUBBUBUUBBUBUBUUUUUBUBUUUUUUUUUUUUUUBBUUBBB
UUUBBUUBUUUUBUUUUUUUUBBUUBUBUBUBUUBUUUUUUUUBUUBBUUUBUUBUUUUUUUUUBUUUUUUUUUUBUBBUBBUUBUUBBBUUUUUUUUBBB
UBUUBUUUUUUBBBUUUUUUBUUUUUUBUUUBBUUUUUUUBUBUUBUUBBUBUUUUUUUBBBUUBBUUUUUUUUBUBBUUBUUUBUUBBUUUUUUBUUUUU
BUUBUBBUUUBUBUUBUUBBUUBUBBBUBUUUUUBUUBUUUBUUUUBUBUBBBUUUUUUUUBUUUUBUUUBUBUBUBBUUUUUBUUBUUUUUUBBBUUBUB
UUBBUUBUUBUUUUBBBBBBBUUUUUUUUUBUUUUUUUUUBUUBUUUUUUUUUUBBUBUUUBBUBUUUUUUUUBUUUBBUUBUUUUUUUUUUUUUBUBUUU
UUUUUBUUUBBUUUUUUUBUUUBBUBUUUUUBUBUBBUBBUUUUBBBBUBUBUUUBUUBBUBUBBBUUUUBUUUUUUUBUUBBUUUBUUBBUUUUUUBUUU
