UUUUBUUBUUUUUUUUUBBUUUUUUUUUBUUUUBUUUUBUUUBBUUUBBUUUBBUUUBBBBUBUBUUUUBUUBUUUBUBUUUUUBUUBUBUUBBBBBUUUB
UBUUUBBUBUUUUBUUBUUUBBUUUBUUUUBUUUUUUUBUUUBBUUUUUUUUBUUBUUBUUUUBUUUUUUBUBBUUUBUBBUUUUBUBBBUUBUUUUBUBU
UBUUUBBUUUBUUBBBUBUBUUUUUUUUUBUUUUUUUUBUBUUUUUUUUUUBBBBUUUBBUBBBUBUUUBBUUUUUBUBUUBUUUUUBUUUBUBUUUUUUU
UUUUUBUUUBBUUUBUBUUBUUBUUUUUUBBBUBUBUBUBUUUUUBUUBUBBUBUBUUUUUBUUUBBUBUUUUUBBUUUBUBBUBBUBBUBUBUUBUUBBB
UUBUUBUBUUBUUUBUUBUUUUUUUBUUUUBUUUUUUUUUUBUBUUUUUBBBUUUBUUBUUBBUBBBUUUBUBUBUUBUUBUUBUBBBUBBBUUBUUUBBU
UUBUUBUUUUUUUBUBUUBUBBUBUBUUUUUBUBUUUUBUUBBUUUUUBUUUUBBUBUUBBBBUUBUUUBBUUUUBUUBUBUUUUUUBUUUUUBUUBUUUB
UBUBUUUBBBBUUUBUUUBUUBUUUBUUUUUUUBBUBBUUBUUUUUUBUUUUBUBBUUUUUBBUUBUBUBUUUUUUBUUUUUUUUUUBUUBUUUUUUUUBU
UUUUUUBUBBUUUBUUUBUUBBBBBBUUUBUUUUUUBUBBUUUUUUUUUUBUUUUUUBBUUUUUUUUUUUUUUUUUBBUUBBUUUUUUBBBUUBUBUBBUU
UBBUUUBUBUBUBUUBBUUUBBUUUUBBBBBBBBUBUUUUBBUBBUUUUUUBBUUUUUBUUUUUUBUUBBUUUBUUUUUBUUUUBUUUUUUUUUBUBUUBB
UBUUBBBBUBUUUUBBUUUUUUBUUUUBBUBUUUBUBUUBUUBBBUUUUUUUUUBBUBUUUUBUUUUBUUBUUUUUUUUUUUUUUUBUUBBBUUUBBBUBU
UUUUUUUUUUBBUUUUUBBUUUUUUBBUUUUBUUBUUUBUUUUBUUUUBUUUUUUUBUBUUUUUUUBUUUUUUBBBUBBUUUUUUBBUUUUBUUBBBBUUU
UBUUUUUUBUBUBBUUUUBBUBBBBUUBUUBUUUUUUUBUUUUBUUUUBUUUUUUBUUUUUBUUUUUUUBUUBUUBUUUUUUBUUUBUUUUUBBBUUUUUU
UBUBUBBUBUUUBUBUUUUUUUUBUUUUBUUUUUUBUUBUUUBUUUUUUUUUBUUUBBUUUUUUBUBUUUUBBUUBUBUBUUBBUUBBUUUBUBUUUUBBU
UBUUUUUUUUUUBUBBBBBUUUUUUUBBBUUUBBUUBUBUUUBUBUUUBUUUUUBUUUUBUUUUBUUUUUUUUUUUUUBUUBUUUBUBBUUBUUUUUUUUU
BUUUUUUUBUBBBBBBUUUUUUUUUUUUBUUUBUBBUUBUUBUBUUBUUUUBUUUBUBUBUBUUUUBUUUBUBUUUUUUUUUUUUBUUUBUUBUUUUUBUB
UBBUUUUUUUUUUUUBBUUUBBBUUBBBBBBUUUUUUBBBBUUUBUUUUUUUBUUUBBUUUUUUBUUUUBUUBUUBUUUUUUUUBBUUUBBBUUBBBUUUU
UUUUUUUUBBBUBUBUUBUUBUUBBUUUBUBUBUUUUUUUUUUUUUBUUUUUUBBUUUBUUBUUBUUBBUUUUUUBUBUUBUUBUUUBBBUUUUUUBBUUU
BBUBUBUUUUBBBUUUUBUBUBUUUBUUUBBUUUUUUBUBUBBBUUBUUUBUUUBUUUUUUUBBUUUUUBUBUUUUUUUUUBBBUUUUUUUUUUUUUUUUU
UUUUBUUUUUUUUUUUUBUUUUUBUUBUUUUUBUUUBUUUUUUUUUUUBBBUUUUUUBBUUBBBUUUBUBBUUUUBUUUUUUUUBBBUUBUBUUUUUUUUU
UUUBBUUBUBUUUUBBBUBUBBUUUUUBUUUBBUUUUUUUUBUBUBUBUBUUUUUUUUUUUBUUBUBUUUBUBBUBUBUUBUUUUUBUBBBUBUBBUUUUU
BBUBBBUUBBUUUUUUUUBBUUUUUBBUUBUUBUUUUUUUUBBBUUBUUUUBBUBBBBBUBUBUUUUUBBUUBUUUBUBUUBUUUUBUBUBUUUUBBUUUU
UBBBUUUUUBUUUUUUBUBUBBUUUUBUUUUUBBUBUUBUUUUUBUUUUUBUBBUUUUUUUUUBUUBUUUUUBUUBUUUUBBUUUUUBBBBUUUUUUBUBB
BUBBUUUUBBUUBUUUUUBBBUUUUBBBBUBBUBUBBBBUUUUUUUUUUUBUUBUBUUBBUBUUUUUUBUUBUUUUBBUBBUUUUUBUBBBUBUUUUUUUU
UBUUBBBUBUUUUUBBUBUUBUBUUUBUUUUUUUUUBUUBUUUUUUBBUUUUBUUBUUBUUBUBBBUUBUBBUUUUUBBUBUUUUBUBUBBUUUUUBBUUB
UUUUUBUUBUBUUUUBUUUUBUBUUUBUUBUUBUBBUBBUUUUBUUUUBUUBUUBUBUBUUBUUUBBBUBUBUUUUUUUUBUBBUBUUBBUUBBUBBBBUU
BUBUUUUUUUUBUUUBUUUUUUBUUUBBBUUUUUUUUUBBBBUUUUBUBUUUUUUBUUUBUUUBUUUBUUBUUBBBUUUUUUBUUUUUBBUUUUBUUUUUU
UUUUUBUUBBUBBBUUUUUBBUBUBBBBBBBUBUBUUUBBUUUUBUUBUUUBBUUUUUUUUUBUUBUUUBUBUBUUUUUUUBBBBUUUUUUUBBBBBUUUU
UUUUBUUBUBUBUUBBUBUUUUBUBUUUUBUUBBUBUUBUBUUUUUUUBUBUUUUBUUUUUBBUUUUUUUUUUBUUUUUUUUUUBUUUBUUUBBUUUUUUB
UUUBUUBUUUUUUUUUBUUUUUBUUUUBBUBUUUBUUBUBUUUUBUUUUUUBUUUUUUUUUUBBBUBBBBUUBUUUUUBUBUUUBBUBUUUUUBBUUUBBU
UUUUUUUUBUBBBBUUUUUUUUUUBBBBUUUUUBUBUBUBUUBUUUUUUBUUBUUUUUUUUUBUUUUUUBUUUUUUUBUUUUUUUUUBUUBBBUUUUBBUU
UUUUUUUUUUBUUUBUUUUUUBUBUBBUUBBUUUUBUUBUUUUUUUUUUUUBBUBBBUUUUUUBBUUUUUUUBBUBUUUBUUUUUUUUUUUUUBUUUUBUB
UBBUBUBUUBUBBUUUUBBUBUBUBUUUUBUBUBUBUUBUUUBUUBUUUUUUUUUBUUUBBUUUBUUBUUUUUBUBUUUBUUBUBUUBBUBBUUUUBBUUU
UUUBUUUUBBUUUUUUUUUUBBUUBBBBBUUBUUUUBUUUUUUBUUUUBUUUUBUUBBUUBUUUBUBUUUUUUBUUUUUUUUBUUUUUUBUUUUUUBBUBU
BBBBBBUUBUUUUUUUUUUUUUUUBUUUUUUUBUBUUUBUBUUBUUBUUUUUUUUUBUUUUUUUUUUUBUBBUUBUUUBBUBUBBUBUBUUUUUUUUUBUU
UUBUBBUUBBUUUUUBUUUBBUUUUUUBUUBUUUUUUUUUBUUUBBBUBUUUUUUUUBUUBUUUBUBBUUUUUUUUBBUUUBUBBUUUUBUUUUUBUUUUB
UUBUUUUBUUUUUUUUUUBUUUBBUBUBUBUBUUUUBUUUBUBBUUUUUUUUBBBUUUUUUUBUUUUUUBUBBUUBBUUUUUUUBBUUBUUBUUUUBBUUU
UBUUUUUUUUBBUUBUUUUUUUUBUUUUUBUBUBUUUUUUUUUUUBUBUUUUUBUBUUUUUUUUUBBUUUBUBUBUBUBBBUUUUUUBUUUBBBUUUBBBU
UUUBUBUUUBUUUUBUUUBBUUBBUBUUBUUBUBBUUBBUBUUUUUUBUBBUBUUUBBBUBUBBUUUUUUUUUUUUBUBUUUUUUBBUUUBUUUUBUUBUU
BBUUBUUUBBUBUUBUUUBBBBUBBUBUUUUUUUUUBUBUUUBUBUUUUUBUUBBBUBBUUUUUUUUBUUUUBUUUBBBUBUUUBUUBBUUUUUUUBUUUU
UBUBUUBUBUBUUUBUUUBBUUBBUBUUUBUBUBBUUUUUUBBUUUUUUUUBUBUUUBUUUUUUBBBUUUBUUUUBUUUUBUUUUUUUBUBBBUBUUUUUU
BUBUUBUUBBUBUUUUUUUBBUUUBUUUBUUUBUUUUUUUUUUBUUBUUBUUBUUBUBUUUUBBBUUUUUBUUUBUUBUUBUUBBBUUUUUBBUUUUUUUU
UBBUBBUUUUUUUBBBUUUUUUUUBBBUUUUUUUUUUUUBUUUUUBBUBUUUUUUUUBUUUUUBBUUUUUBBBUUUBUUBBBBUUUBUUUBBUBUUBBUUU
BUUUUUUUUUUBUBBBBUUUUUUBUUUUBUBUUBUBUBUUUUUBUUBUUBUUUUUUBUUUUBUBUUBBUUBUUUUUUUUBUUBUBUUUUUBBUUBUUBUUU
UUUUUBUBBUBBUBBUUBBUUBUUUUUUUUBUBUUUUUBBBUBBUUUUUBUBUUUBBUUUUUBUUBUUUBBUUBUUBUBUUUUBUBBBUUUUBBUBUUBUB
UBUUUUBBUUUBUUUUUUBUBUUUUBUUUUUUUBUBUUUUBUUUUBUBUUUUBUUUUUBUBUUUBUBBUBUUUUUUUUUUUUUUUUUUUUUBBUUUUUBBU
BUUBBUUUBUBBUBUUUUBUBUBBUBUUBBUUUUUUBUBUUBBBUUUUBUBUUUUUBUUUUUUUUUUBBUUUBUUUBUBUUUUUUUUUUUUUUUUUBBUBB
UUUBBUUUUUUBBUUBBBUUBBBUUUUUBBBUBBUBBUUUUUUUBUUUUUBBUUBBUUBUUBUBUUUUUBBUUBUUUUBUUUBUUUUUUUUBUBUUUBUBU
BUBUBUUBUUBUUBUBUUUUUUUBBUUUBBUUUBUUBBUUUBUUUUUUUUBUUUUUUUUBUUUUUBBBUBUUBUBUUBUUUUBUUUUUUBBUBUBBUUUUU
BUUUBUUBUUUUUUBBBBBUBUUBUUUUBUBBUBUUUBUUUUUUUUUBBUUBUUUBUUUBUUBBUUUBUUBUUUUUBUBUBBUBBBUUBUUUUUUUBUUUB
UUUUBUUBBUUBUBBBBBUUUBBBUUBBUUUBBUUUUUBBUBUUUUUUUBUBBUUUUBUUUBBUUUBUUBUUBUUUUBBUBUUBUUUBBUUUUUUUBUUBB
UUUUBUUUUBUBBUUUUBBUUUUUUUUBBUUUBBBUBUBUBUBUUUUUUBBUUUUBBUUBUBUUUBUBUUUBUUUUUUBUUUUBBUUUBUUUUUUUUUBBU
UUBUUUUUUUUUUUBUUUUBUUUBUUUBUUUUBUBUUUUUUBUUBUUUUUUUUUUUUUUUBBBUUUBUUUBUUUUBUUBUUUUBUUBUUUBBUUUBUBUUU
UBUUUUUBBUUBUBUUUUUUUBUUUUUUUBUUUBBUUUUUUBBUBUBBUBBUUBUBUUUUUBUUUUBBUBUBBBBUUUBUUUUBBBUUBUUUBUUBUUBBU
UBBUUUUBUBUBBUBUBUUUUUUUUBUUUBUUUUBUUUUUUBUUBUUBBUBBUUBUUUBBUBUUUUUBUUUBUUUUUUUBBBUUUUUBUUUUUUBBBUUUU
BBBUUBUUBUUUUUUUUBBBUBUUUUBUBUUUBUBUUUUBBBUBUUUUUUUBUUBUUUUUUUUUUBUUUBBBUBUUUUBUUUBBUUBUBBUUUBBUUUBUB
BUBUBBUBUUBUUUUBBUUUUUUUUBUUUUUUBUUUUUUBUUBUBBUBUUUUUUBUUBUUBBUUBUBUUUUBUUBBUUUBUBBBBUUBUBUBUUUBUUUBU
UBUUUUUUUBBBUBUUUUBUUUUUUUUUUBUUUBUUBUUUUUBUUUUBUUUUUBUBBUUBUUUUBUBUUUBUBUUBUUUUUUUUUUUBUUUBBUUBUUUBB
UUUUUBBUUBBBUUUUUUUUUUUUUBUUBBUUUBBBUBBUUBUUBUUUBBBUUUUUBUBUUUUUUUUUUUUUUBUUUUBBUBUBUUBBBBUUUUUBBUUUB
UUBUUBBUUUUBUBUUUUUUBUUUUBUUUUUUUUUBBUUUBUUUUUUUUUUUBUUUUUBUBUUBBUUBUBBUUUUUUUUUUUUUUUUBUUUUUUUUUUBBU
BUUBUUUBBUUUBUUUUBBUUBUUBUUUUUUUUBUUUUUUUUBBUUUUBUUUUUUUBUUUBBUUUUUBBUUUUUUUBBUUUUUBBUUBBUBUUUUUUBUUU
UBUUBUBUUUUBBUBUUBUUUUBUBUUUUBUBBBUBUBUUBUUUBUBUUUBUUUUBUUUUBUUUBUUUUUUBUBUUUUUUUUUUBUUUUUUUUBUUBUUUU
UUBUBBUUBUUUUUUUBUUBUBUUUUBBUUBUUUBUUBBBUUBUUUUUUBBBUBUBBUBUUUBBUUBUUBUUUBUBUUUBUUBBBUUUUUUBUBUUUUBUU
BUUUUUUUUUUBUUBUUBUBBUUUUUUUUUUBBUUUBBUUBBUUBBBUUUUBUUUUUUUUUUUUUBBBUUUUUUUUUBBUBUUBUBUBUUUBUBBUUUUBU
BBBUUUUUUUUUUUUBUUBUBUUUUBUBUBUUUUUUBUUBUBUUBBBBUUUUUUUUBBUBUBUBUUUUBBUUBUBUUUBUUBUUUUUUUUBUUUUUUUBUB
UUBUUUUBUBUUBUBUUUUUUUUUUUUBUUUUUBBUUUUBUBUUUUUBUUUBBUUUUBBUUUUUBBUUBUUUUBBBBBUUBUUUUUUUBBUUUBUBUBUUB
UUBBBUUBUBBUBBBBBUUUBUUBUUUBUUUUUUUBUBUUUUBBUUUUUUUUUBUBBBBBUUUBUBBUUBUUBUUUBUBBUBBUUUUUUBUUUUUUUBBBB
UUBBUUUUUBBBUUUUUUUBUUUUBUBBUBBBUBUUUUUUBBUUUBBUUUUBUUUBUUBUUUUUBBUBUUUUBBUUUUUUUUUUUUUBUUUUUUBBBUBUU
BUUUUBUUUUUUUUUUUUUBUBUUUBUBBUUBUUUUBBUUUBBUUUUUBUUUUUUUBBUUUBUBUUUBUUUUBUUUUBUBUBUUUUUBUUUUBUUUBUUBB
UBUUUUUUUUUUUBUBUBUUUUUUUUUBBUUUUBUBBUUUBBBUUBBBUUUUUUUUBBUUUBUUUUBUUUUUUUUUUBUUUBBUUBUUUUUUUUUUUUUUU
UUUUUUUUUUUUUUUBUUUUUBUBUUUUUUUUUUBUBUUBBBUBBUBUUBUBBBBBUUUBBUUBBUUUUBUUUUBBUUUBBUUBBUUUUBUBUUUBUUUUU
BUUUUUUUUUUUBUBUBUUUBBUUUUBUBBUBBUUUUBUUUBUBBUUBUUUUUUBUBBUBUUUUUUBUUUUUBBBBUUUUUUUBBBUUUUBUUUUBUBBUU
BBUUUUUBUUUUUUUUUUBUUUUUUUBUBBBUUUUBUUUUUBBUUUUBUUUUUBUUUUUUUUBBBBBUUUUUBUUUBUBUBUBUBBBBUBBBUUUUUUUUU
UUUBUBBUUUUUUBUUUUUBUUUUBBBBUUUUUBUUUBUUUUUUUBBUBUUUBBUUBUUBBUUBUBUUBUUUUUBBUUUBUUUBUUUUUUUBUUUUUBBUB
BUUBUUBBBBUUBUUUBBUUUUUUBUUUUUUUUUUUBUUUUUBUBUBBUUBUUUUUBBBUUBUUUUUBBUUUUUUUBUUUBUBUUUUUUUUUUUUBUUUBU
BUUUUUBBUBUBUUUUBUUUUUUBUBBUUBBBBUBUUUUBUUBBBUUBUBBBUUUBUBUBUBUUUUUUUBBBUUUBUUUUUUUBUBUBUUBUUUUBBUUBB
BUBBBBUUUUBUBUUBUBUBBUUUUBUUBBBBUUUUUUBUBUUUUUUUBUUUBUUUUBUUUBBUUUBUBUBUUBUUUUUBUBUBUBUBUUUUUUUBUBUBB
BUUUUUUBBUUUUUUUUUUUBUBUUUBUBUUUBUBUUUUBUUBBUUUUUBUUUBBUBUUUBUUBBUUBUBBUUUBUUBBBBUUUUUUBUUUUUUBUUUUUU
UUUUBUUUBUUBUBUUBUUUUUUUUUUUUBUUUUUBUUUUUUBUUUUUUBUUBUBBUUUUUUUUBUBUUUUUUUBUBUUBBBUUUUBBUUUUUUUUUUBUB
UUUBUUBBUBBBBUBBUUBUBUUUUUBUBBBUUBUUUUBUUUUBUBUBUBBUUBUBBBUUUUUUUUBUUUBUUUUBBUUUBBUUBUUUUUUUUUUBUBBUU
UUUUUBBUUBUUUUUBUBUUUUUUUUUUUUUUBUUUUUUUBUBUBUUBBUBUBUUBUUUUUUUUBUBUUBUBUUUUUUBUUUUUUBUUBBUUUUUBUBUUU
BUBUUUUBUBUBUUUBBUUUUBUBUUUBBBBUBUUUUBUUUUBBUUUUUUUUUUUUBUUUUBBUBBBUUUBBBUUBUBUBBUUUUUBUBBBUUBUUUBUBU
UUBBBUUBUUUUUUUUBUBUBUUBUUUUBUUUUUUBUUUBUUUUUUUBUUBBBBBBUUBBBUUBBUBBUUUUBBUUUUUUUUUUUUBUUUBUUBUUBUBUU
BUUUUUUUBUBUUBBUUUUBBBUUUBBUUUUUUBUBBBUUUUUUUUBBUUUBBUUUUUUBBUUUUUUUUUUUUUUUUUUUUUUUUUUBBBUUUUUUBBUUU
BUUUUUUBUUUUBUUUUUUBBUBUUUBUUBUBUBUUUUUBUUUUUUUUUBUUUUUUUBBBUUBUUUBBUUBUUUBUUUUBUUUUUUUUUBUBBUBUUUUUU
UUBUUUUUBUUUUUUBUUUUUUBUBBBUUBUUBUUUUBUBUBUBUUBUUBUUUUUUBBBUUUUUUBUUUUBUBBBUUUUUUUBUBUUUUUBUUBUUUBUUB
UBUUUUUUUUUUUBUUUBBUUUUUUUBUBUBBUUUBUUBBUUUUBBUUBUBUUBUBBUBBBUBUUBUBBUUUUUUUUUUBUUUUUUUUUBUUUBUUUUBBU
BUUBUBBBUBUUBUUBUBBBUUUUUUUUUBBBUUUBBBBUUBBUBUBUUUUUUUBBUUUUBBUBUUUBBUUUUUUBUUBUBBUUUUUUBUUUUUBUUUUUU
BBUUBBUUUBUUUBBUUUUUUBUUUBBUUUUUUUBBBUUUBUUUUUBUBUUBUBUUUBUUUBUUBBUBUUBBUBUUUUUUUUUUUUBUBUBUBUBUUBUBB
UBUUUUBBUUUBUBUBBUUBUUUUBUUBBUUUUBUBBUBBUBUBUUUUUUUUBUUUUUUBUUUUUUBUUBUUBUUUBUBUBBBUUUBUBUUUUUUBBBUUB
UUUUBUUBBUBUBUUUBUUBUBUUUBBBBBUUUUUBBBUBUBBBUUUUBBUBUUUUUUBUUUBUUBUUUUUUUUUBUBUUUUBBBBBUBUUUUUBUUUUUU
UUUUUUUBUUBUUBUUUUBUUBUBBUUUBUUUUUUUUUUUUBBUUBBUUBUBUUUUBUUBBBUUUUBUUBBUUUUUUUUUUBUUUUUUBBBUUUUBUBUUB
UBUBUUBUUUUUUUBUUUUUUBBUBUUUBBUUUUBUUUBBUUBUBUUUUUUBUUBUUBUUUBBUUUUBUUUUUUBBUUBUBBBUBUUUUBUUUUUUBUUUU
BUUUUUUUUUUUUUUUUUUUUUBUBUBBUUBUUUBUBUUUBUUUUBBUUUUUUBUUUBUUUBBUBUUUBBUUBBUUUUUUUUBUUUUUUUUUUBUUUUUUB
UUBBUBBBUUUUUBUUUUUUUUUBUUUUUUBBUUUUBUBUBUUUBUUBBUUUBUBUUBUUUBUBBUUBUBUBUUBUUUUUUUBBUUUUUBBUBBBUUUBUU
UUUUBUUBUBBBUUBBBUUBUBBUBUUUUUUBBUBUUBUUUUUBUUUUBBUUBUUUUUUUBUBUUUUUUUUUUBUBBBUUUUBUUUBBBUBUBUUBUBUUU
BUUUUUUBUBBUUUUUUUUUBUBBBUUUUUBUUUUBUUBUBBBUUBUUUUUBUUUUUUUUUUBBUUUBUUUBUUUUUUBUUUBBUUUUUBBUUUBBBUUUB
UUUBUBUUBUUUUBUBBUBUUUUUUUUUBUUUUUUUUUUUUBUUBBBUBUUUUUUUUBUUUUUUBBUUUUBUUBUUUUUUUBUUUUBUBUBUBBUUUUUUU
UUUUBUUUUUUUUUUBUUUBUUUUUUUBUUBUUUUUUUUBUUBUUUUUBUBUUBBUBBUUBUUUUUUUBBUBUBUUUBUUUUBUUUBUBUUUBBBUUUUBB
BUUUUBUUUUUBUUUUUBUBUBBBUUUUUUUUUUBUBBUUUUUUBUUUUUUUUBUBBUUUUUBUBUUBUBUUUUBBUBUUBUUBUUUUUUUBUBUUUUBUB
UUBUUUUUUBUUUBUUUUBUUUUUBUUUUBBUBBUBUBUUBBBUUUUUUUUUUUUUUUUUUUUUBBUBUUUUUUUUUUBBBUUUBUUUUUUUBBUBUBUBU
UUUBBBUBBBBUUUBBBBUUUUUUUUUUUBUUUUUUUBBUBUUUUUUUUBUBUBUUUUUUUBUUBUUUUUUUUUUUBBBBBBUUUBUUUUUUUUUUUUUUU
