UUBBBBBUUUUUUUUUUUUUUUUBUUUUUUBUBUUUUBUUUUBUUBUUUBUBUUUUBUUUUBUUUUBBUUBUBUUUBUUUUBUUUBUBUUUUUUUBBBUBU
BUUUUUBUUBBBUUUBUUUBBBUUBUUBBBUUUUBUUUBUUUUUBBUUUUUUBBUUBUUUUBBUBUBBUUUUUBBUUUBUUUBUBBUUUUUUUUBUBUUBU
UBUUUBBBBBUUBUBUUUBUUUUBUUUUUBUBBUUUUUUUUUBUBUBUBUUUUUUUBUBBUBUUBUUUUUUBBUUUUUUBBUBUUUUUBUUUUBUBBUBUU
UUUUBUUUUUBUUUUUUUUUUBUBBBUUUUUUBUUBBUUUUUBBBUUUUBUBUUUUBUUUUBUUBUUUUUUUUUUUUUUBBUUUBBUBBBUUUUUUUBUUU
UUBBUUUUBBUBBUUBUUUBUUUUBUBBBUBUUUUUUUUBUUUBUUUUBUUUUUUBUUBBBUUUUUBUUBBUUUBUBUUBUUUUUUBUUUBUUUUUBUBBB
BUUUUUBUUBUBBBUUUUUBUBUUBUUBUBUUUBUUUUUBUBBBUUBUBBUUUBBUUBUUUUBUBUUBUBUBBUUUUUBUUUBUUUBUUUBUUUBBBUBUB
BUBUBUUUBBUUUUUBUUUBUBUUUUBBUBUBUUUBUBBUUUBUUUBUUUUUUBUUUBBUUUBUBUBUUUUBUUBUUUUUUBUBUUUUUUUUUUUUBUUUU
UUBUUUUUUUUUBUBUUBUUUBBUBUBUUBUUUBBUUUUUBUUUUUUUBBBUUUUUUUUBUUUBBUUUBUBUUBUUUBUBUUBUUBUBBUUBBUUUUBUBU
BUUUBUBBUUUUBUBUUUUUUUBUBBUUUUUUUBUUUUBUUUBUBBUUUUUUUBUBBUUBUUUUUUBUBBUBUUUBUUUUUUBUUUBUBUBUUUBUUUUBB
UUBBBUUBBBUBBUUUUBBUUBUUUUUUUBUUUUBBBUUUUUUUUUUBUUBBBUUBBUUBUUBUUUUUUUBBBBBUUBBBUUBUUUUUUUUUUUUUBBBUU
BUBBUBBUUBUUUUBUUBBUUUBUUUBBUUUBUUBUUBBBBUUBUUUBUUUUUUUUBUUUUUUBUUUUUBUUUUUBBBUBUUBBBUUUUUUUUUUUBUUUB
UBUUUBUUBBUUBUUUUUUUUBUBBUBBUUUUUUUUBBBUUBUUUUUUUUUBUUBUUUUBBBUUUBUUUUBUUUUUUUUUUBUUUUUUUUBUUUUBUUBBB
UUUBUUUUUUUBBBUUUUUUUUUBUBBUUUUBUUUBUUUUUUBBUBBUUUBUBUUUUUBUBUBBBUUUBUUUUUBUUUUUUBUBUUUUUUUUUUUUBUUUU
UBBUUUUUUBUUUUUUUBUUUUBUUUUBUUUUBUBUUBUBUBUBUUUUUUBUUBBBUUUUUUUUUUUUUUUBUBUUUUUBUUUUUUBUUBUUBUUBUUUBU
UUUBUUUBUUUUUBUUUUUUBUBUBUBUUUUUUUUUUUUUBUBBUUUBUUUBUUUUUBUBUUUUUUBUBUUBBUUUBUUUUUUUBUUUUBUUUUUUUBUUU
UUUBBUBBUUBBUUUBBUBBUUUUBBUUBBUUUUUUUUBBBBUBUUUUBUBUUUUBUUBBUBUUUBBUUUUUUUUBBUUUUUUUUUBBUUBBUBBUUUUUB
UUUBUUBUBUUBBUUUUBUUUUUUUBUUUUBBBUBUUBUUUUUUUUUBBBUUBBUUUBUUUUUUUUUUUBUBBBBBBUUUUUUUBUUUUUUUBUBUUUUUU
UBUUBUBUUUUUUUUUBUUUUBUUUUBUUBUUUUUUBUUUBUUUUBUUUUUBUUBUUUUUUUUUUUUUBUBUBBUUUUUUUUBUBBUUUBUBUUUUUUUUU
UBUUBUBUUUUBUUUBUUBUUBUUBUBBBBUUUUUUUUBUUUUUUUBUUUUBUUBUUUUUUBUUUUUUUUUUUUUUUBUUBBUBUUUUUBUUUUBUUUUBB
BUUBUUUUUBUUUBUUUUUUUBUUBUUBUUUBUUBUBBUUBUUUBUBUBBUUBUBUUUUUUBUUUUUUUUBUUUUUUUUUUBUUUUUUUUUUUBUBUBUBU
UBUUUUBUBBBBBUBBBUUUUUUBUUUUUUBUUBUBUUBUBUUBUUUBUUUUUUUBUUUUBUUBBBUUUBUUUUUBUUUUUBBUBUUBUBUUUBUUBUUUB
UBBUBUUBUBUUUBUUBBBUUUUUBUUUUUBUUUUUUBBUUBUUUUUUUBUUUBUUUUUUBBUUBUUUUUBUUUUUUBBUBUUBBBUBUBUUUBUUUBUBU
UUBUUUUBBUUUUBUUUUUUBBUUUBUUUBUBUUBUUBBBUBUBUBBUBUUBUUUUUBUUBUUUBUUBUUUUBUUBBUUBUBBUUUUUUBUUUUUBUBUUU
UBUUUBUUBUUUUUUUBUBUUBBUUUUUUBBUBUUBBBBBUBUBUBBBUBUUBUBUUUUUUUUUBBUBUBUUUBBBUBUUUUUUUUUBUBUUUBUUUUUUU
BUUUUUUBBUUBUUUUUBUUUUUUBUUBUUUUBUBBUUUUBUBBUUBBUUUBUBUUBBUUUUUUBUUUUUUBUUUBUUUUUBBUUUUUUUUBUBUUUBUUU
UBUBBUUUBUUBUUUUUUUUUUUUUUUUUUUBUBBUUUBUUUUUBUUUUBBUUUBUUUBBUUUUUBUBBBBBUUBUUUUBUBBBBUUUUUUBUBBUUBUUU
UUBUBUUUUUUUUBUUUBUUUBBUBBUBUUUUUUUUUUUUUUUUUUUUUBUBUUUUUUUBUUUUUUUBUUUBUUUBBBUBUUUUBUBUUUUUUUUUUUUUB
BUBUUUUUUUUUUUUUUUBUBUBBUUUUUUUBUUUUUUUUUBBUBUUUUBBUUUUUUUBBBBUUUUBBUUUUBUUUBBBUUBUUUBUBUUUUUUUUUUUUU
UUBUUUUBUUUUBUUUBUUUUUUUUUUBUBBBBUUUUBUUUBUBUUUBUUUBBUBUUUBUUUUUUUUBBBUUUUUBUBUUUUUUUUUBUBUUUUUBBUUBU
UBUBBBUUBUUBUUBUBUUBUUUBUBUUUUUBUUUBUUBBBUUUUUUBUUBUUBUUBUUUUBUBUUBUUBUBBBUUUBBUUUUUUUUUUUUUBBUBUUUUU
UUBBUUUUBUUUBBBUUUUUUUBUUUUBUUUUBBBBUBUUUUUUUBUUUUBUUUUBUUUBUUUUBBUUUUUUUBUUUUBUUUUUBUBBUBUUUBBUUUBUU
UUUUUUUUUBUUUUUUUBUUBUBUUUBUUBBUUUUBBUBUUUBUUUUUUUUBUBUBUUUUBUBUUBBUUUBUBUUUUUUBUUBUUUUUUUUUBUBUUUBUU
UUUUUUBUUUUBUUUUUUBUBUUUUUBBUUBBBUBUUUUUBBUBBUUBUUUUUUBBUUBUBBUUBBUBUUUUBUUUUUUUBBBUUBUUUBUBUBUBUBBUB
UUUUUBUBUUUUBUBUBBUUUBBUUBUUBUUUBBUBUUUUUUUUUUBBUUUBBUUUUUUUUBUBUUBBBBUUUUUBUUUUUBBBUUUUUUBUUUUBUUUBU
UBUUUBBUBUUBUUUUBUUUBUBUBUBUUUUBUBBUUUBBBUUUBUBUUBUUBUUUUBUBBUBBUUBBUUUBUUBUBBUUUUUUUUUBUUUUBUUBUUUBU
UUUBBUUBUUUBUBUUUUUUUUUUUBBUUUUUUUBBUUUUUUUBUBBUBBBUUBUUUUUUUUUUUBBBUUUUUUUBBUUBBBUUUUUUBUBUUUUUBUBBU
UUUBUUUBBBBUBUUUBUBUUBUUUUBUBUUUUUUBBUUUUBBUBUUUUBUUUBUUUBUBUUUUUBBBUUUUUBUUUBBBBBUUUUBUBUUUUUBUUUUUU
UUBUUUUBBUUUUBUUUBUUUBUUBUBUBBBUUUUUUBUUUUUUUUUUBBBUBBUUUUUUUUUUBUUBBUUUUUBUUBUUUUUBUBUUUBUUBUUUUUUBU
UUUBBBBUUUUUUUUUUBUBBBUBBUUUUUBUUUUUUBUBUUUUBBUUBUUUBUUUBBBUUBBBUUBUBUUUBBUUUBBUUUBUUUUBUUUUUBBUUBUBB
UUUBUUUBUUBUUUBUUUBBUUUBUBUUUUBUUBBBUBBUUUBBBUUUUUUUBBUBUUUUUBBUUUUUUBUBBUBUUUUUUBUUUUUBUUBUUBUUUUBBU
UUUBUUBBUBBUUBUUUBUBUUBUUBBBUUUUUUUUBBBUUUUUUBBUBUUBUUBUUBBUUUUBBUUUUBUUBBUBUUUBUUUBUUUUUBUUBUUUBUUBU
UUUUBUUBUUUUUUUUUUUUUUBBBUUBUBBBUUUUBUUBBBUUUUUBUUBUUUUUUUUUUUUUBBBUUBUUUBUUBUUUUUUUUUBUBUBUUUUUUUUUU
UBUUBBUUUBBUUUBUUUUUUUUUUUBUBBUUBUUBUUUBBUUUUBUBUBBBBUBUBBUUUUUBBUUUUUUBUUUBBBUBUUBUUUBUUUUUBUUUBUBUU
UUUBBUBUBUBUUUUBUUUBBUBBUUUUBUUBUBUUBBUUBBBBUUUUBUUBBUUUUUUBUBUBUUUBBUUBBUBUBUUUUUBBUUUUUUUUBBBUUUBBB
BBUUUUUUUUUUUBUUBBUBBUUUUBUUUBBBBUUUBUBUUUUUUBUUUBUUUUUUBUUBUBUBBUBUUUUUUUBBUUBBUUUUUUUUUUUBUUUBUUUUB
UUUUUUBUUBUBBUBBUUUUUUUUUUBUUUUUUUUBUUUUBBUUUBUUUUUUUUUBUBBUBBUUUUUBBUUUBBUUUUBUUUUUUUUUBBBUUBUBBUUBU
UUBUUUUUBUUBUBUUBUUUUUUBBUUUUUUBUBUUBBUBUUUBBBBBUUBUUBBBBUUUUUUUUUUUUUBUBUBUUBUUBUUUBUUUUBBBUBUUUUUUU
BBBUBBUUUUUUUUBBUUBUUUBUUBBUUUUUUUBUUBBUUUBUBUUUUUBBUUUBUUUUBUUBBBUBBUUUBUUUBUBUBBUUUUUBUBUUUUUBUUUUB
BBBBUUUBUUUBUUUUBUBBUUBBBBUBUUUUBUUUUUBBUBUUUUUUBUUUUBUUUUUUUUUUUUUUBUBBUUUBUUUUUUUUUUUBUUUBUUBBBUUBU
UUBBUUBUUUUBUUBUUUUUUUUUUBUUUUBUBUUUUUUUBUUUBUUBUUUUBBUUUUBBUUBUUUUUUUUUUUUUUUUUBUBUUBUUUUUUBBUUUBBBU
UUBUBUUBUBUUBBBUBUUBUUUUUUUUUUBUUUUUUUUUBUUBUUUBUUUUUBUUUUBBBUBUUUUUUBUBUUBUUUUBUUBUUUUBUUBBBUUUUUUBU
BUBUUBUBUUUUUBUUUBBUUUUBBUUUBBUUUUBUUUUUUBUUUUUBUUUUUBUUUBBBUUUBUUBUBUBUUUUBUUUBUUUUBBUUBUBUBBUUBUUUU
BBUUUBUUUUUUUUUUUUUUBUUUUUBUUBBUUUBBUUUUUBUUUUBUUUUUBUUUUUUBBUUUUBUUUUUUUBBBBBUUUBUUUUUUUUBUBUBUUUBUU
UUUBBUUBBUUBUBUBBUUUUUUUUUUUUBBUUBUBUBBUUUBUUUUUUUBUBBBUBBBUBBBUBBBUUBBBUUUUUUUUUUUBUUUBUUUBUUUUUUBBU
BBBUUUBBUUUUUUUUUBBBUBUBUBUUUUUBUBUBUUBBUUUBUBUBUBUBBUUUUUBUUBBUBUUBBBUUBBBBUUBBUUBUBUUBBBUUBBUBUBBBB
UUUBBUUUUBBBBBUUUUBUUBUUBUUBBUUBBBUUUUUBUBUUBUUUUBUUUUUBUUUUUUBUUUUUBUBUBUUUUUUUBBUUUUUUUUUUBBBBBUUUU
UUBUUUUUBBBBBUUUUUUUUUUUBUBUUBUUUUUUBUBUBBBUUUUBUUUUUUUUUUBUUUUUUBUBBUUUUUUBUUUUUUBUUBUUBBUBBUUUUBUBU
UUUBBUUBUBUBUUUUBBBBBUUUUUUBUUBBUBUUUUUUBUUBBBUBBUBUUUUUUUBUBUBUUUUUUUUUUUUUUUUBBUBBBUUUUUUUUUUBBBUUB
UUUUUBUBUBUUBUBUUUUUUUUBBUBUUBUBBUUUUUUBUUUUUBUUBBUUUUBUBUUBUUUUUUUBUUUUUUUUUUBUUUUBUUUBUUUUUUUBBUUUU
UBUBBUUBUUBUUUUBUUUUUUUUBUUUUUBUBBUUUUUUUUUUUBUUUUUBUUUBBUBBBUBUUUUBUUBUUUUBBUUUUBBBUBUBBUBUUUUUUUUUU
UUUUBUUUUUBBUBUUUUBUUUUUUUUBUUUUUUBBUUBUUUUUUUUBUBBBUUBUBBBUBBUBUBBBUUBBUUUUUUUUUBUUUUBBBUUUUUUBBUUBB
UUUUBUBUUUUUBUBUUUUUUBUBUUUBBBBUUBBUBBUUUUBUUBUUBUBUUUBBUUUUUBUUUUBUUUUBUBUUUUUUUBUBBUBBUUBBUBBBUBUUU
UUBBUUUUUUBUUUUBUUBUUUUUUBBUUUUUUUUBUUUUUUUUUUBBBUUUBBUUUUUUUBUBUUUUUUUBUUBUUBUUUUUUUBUUUUUUBUBUBBUBU
UUBUBUUUUUUBUUUUUUUUUUUBBBBBBUBBUBBBBUBBUUUUBUUUUUUBUUBUUUUUUBBBUBUBUUBUUUUUBBBBBUUUUUUBBUBUUBUUUUBUU
BUUUBUBUUUBUUBUUUUUUUBUBBUBUBUBUUUUUUBBBUUUUBUBUBUBUUBUUUUUBBBUUUBUBBUUBUUUUUUUUBUUUBUUUUUUUUUBUUUBUU
UUUUUBBBUUUBUBBUUUBUUUUUBBBUBBUUBUUUUUUUUUBUUUUUBUUUBUBBBUBUUUUUBUUUUUUUUBUUUBUUBUBUUUBUUUUUUUUUBUBUB
UUBUUUBUBBBBBUBUUUBUUBUUUUUBUUUUBUUBUBBUBUBUUUBUUUBUBUBUUUBUBUBUBUUUBUBUUBUUUUBBBBUUUBUUBUUUBUUUUBUUU
UUUUUBBUUUBUUUUUBUBBUUBUBUUUUUUBUUUUUUUUBUUUBBBBBBBUUUUUUBUBUUBBUBUUBUUBUUUUUUBBUUUUUUUUUUBUUBUUBBBUU
UUUUUUUUBBUUUUUUUUUBUUUUBUUBUUUUUUUBUUUUUBUUUUUUUUBUUBUUBBUBUBBUBUUUUUUBUUUBBUUUBUUUUUBUBBBUUUBBUUUUB
BUBBUUUUBUUUUUBBUUUBUUBBBUUUUUUBBBBBUBUBUUBUBBUUBUBBUBBBBUBUUUBUUUUUUUUUUUBUUUUUBUUUUUBUUUUBUUUUUUUBU
UUBBBUUUUUUUUUUUBUUBBUBUBUBUBUUUUBUUUUUBUUUBUUUUUBUUUUUBUBUUUBUBUUUBUBUUUUUUUUUUBBUUBBUBUUUUUUUUUUUUB
UBUBUUBBUUUUUUUUBUBUUUUUUUUUUBUUBUUBUUBUUBBUUUUUBUUUUUUUUBBBUUBBBUUUBBUBUUUBUBUUUUBUBUUUBUUUUBUBUBUUU
UUUUBUBUBUUUUBBUUBUBBBUUUUUUUUUUUUBUBUUUUBUUUUBUUUBUUUBUUUUBBBBUBBBUUUUUUUBUUUUBUUBUUUBUBBUBBUUUUUUUB
UBUUUUUUBUUUUUUBUUUUUUUUUUUBBUUBUUUUBUBUUUUBUUUUUUUUBUUUBUBUUUBUUBUUBUUBUUUUUUUBBUUUUUUBBBBUUUUUBUUBU
UUBUUUUUUBUUUUBUBBUUUUUUBUUUBUBUUUBUUBBUBUUUUUBUUUUUUUBUUBBBBUBUBBUBBBUUBUUUUBBUUUUUBBUUBBUUUUUBBUBUB
UUBUUUUUUBUUUBUUBUUBUUUUBUUUUUUUUBUBBUUUBBUUUUUBUUBUUUUBUUUUBUUUUUUUUUBUUUUUUUBBUBUUBUUBBBUUUBUBUUUUB
UUUUUUUBBUUBUBUUUUUBUBBBBBUUBBBUUBUBUBBUUUUUBUUUBBUBUUUBUUUUUUBUUUUUBBBBUUBUUUUBBUUUUUUUUUBUUUBBUBUBB
UBUUBUUBBUBUUBBUUUUBUUUBUBBUUUUBUUUUUUUUUUBUUUUUUUUUUUBUUUUUBBBBBUUUBUBUUUUUUUUBBUUUUBUUBBUUBBUUUUUUU
UUBUUUBUUUUBBUBBBUUUUUUUUUUUUUUUUUBUUUUBBUUBBUBUBUBUBUUBBUUUBUBUUUUUUUBBBUUBUUBBBUBUUBUUBUUBUBUUUBUUB
UUBBBUUUBUUUBUUUUUUUBBBBUUUBUUUBUUUUBBUBUUUUUUUUBUUUUUUUUBUUBUBBUUUUBBBBBBBUUUUUUBBUBBUUUBBBUUBBBBUUB
BBUUUUUUBBUUBUBUUUUUUUUUUUBUUUUUBUBUUBUUUUBBBUUUUUUUBUUUUUUBUUUUBBBUUUUUUBUBBUUBBUBBUUBBUUUUUUUUUBUUB
UUUUUUUUUUUUUUUUUUBUUBUUUBUUUUUUUUUBUBUBBUBUUUUUUUUUUBBUUBUUUUUUUUUBUUUBUBUBBUUUBBUBBUBBUBUUUUUUBUUBU
UUUUUBUUUBBBUBBUBUBUUBUUUUUBUUBBUBUUUBUUUBBUUBUUBBUBUUUUUBUBBUUUUUBBUUUUBUBUUBBUUUBUUBBUUUUUUUUUBBUUB
UBUUBUUBUBUUBUUUBBUUBUUUUUBUUBUUUBUUUBUUUUBUUBUUUUUUUUBBBUUUBUUUBUBUBUUUBUBBUUBUUBBBBBBUBUUUUUBBUUUUU
BUUUBUUUUUUBUBUUUUUUBUUBUUBBUUUBUUUUBUBUBBUUUBBUUUUUUBUBUBBBUUUBBUUUUUBBUBBUBBUBUBBUUBUUBUBUUUUUUBBUU
UUUUBBBBUUBBUUBUUUUBBUUUUUUUBUUUUUBUUUUBBBUBUBUBUUUUUBUUUBBUUUUBUBUUUUUUUUBUUUUUUUUUBUBUUUUUUUBUUBUBU
UUUBBBUUUUUBUUUUUUUBUUBBUUBUUBUBUUUBBUBUUBBUUUBUUUBUUUBBBBUUBUBBBUUUUBUBUUUUBBUBUUBUUBUUUUBBBUUUBUUUU
UUUUUUUBBUUUUBUUUBUUUUUUBUBUUBBBBUUUUUBBBUUUUUUUBBBBBUBUUUBBBUUUUBBUUBUUUUUBUUUUUUUUBUUUUBUBUUUBUUUUU
UUUBUUBUUUUUUUUUUUUUUBUBBUBUUUUUUUBBBUUBUBBUBUUUBUUBUBUBBUBUUBBBBUUUUUBUBUBUUUBUUBUUUUUUUUUUBBBUUBUUU
UBUBUUBUBBUUUUBUUUUUUBUUUUUUUUUUBBUUUUUUUUUUUUBUBUUUUUBUBUUUUUUUUBBBBBUUBUUUUBUUUUBBBUUUBBBBUUUBUUUUU
UUBUUBUUUBBUUUUUUUUUUBUUBUUBUBUUUUBUUBUUUUBUUUUUUUUUUUUUUBBUUBBUBUBUUBBUUUUUBUUBBBUBUBUUUUUUUUBUUUBBU
UUUBUBUBUUBBBUUBUUUBBUUUUUUBUBUBBBBUBBUUBBUUUUUUUBBUBBUUBUUUUUBUUBUUUUUUBUUUUBUBUUBUUUUUUUUUUBUUUBUBU
UUUBBUUUUUUUUBUBUUUUBUUBUUBUUUUUUBUUUUUUUBBBUUBUUUUBUUBUUUUUUBUUUUBUUUBBBUUBUUUUBUUBUUUUUBUUUUBUBBBUU
UUBBBBUUUUBUBUUBBUBUBBUUUUBUBBUBBBUUUBUUBUUBBUUBUUBBUUUUUUUUUUBBBBBUBUUBBBUUUBBBUBUUUBBUUUBUBUUUBUBUU
UBBBUUUBUUUBUBBUBUBUUUUUUUBUBUUUUBUBUUUUUBUUUUUBUBUUBBUUBUUBUUUUUUUUUUBBUUUUUUBUBUUBBUUUUUUUBUBUUUUBU
BUUUUUUUBUUUUUUUUUUBUUUUUBUUUUBBUBUUBUBUBUBBUBBBUUUUBUUUUUUUUUUUBUUBUBUBUBUBUUUUBBUBBUUUUUBUUUBBUUUBU
UUBUUBUUUBBBUUUUUBUUBUUBUUBUUBUUUUUUUBUUUBBBUUUBUBUUBUBUBUBUUUUBUBUUUUUUUBUBBUUUUUUUUUUUUUUUBUUUUUUUB
UUBUUUUBUBUBUBUUBUBUUBUUUUBUBUUUUBBBUBBUUBUUBUUBUUUBBUUUUUUUUBUBUUUUUUBUBBUUUBUUBBUBUUUUUUBUBUUUUUUUU
UUUUBUUBBUUUUUUBUUBBBBUUUBUUBBBBBUUUBBUUUUUBUUUUUUUUUUUUBUBUUBUUUUUBUUUUUBBUBUUUBUUUUUUUUBUUUUUUUUUUU
UUUBUUUUUUUUUUBUUUUBBBUUBUBUUUUUUBUUBUBUUUBUBUUUUUBUUBUUBUUUUUUUUBUUBUUBUUUUUUUUBUBUUUUBUUBUUUUBUUUUU
UBUUUUUUUBBUBBUUBBUBUBBUUBUUUUBUUUUUBBUBUUUUBUUUUBUUUUUUUUUUUUUBUBUUUBUBUUUBUUUUUUUUUUUBBBUUUUUBUUUUU
