UUBBUUUUBBUUUUUUUUUBUUBBUUUUUUUUBBUUBUUUBBUUUBUBUBUUUBUBUUUBUUUUUUUBBUUUUBUUUUUBBUBUUUUBUUBBBUUBBUBUU
BUUUBUBUUUUUUUUUUBUUBBUUUBBUBUBUBUBUBUUBUUBUUBUUUBUBBBUUUBUBUUUBBUUBUUUUUUUUUUUUUBUUBBUBUUUBUUBUUBUUB
BUUUBUUBBBUUUUUBUUBUUUUBUUUUUUUUUUUUUBBUUUBUUUUUUUBBBUBUUUUUUUBBUBUUUUUUUUBUUUBUUUBUUUUUUUUBUUUUUUUUU
UUBUBUBUUBUBBUBUUBUBUUUUBUBUBUUUUUUUBBUBUBBUBUUBUUUUBBUUUUBUUBUBBUBUUUUUUUBBBBUUUUUUUUBBBBUUUUUBUUUUB
UUBUUUBUUUUUUUUBBUBUUUBBBUUUUBUUUUBBUUBBBUUUUBUUUBUUBUUBBUUUBBUUUUUUUUUUUBUUUUUUUBUUUUUBUUUUBUBUUUBUU
UBUUUUBUUUBUBBUUUBUUUUBBBUUUUBUUUBUUUUBBUBBUBUUUUBUUUUUBUBUBUUUUUUUUUUUUUBBUUUBUBUUUBUBUUUUBBUUUBBUUB
UUBBUUUUUBBUUUUUBBUUBUBUBUUUUUBUBUBUUUUBUBBUBUUBUUUUBUUUUUBUUBUBUUBUUUUUUUUUUUBBUUUBUBBUBUUUBBBUUBBUU
UUUBUUUUBUUUUUUUUUUUBUBUUBUUUUUUUUUUUUUUUUBUUUUBUUUUBBBUUBUUUUUUBUBBBUBBUUBUBBBUUUBUUUUUUUUUUUUUBUBUU
UUBUUUUBUBUUUBBUUUUUBUUUUBUUUUUUUBUUBBUUUUUUBUUUUBUUBUUBBUUUUUBBUUUBBUUUUBUBBUUUUUUUBUBBUBBUUBUUUBUUU
UUBBBUUUUUUBUUUUUBUUUUUBUBUBUUBUBUUUUUBBUUUBUBUUUUUUBUUBUBUUUUUBBUUBUUBBUUBUUUUBUUBUUUUUUUBUUBUBUUUUU
UUUUUUBUUUUBUUUUUBUUUBBUBUUUUUUUBBBUUUUUUBUUUBUBUUUBUUUUUUBUUBUUUUUBUBUUUUUBBUBUBUBBBBBUBUUUUUUUUBUUU
UBUBUBBBUBUUBUBBUUBBBBUUUBUUBUUUUUUBBUUBUUUUUBBUUUUUUBUUUUUUBBUBBBBUUUBUUUUUUBUBUUBUUBUUBUUUBUUUBBUUU
UUUUBUUBBUUUUUUBUUBUBUUUBUBUBUUUUBUBUUBUUUUBUUUUUBBUUBUUUUUBUUBUUUUUBUUBUUUUUBUBBUUUUBUUBUBBBBUUUUBUU
BBUUUBBUBBUUUUBUBUBUUUUBUUUUUUBUBUBUUUUBUUUUUUBUUBUBUUUBBUUUUUBUUBUUUUBUBBUUBUUUUBUBUUUUBUBUUUUUUUBUB
BBUUUUBBUBUUUUBUUBUUBBUUUUUBBUUUUUUUUBBUUUBUUUUUUUUUUUUUBUBBBUUUUUUBUUBUUUUBBUUBBUUBUBUUUUBBUUUUUUBBU
BUUUUUUBUUUUUBUUBUUUUUUBUUBUUUUUUUBUBUUBUUBBUUUUBUUUUUUBUBUBBUUUUUUUUBBUUUUUBBUBUBUBUUBBBUBUUBUUUUBUU
UBUUUUUBUUUUBUUUUUUUUUUUUUUBUUBUUUUUUUUUUBBUBUUUUUBUUUBUBUUUUUUUBUBUUUUUBUUBBUBUUUUBBUUUUUBUUBUUUUBUB
UBUUUUBBBUUBBBUUUBUUUUUUUUBUUUUUBUBBUUUBUBBUBUBUBBUBUUUUUUBUBBUUUUUUUUBUUBBUBUUUUUUBUBUUBUUUUUUUUBUBU
UUBBUUUUUUBBUUUUUUBUUBUBUUUUUBUBUUBBBUBUUUUUUUUUBUBUBUBBBUBUUUBUBUBUUUBUUUUUUUBUUUBBUUBUUUUUUUUUUBUUB
BUUUUBBUUUBUUBBUUUUUBBUUUUUUBUUUUUUBBUBBBUUUUUUUBUUUUBUUUUBUUUBBUUUUUUUUUUUUBUBBUUBUUUUBUUUBBBUBUBUBU
UBBUUUBUUUUUUUUUUUUBBUUBUUUUBUBUUBUBUUUUBUUUUUUUUUBBUUUUUBUUUUBUUUUBUBBUBUUUBUUUBUBUUUBUUUBUUUUUUUBUB
BUBBUUUBUUBUUUUUUBUUUBBBBUUUUUUUUUUUBUBBBUUUUBUBUUUUBUUUUBUBBUUBUUUBUUUBUUUUUBBUUUBBUUUBUBUBUBUBUBUUB
BUUBBBBUBUUUBBUBUUUBUUUUUUBUUUUUBBUBUUUUUUUUUUUUUBBBUUUUBUBBUUUUUUUUBUBUUUUUBUUUUBUUUBBBBBBUUUUBUUUBU
UUUUUBUBUUUBBBBBBUUBUUBUBUUUBUUUUUBUUUBUBUUBBUBUUUUUUUBBUUBUBUBBUBBBUUUBBUUUUUUUUUBUBUUUBUUUUUUUBUUUB
UUUBUUBUUUBUUUUBUUUUUBBUUUBBUUUUBUBUUUUUUUBBUBUBUBUBBUUUBUUUUBBUUUUBUUUUUUBUUBUUUBUUBBBBUBBUUBUUUBUUU
BUUUUBBUUUUUUUBUUUBBUUBBBUUUUBBUUUUUUUBBUBUBUUUBUUUBUUUUBUUBBUUUBBUUUUUUBUBUUUBUUBUUUBUBBBUUUUUBUBUUU
UBUUUUUBUBBUBBUUUUUBUUUBUBUUUUBBBUBBUUBUBBUBUUUUUBUUUBUBUUBUUUUBUBUBUBUBUUUBUUUBUUBBBUBUUBUBUUBBBUUUU
UUBUUBUUBUUUUUBUUUBUBUUUBUUUBBUBUUUUUUUUUUBBBUUUUUUUUUUUUBBUUUBUUBBUUUBUBBUUUBUUUUUBUBUBBBBBUUUUUUBUU
BBUUUUUUUBBUUUUUUBUUUUBUUUBUUBUBUUUUBUUBBBUUUUUUUUBUUUUUUUBBUUUBBBUUUUBBBUBUUUUUUUBUUUBUUUUUUBUUBUUUB
BUUUUBUUUUBBBUBUUUUBUBUUUUUBUBUUBUUUBBUUUUBUUUUUBBBUBBUUUUBBUBUUBUUUBUUUUUUUUUUUUUUUUUUBUBUBBBBBUUUUU
BUUBUUUUBUUUUBUUBBBUBUUBUBUUBUUUBUUUBBUBUBUUUUUUBUUUUUBBUUUBUUUUUUUUUUBUBUBUUBBUBUUBUBBUUUUUUUUUUUUUB
BUUUUBUUUBBBBBUUUUUUUBUBUUUBUUUUUUUBBUBUUUUUUBUUBBUBUBUUUUBUUUUBUUUUUUUUUUUUUUUBBUUUBUUUBUUUBBUUUBUUU
UUUUUUUBUUBUUBUUUBUUBBUUUBUUBUUUBUBUUUUUUUUUUUUUBBUUUUBBUUBBUBBBBUUBUUUUUUUUUUUUUBUUUUBUUUUUUUUUUUUUU
BBUUUUUUBUUBUBBUBUUUBUUUUUUUBBUBUUBUUUUUBUBUUBBUUUBUUBUUUUBUUUUUUBUUUUUBUUBBBUBUUUUUUUUUUUUUUUBBUUUUU
UUUBBUUBUUUUUBUUUUBUBBUUBUUBUBUBBBUUBBUUBUUBUUBUUUUBUUBUUUUUUUUBBUUUUUUUBUUBBUUUUBBUUUUUUUBUBUUUUBBUB
BUUUUUUUBBUUUBBUBUBUUUBUBUUUUUUUUUUBUBUUUUUBUUBUUUUUBUBUUUBBUUUUUUUUUUUBUUUUUUBUBUUBUUBUUUUUUUUUUBBUU
UUUUUBUUUUUUUUBUUUBUUBBBUUUBBBUUUUBBBUBUUUUUBBUBUUUUUBBUBBUBUBBUUUBBUUUBUUUBUUBBBUBUUBUBUUBBBUBUBBBBU
BUUUUUUUBUBUUUBBUUUUBUBUUUBBBUUBUUUUBUUUBUUUBUUBUUUUUUUUUUUUUUUBBBBUBUUBBBUBBBUUUUUUUUBUBBUBBUUBUUUUB
UUBUUBBBUUBUUBUUBBUUUUUUUUUBUUUUUUUBUBBUUUUUUUBUBUUBUUUBBUUUBUUUUUBUBUUUBBUBUUBUBUUUUBBUUBUUUUBUUUBUU
UUBUBUUUBBUUUBUBUUUUUBUUUUBBUBBUBUUBUUUUUBUBUUUUUUBUBBUUUUUUUUUUUUUBBUUUBBUBBUBBUUBUBBBUUBUUBBUUBUUUU
UUUUUUBUUUUUBUUUUBUUUUBUBUBUBUBUUUUUUUBBUUUUUUUUUBUUUUUUUBUBBBUBUUUBBUUUBUUBUBUUUBUUUBUUUUUUUUUUUUUBB
UBUUUUUUBUUUUBBUUUUBUUUUUBUBUBUUUBUUUUUUUUUUUBUUUBUUBUUBBUBUBUUUBBUUBUBBBUUUUUUUBUUUUUUUBUUUUUUUUUUBU
UUUUUUUBBUUBUUUUBBUUUUUBUUBUUUUUUUUUUUUUBBUUBBUUBUUBUUUUBBUUBUBUUBUUBUUUUUUUUUUUUUUUUUUUUUUUBUBUUUBUB
UUBUBUUUUBUBUUUBUUUBUBUBUUBUUBUUBUBBUUUBUBUBBUUBUUUBBUBUUUUUUUUUUUUBBUUBUUBBBBUBUBUUBUUUBUUBUUUUBBUUU
BUBBUUUUBBUUUBUUUUBBBBUUUUBUUBUUUBUBUUUUUUBUUBUUUUBUUBUBUUUUUUUUUUUUUBUBBBUUUUUUBUUUUUUUUUUUBUUBUUBBB
UUUUUBUUUUBBBUBBBUBUBBBUUUBUUUBBBUUBUUUUUUUBUUUUUUUBUUUBUUBUBUUUUBUUUUUUUUUUUUUUUUUUBBUUBUUUBBUUUUUUU
UUUUBUBUUUUBUUUUUUUUUUBBUUUUUBUUUUBUBBUUBUUBUUUUUUUUUBUBUUUBUUUUUBUBUBUUBUUUUBUUUBUBUUUBUUUBUBUUBBBUU
UUUBBBUBUUUUUUUUUUUUUUUUBUUUUBUBUBUBUUUBUBUUUUBUUUUUUBUUUUUBBUUBUUUBUUBBUUBBBUUUUUUUUBBBUUUUUBBUBUUUU
UUUUUBUBUUBUBUUUUBBUUUUBUUBUBUUUUUUUBUBUBUUUBUUBUBUUUUUUBBUUUBUUUUBUUUUUBUUUBUBBUUUUUUUUUUUBBUUUBUUUB
BBUBUUUBUBUUBBBUUUUUBUBBUUUUUBUUUUUUBBBUUUUUUBUBUBBUBBUBUUUBBBBUBUUBUBUUUBBUUUUUBUBUBBBUUUUUUBUUUUBUB
BUUUBBUUUUUUUUUUUUUBUUUUUUUBUBUUUUUUUUUUBBBBBUUBBUUUUUBBUBBBUUUBUUUUUBUUBUUUUBBUUBUUUBBBUUBUUUUBUBUUB
UBUBUUBUUBBUUUUUBBBUUUBBBBUUBBUUBUUUUUUUUUUUUUBUUUUBUBUUUUUUBUUUUBUUBUBBBUUBUUBBUUUUUUUUUBUUUUUUUUUBU
UBUUUBBBBUUUUUUUBUUUUUBUBBUUUUUUUBUUUBUUUBBUUUUBUBUUBUUBBUUUUUUBBUBUUBBUUBBUBUBUBUBUUUUBUUBBBUUUBBUUB
UUBUUBUBUBUUUUBUUUUUUUUUUBUBUUUUUUUUUUUUUUUUBUBBBBUBUUUBUUBBUUUUUBUUUBBUUUUUBBUBUUUUUUUUUUUUBUUUUUUBU
UUUBUUUUUUBUBUUBUBUBUBUUUUUUBBUBUUUUUBUUBUUUBBUBUBUUUUUUUUBUBUUUUUUBBUUBBUBUBUUUBBUUUUUUUBBUBUUBUUUUB
UBUUUUUUBBUUUUUUUBBUUUBUBUUBUUUUUUBUBUUBBUUUUUBUUUUUBUUUUUUBUUUUUUUUUUUUUBUBUUUUBUBUUBBUBBBUUUUUUUUUU
UBBBUUUUUBUBUUUUUBBUUBBUUUUUBBBBBUBUUUUUBBUBUUBUUUUBUBUUBUUUBUBUBBUUUUUUUUUBUBUBUUUUBUUUUUUBUBUUUUUUU
BBUBUUBUUUUUBUUUUUUBUUBBBUBUUUUUBBUUUBBBUBBBUUUUBBUUUBUUUUUUUUUUUUBUUUUBUUUBUBUUUBBBUUUUUUBUUUUUBUUBU
UBUUUUBUBUUBUUUUUBUUUBBBUUUUUUBBBUBUUUBUUBUUBUUBUBUUUUBUBBBBUUBUBBUUBBUBBUUUBUUUUUUBUUUUUUUUUBUBUBUUU
UBUBUBUUBUBUUUUUUUBUBUBUUUUBUUUUUUBUUUUUUBBBUUUBUUUUBUUUBUBUBBUUUUUBBBUUUUBUUUUBUUBUUUBBUUUBUBBBUUUBU
BBBBUUBUUBBUBBUUBUUBUUBBUUUUBUBBUUUBBBUBBUUUUUBBUUUUBUBUUUBUUUBUBUBUUUUBUUUUUBUUUUUUBBUBBBBUBUUUUUUUU
UUBUUUUUUBBUBUBBUUBBUUUUUUUBUUBUUUBUUUBUUBBUUUUBUBUUBUUUUBUUBUUUUBUUUUUUUBUBBUUUUUUUUBUUUUUUUUUUBUUUU
UUBUBBUUUUBUUUBBUUUBUUUUBUUUUBUBBUUBUUUUBUUBBBUBUUUUBUBUUUUUUBUUUUUUUUUBUBUBUUUUBUUBUUUBUUUUUUUUBUBUU
UBUUUBUUUBUUUBBBBUUBUUUUUUBUUUBUBUUUBUUUUUUUUUBUBUUUUUBBUUBUUUUBUBBUBBUBBUUBUUUBUBUBUUUUUBBBUBUUUBUBU
UBUUUUUUUBBUUUBBBBUUBUUBBBBUUBUUUBUUBBUBUBUBBUUUUUUUUUUBBUUUUUUUUUUUUUUUUUUUUBUBUUUUBBUBUUBUUBUBUBUUU
UBUUUBUUUUUUBUUBUUUBBUBUUBUBBBUUUBUUUUUUUUBUBUUBUUBUUUBUBUUUBBUBBUUUUUBUUUBBBUUUBBUBUBUUUUUUUBUUUUUUU
UUUUUBUUUBUBBUUUUUUUUUUUUUUUUUUUBBUUBUUUUBUUBBUUBUUBUUUUUUBUBUBUBBUBUUUBUUUBUBUUBUUUUUUUUBUUUUUUBUUUU
BBUUUUUUUUBUBUUUUUUUUBUBUUUUUUUUUUBBBUUUUBUBUBUBUUUUUBUUUBUUBUUBUUUBBBUBUUUUUUBUUUBUUUUBUBUUBUUBUBUUB
UBUBUBUUUUUUUUBUUUUBUBUUUBUUUBUUUUUBUUBUBUBUBBUUUBUBBUUUBUBUUUUUBUUBBBUUUBUBBBUUUUBBUBUUUBUUUUUBUUUUB
UBBUUUUBUUBUUUUUUUUUUUBUUUUUUUUUBUUBUUBUUUUUUUBUBUBUBBUUUBUBBUUUBUBUBUUUUBUUUUBUUUUUUUUUUUUBUBBBBUUUB
BUBUUBUUUBBUBUUBUUUUBBUUBUUUUUUUUBUBUUUBBUUUBUBBBUBBBUUUBUBBUUBUBUBUBUUUBBBBUUUUUBUBUUBBBUUBUUBBUBUUU
BUUUUUUUUUUBBBUUUUBUUUUUUUUUUUBUUUUUUBBBUUBUBBBUUUUUUBUUBBBUUBBUUUBUUBBBUBUUUUUUUUUBUUBUBUUUUUUUUUUBU
BUBBBUUUUUBUBUUUUBUUUUUUUUBBUBBUUBBUBBUBUUUUUUBBUUUBBUUUUUUUUUUUUBUBUUUUUUUBUBUUUUUUUUBBUBUUUUUUUUBUU
UBUBUUUBUUUUUBUUUUBUUUBBUUUUUUUBBUUUBUUBBUUBUUUBBUBUBUBUBUUBUUUUBUUUBUUUUUUUBUBUUUUBUUBUUUUUBUBBBUUUB
BUBUBBUUUUUUBUUUBUUUUUBUUBBUUUBUBUUBUUUUBUUUUUUUBBUUUUBUBUBUBUBBUUUBUUBBBBUBUUBUBUBBBUUUBUUUUBBUUUBUU
UUUBUUUBUUUBBBUUUUBUUBUUBBUUUBUUUUUUUUUUUUBUUBBBUUUBBBUUUBUUUUBUUUUUUBUUBUUBUBUBUUUUUUUUUUUBUUBBUUUUB
UBUUUUUUUUUUUBUUUUBUBBBBUBUBUUBBBUBUUUUBUUUUUUUUBUUUUBBBBUUBUUBUUBUUUBBBUBBBUBBBBUBUUUUUBBUBUBUUUBUBU
UUUUUUUBUUBBBUUBBBBUBUUBUUBUBUBUUUUBUUUUUUUUUUUUUUUUUUUBUBUUUUUUBUBUUUUUUUUBBUUBBBBUBUUUBUUBUUUUUUUUU
UBUUUUBBBUUUUUUUUUUUUUBBUBUUBUUUBUUUBUBUBBUBBBUUBBUUUBUBUUUBUUUUUUBUUUBUUBBBUBUUBBUUUUUUUUUBUBUUBBUUB
UBUUUUUUBBBUUUUUUUBBBUBUUUUBUUUUBUBUBBBUBUUUBBUUUUUBUBBUUBBUBBUBBUUUUBBUUBBUUBUBBUBUBBUUUUUBUBBUBBUBU
UBUBBUBBUUUUUBBBUUBUUUUUUUUBBUUBUBUBBUUUUUUBUUBBBUUUUUBUUUUBBUUBUUUBUUUUUBBBUUUBBUBUUUUUUUUUUBBUUBUBU
BUUUBBUUUBBUBUBUUUBBUUUBBUUBUUUBUBUUUBUUUUUUUUBBUBUUUBUUUBBUUBUUUUUUUBBBUUUUUBUUUBUUBBUUUUUUUBUUUUUUB
UUUBBUUUBBUUUBUUUBUUUUBBUUUUUBUUUBUUUUBUBUBBBUBUUUUBUUBUBUUUUBUBUUUUUUBUBUUBBBUUBUBBBBBBBUBUUUUBUBUUU
BUUUUBBBUUUBBBUBUUUUUUUUBUUUUUUBUUUUUUUBBUBBBUBUUBBUUBUUUUUUBBUUBUUBUBUUUBBUBBUBBUBBBUBUBUUBUBUBBUBUB
BBBUBUBBUUUBUUUBUBBUBUUUBBBBUUUUBBUBUBUUBUUUUUUBUUUUUUBUUBUUUUUBUUBBUUUUUBUUUUUUUUBUUUUUBBUUBBBUUBUUU
BUUBBBBUUBBBUBBUBBBUUUUBUBBUUUUUUUUUBUUUUUUUUUBUUUBUBUUUUUUUUUUBUUUUUBBUUUBUUUUUUBUUBUBUUUBBUUUUUUUBU
UUUUUUBBBUUUUUBBUBBUUBUBUBUBUBBUBUUUUBUBBUBUUUUBUBUUBUBBUUUBBUUBUUUUUUUBUUUBUUUBBUUBUUBUUBUUUBUUUUUUU
BUUBUUUBBUBUUBBUBUBUUUUUUBBBBBBBUBUUUUUUUUUUUBUBBUUUUUBBBUUUBUBUBBUBUUBBUUUUUUUBUUUUUUBUBBUUUBUUUUUUB
UBBUBUUUBBBUUBUBUBUBBUBUBUUUUUBBBUUBUUUUUBUUUBBUUBUUBBBUBUBBUUUBUUBUUUBUBUUBUUUUUBUUUBBUBUBUUBUUBUUUU
BUUUUUUBBUUUUUUBBBBUUBBUUUBBUUUUUBUBUBBUUUBUUUUBUUBBUUUBUBUUUUUUUUUUBBBBUUBUUUBUUUBUUBBBBUUUUUUUBUBBU
UUUBBUUBUBUUUUUUBUUBUUUUUUBBUBUUBUUUUUBUUBUBUUUUUUUUUBUBBBBBBUUUBUUUUUUBUUUBBUUUBUUBUUUUUUUUUUUUUBBUB
UUUUBUUBUBUUUUBBUUBUUUBBBUUUUBUUUUUUUBUUBBBUUBUBBBUUUUBUUUUUUUBBUUUUUBUUUBUBUUBUUUBBUUBUUUBBUUUUUBUUB
UBBUUUUUBUUBUUBUUBBUBUBUUUBUUUUUUUUBUBUUUUUUUBUUBUBUUUUUUBUUUUUBUUUUUUUUUUUBUBUBBUUUBBBUUUBBUUUUBUUUU
UUBUBUBUUBUUUBBUUUBBUUBUBBUBUUUUUUUBBBUUUBUUUUBBBBBUUUBUBBUUUUUUUBUUUUUBUBBUBBUBBUBBUUBUUUUUBUUBBUBBB
BUUBBUUBUBUBBUUUUUBUBUBBUUUUUBUUUUUUUUUBUUBUUBUBUUUBUBUUBUUUBUBUUUBUUUBBUBBUUUUUUUBUUUUUUUUBUUBUBUUUB
UUUBUBUUBBUUBUUUUBUUBBUUUBUBUBBBUBUBUUBUUUBUUUUUUUUBUUUUUUUUUUBBUUBUUBBBUUUUUBUUUUUUUUUBUBBBUUUUUUUUU
UUUUBUUUUUUUUBUUUUBUUUUUUBUBUUUBUUUUUUBBBBBUUUUBUUUUBUUUUUUBUUBBBBUUUBUUUBUBUUUBUUBUUUUUUUUUUUUBUUUUU
BUUUBUUBBUUUUUBUUUUUUBBBUUUUUUUBUBBUUUBUBUUUUBBUUBUBBUBUBBUBUBBUBBUUUUUUUUUUUUUBUUBUBUUUUUUBUBUUUUUBB
UUUBUUUUUUUUUBUBUUUUUUBUUUBUBUUUUBBBUBBUUUBUUBUUBUUUUUBUBBBUBUUBUUUBUUUUUBUBBUBUBBUUUUUUUBUUUUBBUBUUU
UUUUUUUUBUUBBUUUUUBBUUUUBUBUUUBUUUUUBUBBBUBUUUUBUUUUUBUUBBBBUUUUUUBUBUUBUBUUUBUUUUUUBUUUUBUUBUBUUBUUU
UUUUUBUBUBUUBBUUUUBUUBBUUBUBUUUUUBBUBUUUUUUUUBUBUUUUBUUBUUUBUBUUUUBBUBUUUBUUUUUBUUBUUUUUUUUBBBBUUUUUU
