UUUBBUUBBBUUUUUUUUUUUBUUBBUUBBBUBUUUUBUBUUUUUUUBUUUBUUBBUUUUUUBBUUBUBUUUBUUUUUBBUUUUUBUBUUBUUUUUUUBUU
BUUUUBBUBUUUUUUUUUUBBUBBUUUUUBUUUUUUUBUUBBUBBUUBBUUUUBUUUUUBUUUUUBUUUBUUBBUUUBBUUUBUBUBUUBUUUUUUUUUUB
UUUUUBUUUUBUBUUBUBBUUBUBBUUUUUUUBBBUUUUUUUUUBUUUUUUUUUUBUUUUBBUBUUUUUUUUUUUBUUBUUUUBUBUUUBUUUBUUUBUUU
BUUUUUBUUUBUBBBUUUUUUBUUUUBUBUUUBBUBUBUBUUUUUBBUBUUUBUUBBBUBBUUUUUUUBBUUBBUUBUUUUUBUUBBUBBUUUUUUUUUUU
BUBBUUUUUUBUUBUUUUUUUUUBUUUUUBUUUBUUUUUUUBUUUUUBBUBBUUUUUBBUBUUUUUUUUUUUBBUBUBBUUUBUUUBUUBUUUUUBUBUUB
UUUUUUBUBUBUUUUUUBUUUBBUUBUUUUBUUUUUUBUUUUUBUUUUBUUUUUUBUUUUBBUBBUBUBUBUUUUUUUUBBUBUUUBUBUBUBBUUBUUUB
BUUUUUBUUUUUUUUUUUBBUUUUUUUBUUUUUBUBUBUBBUBUUUUUUUUUUUBBBUUUUUUUUUUUBUBBUUBUBUBUUUUBBBUUUUUBUBBUBBBUB
UBUUUUUBUUBBBUUUUBUUBBUUUBBUUUUUBUUUUUUUUUBUUBUUUUUUUUBUBUBUUBUUUUUBUBUUUBUUUUBUUBUBUUBUUUBUUUUUBBUUU
UBUUUUBUUUUUUUBUUUUUBUUUBBBUUBUUUBUBUUUBUUBUUUUUUUUBBBUUUUBUUBUUUUBUUUUBUBBUBBUUUBBUBUUUUBUUUBBBUBBUB
BUUUBUUUUUUUUUUBBUUUBUUUUUBUUUBUUUUUUUUBUUUUUUUUUUUUUUUUUUBUUUBUBUUUBUBUUUBBBUUUUUUUBUUUUBBUUUUUUBBUB
UUBUBUUUUUUBUBUUUBUUBUUUUUBUBUBBBUUUUUUUUUUBUBUUUUUBUUUUBUBBUUBUUBBUUUUUUUBBUUUUBUUUBUBUBUUBUUUUUUUUU
BUUUBUUBUUUUBUUUUBUUUUUUUUUBBBBUBUBUUUUBUBBBUUUUUBUUUUBBUUUUUUUUUUUUUBUBUUUUUBUUBUUUUUBUUUUBBUUUUBUBU
UUBUBBUUUBUUUUBBUUUUUUBBBBBBBBBUUBBUBBUBUUBUBBUUUUUUUUUUUUUUUUUUUUUUUUUUUUUBBUUUUUUUUUUUUUUUUUUBBUUUU
UUUUUUUUBBUUUUBUBUBBBUUBUBUUBBUUUUUUUUUUBBUUUBBUBBBUBBUUBBUBUUBUUUUUBBBUBUUUUBUBUUUUUUBUUBUBUBUUUUUUU
UUUUUBUUBUUUUBUBUUUUUBUUBUBUUUUUUBBBUBUUBUUUUBBUUBBUBUUUUUUBUBUUUUUUUUUUUBUUUBBUUUUBUUBUUUBUUUUUUUUUU
UBUUUUUUUBUUUUBUUUBUUUUUUUUUBUUBUBUUUUUBUUBUUUUUUBUUUBUUUUUBUBUBUBBUUUUBUBUUBUUUUUUUBUUUUUUUBBUUUUUUB
BUUBUUBUUUBBUUUBBBUUUUUUBUUUUUUUBUUBBBBUBUUBUBUUBUUBUUUBUUUUUUUUUBUBUBUUUUUUBUUUBUBBBUUBUUUBUBUUUUUUU
UUBUUUUUBUUUUUUBUBUUUUBUBUUUUUBUUUBUUUUUBBUUUUUBUUBUBBBUUUBUUBUUBUUUUUUUUUUUBUUUUUBBUUUUUUBUBUUUUUUUU
UBUUUBUUBUUBUUUBBUUUUUUBUUUBUBBUBUBUUBUUUBBUUUUUBUBUUBUUUBBUUBUUBUUUBBBUBBBUUBUBUUUUUUUUUUUUUBUBUBUBU
UUUBBBBBUBBUBUBUUUUUBUUUUUBBUUBUBUBUUBBUUUBUBBBBUUBUUUUBUUUUUBUBUUUUUBUBBUUUUUUUUUUUUBUBBUBBUUUUUUUUU
UBUUUBUBUBBUBUUUBUUUUUUUUBUBUUUUUBUUUUUUUUUBUUUBUUUUUUUUUUUUUUBUUBBUUUUUUBBBUBUUBUUBUBUBUUBUUBUUBUUBB
UBUUUBUBBUUUBUUBBBBUUUBBUUBUUUUBUUBUBBUBBUBUUUUBUUBBUUUUUUUUUUUUUBUBUBUUUUUUUBUBBUUUBUUBUBUBUUUBUUUUU
UUBBBUUBUBUUUBUUUUUUUBUUBUUBBUBBBUUBUUUUUUBBUUUUUUUUUBUUBUUUUUUBUBBUUBBUBUUBBUUUUUUUUUUUUUUUUUBUUBBUU
UBBBUUUUUUUUUUUUUBUBBUUUBUBUBBUUUUUBUBUUBUUUUUUUBUBUBUUBBUBBUUUUUUUBBBBUUBUBUUUBUUUBUUUUUUUUUUUUUBUUB
UBUUUUUUUBUUUUUBUUUBUBUUBUBUUUBBUBUBUUBUBUUUBUUUBUUBBUBUUUBBBUUUBUUUUBUUUUUUUUUBUBBUUUBBUBUUUBBUUUUUU
UBUUUUUUUUUUUUUBUBBUUUUUUUUBBUBUUUBUUUUBBBUUUBBUUBUUUUUUUUBBBUUUUUBUBUUUUUUBUUBBBUUUUUUBUUUUUBUUUBBBU
UUUBUUUUBUUBBUUUUUUUUBUBUBUUUUBUUUUUUUBUBBUUUBUUUBUBBUUBBBUBUUUUBBUUBUUUBBBUUUUUUUBBUUBUBUUBUUUUUUUBU
UUUBUUUBUUUBUUBUBBBUUUUUUUUUBUBUBBUUUUUUUBUBUUBUUUUUUBUBBUUUUBBUUUUUUUBBUBBUBBUUUUBUUUBBUUUUUUUUBUBUU
UBUUBUUUUUUUUBUUUUBUBBUUUBUUUUBUUUUBUUBUUUUUBBBBUUBUUUUUUBBUUUUUUUUUUUUUUUUBUBBUUUBBUUUUUUUUUUUUUUBUU
UUUBBBUUBUUBUBUUBBUUUUUBBBUBUUUBUUUUUUUBBUUUBBUBUBUUBUUBUUUUUUUUUBUUUUUUUUBBUUBBUUBUUUUUBUUUUUUUUBBUU
UBUUUUBUUUUUUUUUUUUUUUUUBUUUBUUUUUBUBUUBBUUBUBUUBUBUUUUBUUUUUUUUUUUBUBUBUBUUUBUUUUUBUUUBUBBUUUUUBBUUU
BBUUBBBBUUUUUBBUUUUBUUUBBUUUUUUUUBBUBUUUUBUUBUUUUUBBUUBUUBBUUUUBUUUUUBUUBBUUUBUBUUUUUUUUUUUUUUUBUBUUU
BUUUUUUUBUUUUUUUUUBUBBBUBUBUUBUUUUBBUUBBUBUBUUUBUBUUUBUUUUUBUBBBUUUBUUUUBUBUUUUBUUUUUUBBBUUBUUUUBUUUU
UUBUUBUUUBBUUUUUUUBUUUUUBUUBUUBBUUUUUUUBBUBUUBUUUUBUUBBUBUBBUUBUUUUUUUBUUUUUUUUBUUUUUBUUBUUBUBUUUUBBU
BUBBBBUUUUUUBBUUBUUUUUBBUUUUBUUUBUUUUUUUUUUBUUBUUUUUUUBUBBBUUUUUBUUBUUUUUUBBUBBUBUUUUUBBUUUUUUBUUUUUU
BUUUUUUUUUBUUUUUBBUUUUBBUBUUBUBBUUBUUBBBUUUUBUUUBBUUUUUUBBBUUUUUUUBUUUUBUBBBUUUBBUBUUUBBUUBUBUBUUBUUU
UUUBBUUUUUUUUUUBBUBUUUUUUBUUUUBBBUUUUUBUUBUUUUBBBUBUUBUUUUUBBUBUUUUUUBUUUUUUBUBBUUBBUBUBUUUBUUBUUUUBU
UUUBUUUUUUUUUUUUBUUBUUUUBBBBUUBBBBUUBUBUUUUBUBBBUUUBUBBBBUUUBBBUBUUUUBUUUBUUUUUUBUBUUBUUUUUUUUUUBUBUU
UBUBUBUUBUUUUUUUUUUBUUUBUUUUUBBBUUUUUUUUUBUUUUBUBUUUUUUBUBUUUUBUBBUUBUUBUUUUUUUBUUUUUBBUBUBUBUUUUBUUU
UUUUUUUUUUBUUBUUBUUBUUBUBUBUUUUUUUUUUUBUUBBUBUUBUUUUUBUBUUBUUUBUUUBUUUUUUUUUUBUBUUUUUBUBBUUBUUUBUBUBU
UUUUUBUUUUUBUUUBUUUUUUBUUUBBUUUUBUBUUUBUBUUUUBUUUBUUUUUUUUUUUUUBUUBUUUBUUBUBUUUUUUUUUUBBUUUBBUBBUBUBU
UBBUBBBUBBUBBUUUUBBUUUUUUUUBUUUUUBUBBBUUUBUBUUBUUUBUBUUUUUUUUUBUBUBBBBBBUBUBUBUBUBBUUUBUUBBBUUUUBBBUU
UBBUBUBUUBUBBUUBBBUUUBUUBBBUBUBBUUUUUUUBBUUUUUUUUUUUUUBBUUUUUUUUUUUBBBBUBUBUUBBUUUBUUUUUUBUUUUBUUUUUB
UUUUUUUUUUUUUUBBUUUUUUUBUUUUUUBUUBUBUBBUUUUUBBUUUUUBUUBUBBUUUBUUUUUBUUUBBUUUUUUBUBUUUUUUUUUBBUBBUUUUB
UUUUUUUUUUBUBBBBUUUUUUUBUUUUBUUUUUBUUUUUBUUBBUUUUUUUBBUUUBUUUBUUUBUUBUUBUBUBUUUUUBBBUBUUUUBUUUUUUBBBU
UBBUUUBUUUUUUUUUBUBUBUUUUUBUUUUUUBUUBBBUBUBBUUUUUUUBUUBUUBUUUUUUUUUUUUUUBUUUUUUUUUUUUUUUUBUUUBBUUUUBB
BBBBUBUUUUUUUBBUUUUUUUBUUBUBBUUBBBUUBUUUUBBUUBUUUBUBBBUBUUUUUBUUBUUUUUUUUUBBUBUUBUUUUBUUUUUBBUUBUUUBU
UUBBUUBBBUUBBUUUBUUBBUBUBUBBUBUUUUBUBUUBBBBUUUUBBBUUBBUBUBUBUUBUBUBUUBUBUBUUUUUBUBUBUBBUUUUUBBUUUBUBB
UUUBUBUUUUUBUBUBUUUUUBBUUUUUUBUBUUUUUUUUBUUBUUUBBUUUUUUBUUUUUUUUUUUUUUUBUBUUBBUUBBBUBBBUUUUUUUBUUUUUB
UUUUUUUUBUUUUUBBUBUUUBUBUBUUBUUUUUUUUUBBBUUUUBUBUBUUBBUUUUBUUUBUUBUUUUBBBUUUBUBUUUUUUUBBBUUUUUUUUBUUU
UUUBUBUUBUBUUBUBBUUUBUBUUBUUUBUBUUBUUBUUUUUUBBUBUUUUBBBUUBUUBUUUBBUBBUUUUBUUUBUUUUUBUUUBUUBBUUUUBUUUB
BUUUUBUUBBUUBUBUUUBUBBBUUBUUUBUUUUUUUBBUUBUUUUBUBBUBUBUUBUBUUUBUUUUUUBUUBUBUBBUUUUUUUBBUBBUBUUUBBUBUB
UBBUBUBUUUUUUUBBUUUUBUUBBUUBUUBBUUBUBUUUUUBUBUBUUUUUUBUBUBBBUUUUUUUUUUUUUUBUUBUUUUBBUBBUUBUUUUBUBBUBU
BUUBUBBUBUUUUUBBUUUUUBUUUUUBUUUUUUUUUUBBBUUBUBBUUBBUUUUUBUUUBBBUUUBUUUUBUBBUBUUUUUUBBBUUBUBUUUBUUBBBU
UBBBUBBBUUUUBUUUBUUUUUBUUUBUUUUUUBUBUUBUUBBUBUBUBUBUBUUUUUUUUBUUUUBBBBBUUUBUUUBUUUBUBUBBUUBUUUUBUUBBB
UBUBUUUBBUUUBUUBUUUBBUUUUUBUUUBUUUBUBUBUUUBUUUUBBBBBUUBBUUUUBBUBUUUBUUBUUBUUBUUUBUUUBBBUUUUUUUBUUUUBB
UUUBUUBBBBUUUUUBUUUUUBBUBUUUUUUUBUBUUUUBUBUBUUUUUUBUUUUBBUBUUUUUUUBUUUUUUUBUUUBUUBUUUUUBUUBUBBUUBUUBU
UUUUUUBUUUUBBBUUUUUUBUUUBUUBBUUBBUUUUUUUUBUUUBBBUUBUUUUUUUUUUUUUBBUUUUUBUBBUUUBUUBBUBUUBUUUUUBUUUUUUB
UUUBUBUBUBUUBBUUUUBBUUUUUBUUUUBUUUUBBUUBUUUUUBBBUUUUBUUUBUUUUBUUUUUUUBUUUUBUBUUUUUUBUUBUBBUUBUUUBBUUU
UUUUUUUBUUBUBBUUUBUUUUBUUUUUBUUBBBUUUUBUUBUUUUBUUUUUUBUBUUUUBUUUBBUUUUBUUBUUUUBUBBBUBUUUUUUBUUBBUUUUU
UUUBBUUUUUBUUBUBUUUUBUUBUUUUUUBUBBUBUUUUBBUUBBBUUUUBUUUUBBUBUBUBUUUUUUBUUUUUUUUUUBUUBBUUBBUUUUUUBBUBU
UUUBBUBBUUUBBUUUBUUBUBUUBBUUBUUUUUUUUUUUBUUBUBUUBBUUBUBUUUUUUUBUUUBUBBBBBUUBBUUBUBUUUUUBBUUUUBUUUUUUU
BBUUBUBBUBBUUBUUUBBUUBUUUUBUUUBBUUBUBBUUBBBUUUBBUUUUUUUUUUBUUUUBUUUUUUBUUUUUBBUBBBUUBUBUBUUBUBUBUUUUU
UBBBBBUUBUBUUUUUBUUUBUUUBUUUUUUUBBUBUUUBBUUUUBUUBUUUUBUUUBUUBBUBUBUUUUUUBUUBUUUBUBUUUUUBBBUUUUUUUBUUU
UBUBUUBUUUUUBBBUUUBBUBUUUBBUUUBBUUUUUBBBUUUUUUUUUBUUBUBUUUUUBBUUUUBUUBBUUUBUUUUUUUUUUUUBBUUUBBBUUUBBB
BUBBBUUBUUUBUUUUUUUBUBUBBUUUUBUBUUUBUUUBUUUUUBUUUUBUUBUUBUBUBUUUUBBBBUUUBUUUUUBUBUUBUBBBUUBUUUBUUBUUU
UBUUUBBBUBUUUUBBUBUUUUUBBUBBBUUBUUBBUUUUBUUUUUBBUBUUUUBUUUBUUBUUUUUBUUUUUUUUUUBUUUBUUUUUUBUUUUBUBUBBU
BUUUBUBUUUUBUUBUUBUBUUBBUBUUBBUBBUBUUBUUUUUBBBUUUUUUUBUBUUUBUUBBUUBUBBUBUUUUUUUUUBUUUUUUUUUUUUUBBUUBU
BUUBUBUUUBUUUBBUUBUUUUUUUUUBUUUBUUUBUUUUBUUUUBBUUUUBUUBBUUUUUUBUBUBUUUBBBUUUBUUBBUUBUUUUUBUBBUBBBBUUB
UBUUUUUUBUBUBUBUUUUUUUUBUBUUBUBUBUUUBUUUUUUBUUBUUUUUUBUUUBUBUUUUUUUBUUUBUBUBUUBUUBUUUBUUUUBUUBUBUUBUB
UUBUUUUBUUUUUUUUUUBUUUUUUUUUBBUUUUUUBUUUBUUUBBUUUUUUUUUBUUUUUUBUUUUBUUUUUUUBBUUUUUUBBUUUUBUUBUBUBUUUB
UUUUUUUBUUUUBUUUUUBUUUUUUBUUUUUBUUUUUBBUUUBBUBUUUUUUUBBUUUUUUUUUBUUBBBUBUUUUUUUUUBBBBUBUUUUBUUUUUUUBU
UUBUUBUBUBBUBUUUBUUUUBUUBUUUBUBUUUUBUBUUBBBUUUUUUUUBUUUUUUUBUUUBBUUUBUUUUUBUUUBUUBBUBUUBUBUUUUUUBUUUU
BBBUUUUBUUUBBUUUBBBUBUBBBUUUUUUBUBBUUUUUUBBUUUBBUBBUBBBBUUUBBUUUBBBUUUUUUUUBBBBUUUUUUBUUUBUUBUBUUUUBB
UUUUUUUUBUUUBUUUUUUUUBUUUUBBBUUBUUUUUBBUUBUUUBBUBBBUUUUUBUUBUUUBBUUUBBBUUUUBUUBUUUBUUBBUUUUUBUBBUBUUB
UUUUUBBUUUUUUUUBBUUUUBUUBUBBBUUUUBUUUBUUBUUUUBBUUBUUBUUUBBUUBBUUUUUUUUBBUBUBUUBUUUUBUUUUUUUUUUBUUBUBU
UUUBBUBUUUBUUBBUBUBBUUBBBBUBBUUBUBUUBBBUBUBUUUUUBBUUUUUUUUUUUBUUBUUUUUUUBUBUUUUUBUUBUUBBBUBUBUUUBBUBU
BUBUBUBUUUUUUBUUUUUUBUBUUUUUUUUUUBUBBUBUBUBUUBBUUUUBBUUBBUUBUUUUUUBUBUBUBBBBUBUUBUBUUUBBUBUUBUUBBUBUB
UUBUUUBUUUUBUUUUUUUUUUBUUUBUUBBBUUUUUUUBUBUUUUUUUBUUUUUUUUUUUUUUUBUBUUUUUUUUUUBUUBUUUUUUUUUUUBUUUBUUB
BUBUBUBUBBUUUUUBBBUBUUUUUUBUUUUBUUBUUUUBUUUBBUBUUUBBBBUUUUUUUUUBUUUUUUUUBUUBUBUBBUBUUBUUBUUBBBUUUUUUU
UBBBUUUUUUBUBBUBBUBUUBBUBUUBUUBUUUUUBUUBBUUBUBUUBUBBBUBBUUUUBBUUUUUBUBBBUBUBUUUUUUUUBUUBUBUUUBUBBUUUU
UBUUUUUUUBUUUUUUUUUBUUBUUUUUUUUBUUUUBUBBBUUUUBUUUBUBUUBBBUUUBUUBUUUUBUUUUUUUUUBBUUUUBBBUUBUBUBUUUBUUU
UBBBUBUBUBUUUUBUBUUUBUBBUBUUBUBUBBUUUUUUUUUUUBBUUUUUUUUBBUUUUUBUBUUUUBUUUBBUUUUUBBUBBUUUUUUUUBUUUUUUU
BBBBUUBUUUUUUBUUUBUBBBBUUBBBUUBBUUUBUBUBBUUUBUUUUUUUUUUBUUUUUBUBBUBUUUUBBUBUBUUUUUBUUUBUUUBUUBUUUUUBU
UBUUBUBUUUUUUUUUUBUUBUUUBBBBBUUUUUBBUUUUUUBUUUUUUUUUUBUUBUUUUUBBUUUBBUUUUUBUUUBUBUUUBBUUBUBUUBUUUUBUU
UUBUUUUBUBUUUBUUUUBUUBUUUUUUBUUUBBUUUUUUUUUBBUBUUUBBUBUUUUUBUUBUUUUBUUBUBUUUUBUBUUUUUBUUBBUBUBBBUUBUU
BBUUUBBBUBUUBBUBUBUUBBUUUUUBUUUBUBUBUUUBUUUUUUUUBUUBBBBUUBUUUUBUUUUBUBBBBUUUUBBBUUUBUUBUUUUBBBUUUUUBU
UBUBUUBUUUBUBUBUBUUBUUUUUUBUBUUUBUUUUUBUUBUUUUUUBUUUUUUUUUBUUUUUUUUBUBUBUBUUUUUUUUUUUUUBUUUUUUUUBUUBU
BUBUUBUUUUUUUBUUUUUUUUBUBUUUUUBBBBUUUUUBUBUUBUUUUBUBBUUBUUUBUUBUBUUBBUBBBUUUUUBUBBUBUUBUUBBUUUUUUBBUU
BUUBUBBUUBUUBUUBBUUUUBBUUBBUBUBBBBBUUUUBUUBUBUUUUBUUUUUBUUUBUUBBBUUUUUBUUUUBBBBUBBBUUUUUBUUUBUUUUBBUU
UUUBUUBUUUUBBUUBUBBBBBUUBBUUUUUUUBUUUUBBUUUBUUBUBUBUUBUBUUBUUUUUUBBUUUUBBUBUBUUBUUUUUUBUUUBBUUUUUUBUU
UBUUBBUUUBUUUUUUBUUBUUBUUUUBUUUUBBUBBBBUUUBUUUBUUBBBUBUUUBUUUBUUBUUUBUBUBBBBBBBUUUBUUUUUUBUUUUUUUUUUU
BUUBUUBUUUUUBUUUUUBBUUUUUUUUUBUBBUUUUUBUBUBUUUUUUUUUBUBUUUBUBBBBUUUUUUUUUUBUBUUUBUBBUBUBUUBUUUUBBUUUU
UBUBUBBUUBUUBUUUUUUBUUUBUUBUUUBUUBUUUUUUUBUUUBUBUUUUBUUBBUUUUUBUUUUBUUBUUUUUUUBBBBBBBBUUBUBBUUBBUUUUB
UUBUBUUUUBUBUUUBBUUBUBUUUUUUUBUUUBUUUUUBUUUUUUUBUBBUUBUUUUUUUUUUUBUUUUUUUUUUUBBBUUBBUUUUUUUUUUBUUUUBB
UUUUBUUUUUBUBUUBUBUUUUUUBUUUUUBBUUBUBUUBBBBBBUUUBBUBUUUBUBUUUUBUUBUBUUUUBBUUBUUUUBUUBBUUUUUBUUBBUUUUB
BBBBBUBUUUUBUUUBUUUUUBBBUUUBBUUBUUUUBUBBUUBUUBUUUUUUUUUUUUBUBUBUBUUUBUUUUUBUUUUBUUUBBUBUUUUUUBUUUUUBU
BUUUUBUUBUBBUUUUBUUUUUUUUUUUUUUUUUBBBUUUUUUBBBUUUUUUUUUUUUUUUUUBUUUUUBUBBUUUUBUUUUBUBBUUUUUUBUUUBUUBU
UUUUUUUBUUBUBBUBUUUBUUBUBUBUBUUBUBBUUUUBBUUBUUBBBBUBBBUUBUUUUUUUUUBUUUUUUUUUBUUUUBUBUUUUUUUUBUBUBUUBU
BUUUUBUUUUBBUBBBUUBUBBUUUUUUBUBUBBUUBUUUBUUBBUUUBBUUUUUUUUUUUBBBBBUUBUUUUBBUBUBUUUBBUUBUUUBUUBUUBUUUU
UBUUUUUUUUUBUUUUUBBUUUBUUUUUUUBUUUBUUUUUUUUUBUBBUUUBBUUUUBBUUUBUBUUBUUBBUUBUBBUUUUBBUBUUUBBBUUUUUBUUU
