UUUUUUUUUUUUUBUUBBUUBUBBBUBUBUBUUUUUBUBUUUUUUUUBBUUUBBUUUUUUBUBUUBUBUUUBBUBUUUUUUBUUUBUUUUUUUUUUBUBBU
UUUUUUUUUUUUBBUBUUUUUBUUUUUBUUBUUUUBUBUUUUUUUUUUBBUUUUUBBUUUUUBUBBUUUUUUUUUUBUUUUBUUBBUBUUUUUUBUBUBUU
BUBBUUUBBUUUUBUUUUUUUUUUUBUBBUUUBBUUUUUUBUBUUBUUUUUUUUUBUBBUBUUUUUUUUBUUUUUBUUBBUUUUUUUBUUUUBBUUUBUBU
BUUUUUUUUUBBBUUBUBUUBUUUUUBBBBUUBBUUUBBBUUUUBUBUUUUUUUUBUUUBUBBUUBUUUBUBUUUBUUBUUUBUBUUUUUUUBUBBUUUUU
UUBUUUUUUUBUUBBUBUUUBUUUUUUUUBUUBUBUUUUUBBUUUUUUUBUBBUUUUBBBBBBUUUUUUBUUUUUUUBUUUUUUUUBBBBUUBUBUUUUUB
BUBUUUUBUBBBUUUBUBUBUBUUUUBBBUUUBBUBUUBBUUBUUUBUBUUBBUUUUUBUUUBUUUBUUUBUUUUUBUBUUBUBUUUBUBUBUUBUUBUBU
UUBUUUBUUUBBBUBUUBBBUBBUUUUUBBUBUBBBUUUUUUUUUUUBBUUUUUBUBUBBBBUUUUBBUUUUUUBUUBUUUUUUUBBUBUUUUBUBUUUUB
UUBUUUUUUUUUUUUBUUBUUBBBUUBBUUBUUBUUBUBUUBUUBUUUBUBUBBBUUUUUUUBBUUUUUUBUUUBBUBUUUUUBUUBBUBUUBUUUUUUUU
BUUBUUUUBUUUUUUBUBUUUUUBBBUUBUBUUBUUUUUUUUUUUBBUUBUBUUUUBUUUUUUUUUUUUBUUUUUBUBUUUUUUUUUBBUBUUBUUBUUUU
UBBUUBUBBUUBUBBBBBBBUUBUUBUUUBBUUUBBUUBUUBUBUUUBBBUBUUUUBUBUBBUUUBUUUUUUUBUUUUBUUUUUBUUUUBBUUBBUBUUUU
UUUUUBBBBUUUUUUBBUUBUBUBUUUUBBUUUBUUBBUUBUUUUUUUUUBUUBUUUUBUBUUUUUUUUUUUUUUUUBBBUBBUUBBUUUUUBBBBUUUUU
UBUUUUUUBBUUUBUUBUUBBUUUBUUUBBBUUUUBUUUUUBUUUUBUBUUBBUUBUUUUBBUUUUUBBBUBBUBUBUUUBUUUUUUUUBUUUBUBBBUBU
BUBUUUUBUBUBUUBUBUUBBBUBBBBUUUUBBUUBUUUUBUBUBUUUBUUUBBUUUUBUUBUUBUUUUBUBUBUUUUUBUBBUUBBUBBUBUUUBUBUUU
BUUBBBBBBBBUUUBUUUUBUBUUUUBUUUUUUUBUUBUUUUUBUUUUBUUBUUBUUUUBBBUUUUUUBUUUBUBUBBUUUUUUUBUBUUUBUUUUUUUBU
UBBUUUUUUUBBBUUUUUUUBUUUUUUUUBUUUUUUUBBBUUUBUUUUUUBBUUUUUBUUBUUBBBUBBUUUUBUUBUUUBUUUBUUUUUBUUBUUUBBUU
UUUUUUUUUBUBBUUBUUUBUBBUUUUUBBBBBBBUBUBUBUUUUUUBBBBBUUBUBUBUUUBBUBUUUBUUBUUUUUUUUUUBUUBBUBBUBUBUUUUUU
UUBUUBBUUUUBUUUBBUUUBUUBUUUBUUBBUUUBBBBBUUUBBUUUUUUUBUUUUUUUUBUUUBUUUUUUUUUUBBUBUUBBBUUBUBBUUUUBUUBUU
UUUUUBUBUUUUUBUUUUBUUUUUBBBUBUBUUUUBBBUBBBUUBBBUUBUBBUUUBUUUUBUBUUUUUUUUUUUUUUBBUBBUUUUUUBUUBBUUUBUUU
UUUBUUBUBBUUUUUUUBUUBUUUUBBUUBBUUUBUUUUBUUUUBUUUUBUUUUUUUUBBUUUUUUUUBBBBUUBBUUUUUBUUUUBUUUUUUUUUBUUUU
UUUUUUBUUBUUBUUUUBUUUUBUUUBUUUUBUUUUUBUUUBUBBBUUUBUUBUUUUUUUBUUBBUUBUUUUBBUUUUUUUUBUUUUBBUBBUUUUBUUUB
UUBBUUUBUUUBUBUUBBBUUUUUBUBUBUUBUUBUUBUUBUUBUBBUUBUUUUUBUUUUBUUUUBUBBUUUUBUUBUUUUUUUBUUUUUUBBUUBUBBUB
BUBUUUUUBUUUUUUUBUUBUUUBUUUUBUUUUUUUUUUUUBUUUBUUUUUUUUUUUBBUUUBUUBUBUUUBUUUUUBBUUBUBUBUUUBBBUUBUBUUUU
UUBUBUBUUUUBUUUUBUUUUUUUUBUBUBUBUUUBBBUBUBBBUBUUBUUUUUBBBUUUUBBUUBUBUUUUBBUBUUUUUBBUUUUUBBUUBUBBBUBUU
BUBUBUBBBBBUUBUBUBUUUUBUUUBUUBUUBUUBUUUBUUUBUUUUUUBUUUUUUUUUUBUBBUUUUBUBUBBUBUBUUUBUUUUUUBBUUUBUUBUUU
BUUBUUBUUBUUUUBUUUUUBUUBUUUBUUUUUBUUUBUUBUBUBUUUUBBUUUUBUUUUUUUUUUBBUBUUUBUBUUUBUUBBUUUUUUUUBUUUBUBUB
UUUBUBUUUBUUUUUUUBUUUUUUUUUUUUBBUUBUBBUUBUBBBBUUUUUUUBUUUUBUUBBUBUUBBBUBUBUUUBUUUUUUUUUUBUUBUUUBUUUUU
BUUUBBUUUUUBBUUUUUUUUBUBBBBBBUUUBUBUBUBUUUUBUUUBBUUUUUBUUUUUBBUUBUUBBUUUBUUUUUUUBUUUBBBUUUUBBBBUUUBUB
UUUBUUBUUBUUBBBUBBBBBUBUBBBUUUBUUUUUUBUUUUUBUUUUBUUUBBBUUBBUBUUBUBBBUBBBBUUUUUUUUUBUUUUBBUUBUUUBBBBUU
UUUUUUUUUUUUBUUUUUUUUBUBUBUBUUUUUUUUBUUBUBUUBUUBUBBUBUBBUUUUUBBUUBBUUBUUUUUUUUUUUUUUUBUUBUUUBUUBUUUUU
BUUUUUUUUUUBBBUUUUUUUUUUUUUUUUUUUUUUUBBUUUUUUUBUBUUUUUBBUBUUUUUUUUBUUUUUBBUUUBUUUUUUUBUUUUUUUBBUUUUUU
UUUUUUUBBUUBBBUBUUUUBUBUBBUUUUUBUUUUBBUUUUUBBUUUUBBUUBBUUBBUBUUUUUUUUUUUUUUBUUUUUUUUUBBUUUUUBUUBUUBBU
UUUUUUUUUUBUBUUBBBUUUUBBUUBUUUBBUBUUBUUBBUUUBUUUUBUUUBUBBBBUBUUUBUUBBUUUUUUUUUBUBUUUUUUUUUBUUUBBUBUUU
UUBUUUUUUBUBUUBBBBUBUBUUBUUUUUUUUUUUUBUBUBUUUUUUBUBBBUUBUUUUUUBUBBUUUUBUBBUUBUBBUUUUUBUBBUUUBUUUUBBBU
UUUBUBBUUUBUUUUUUUUBUUUUUBUUBUUUBUUUUUBBUUBUUUUUBUUBUUUUUBBUUUUBUUUBUUUBBUUBUBBUBUBBUUBUUUUUBUUBUBUUB
UBBUUUUUBBUUBBBBUUBBBUUUUUUUUBUUUUUBUUUUUUUUBUUBUBBUBUBBUUUUBUUUBUUUBUUUUBBBUUUBUBUUBBUUBBUUUUUBBBUUB
UUUUUUUUBBBBUBBUUUUBUBBUUUUUUUUBUUBUUUUBBUUUBUUUUUUBUUUUUUUBBUUUUBUUBUBUBBBBUUUUUBUUBUUBBUUUUBBUUUUUU
BUUBBUUBUUUUUUUUBUUUBBUBUBBUUBBUUUUUUUBUUBUBUBUUUUUUBUUUBUUUUUUUUBUUUUUUBBBUUUBBUUUUUUBUUUUUBUUBBUUUU
BUBBUBBUUUUBUUBUUBBUUUUUBUUBUUBBUUBUUBUBUUBBBBUUUUUUUUUUBUBUBUBBUBBUBUBUBUUUUBBBUUUUUBUUBBBUUUBUBUUBB
UUUUUUUUBUUUUUBUBUUUBUUUUUUUBBUBBBUUBUUUBUUUUUUUUBUUBBUUBUUUUBUUUUBUUBUBUUUUUBBUUBUBUBUBUUBUUUUBBUUUU
UUUBUUBUUUBBUUUUUUUUUUUUUUUUUUUUBUUUBUUUUBBUUUBUUUUBBBBBUBUUUUUUUUBBBUUUUUBBBBUUUBUBBBUUUUBUUBUUUBUUB
BUBUBUUUUUBUUBUUUBBUBUUUBUUBBUUUBUUBUUUUBBUUBUUBBBBBUBUBUUUBUBUUBUUUUUUUUUUBUBUUUUUUUUUBUBUUUBBUUUUUU
UUUUBUUUUUUUUUUBUUUBUUUUUUUUBUUUBUUUBUBBUBUUBUBUUUUUUUUUUUBUUUUUUBBBUUUUUUUBUBUUUBBBUUUUUBUUUBBBUUUBU
UUUUUUUUUBUBUUUUUUUUUUUUBBUUUUUBBUUUUBUUBUUUUUUUUBUBUBUUUUBUUBUBUUUUUBUUUBUUUBUUUUUBUUBBUUUUUBUUBUUUB
BUUBUUBUBUUUUBBUUUUUUUBUUBBUUUUBUUBUBBUBUUUUUUBUBUUUUUUBBBUUBUBUBUUUUUUUUUBUBUBBUUUUUUUUBUBBUUUUUBUBU
UUUUBUBBUUBBBUUBUBBBBBUUUUUUUUBBUUBUUUUUBUUUUUBBUUBUUUBBBBBUUUUUUBUUUBBUUBBUUBBUUUBUUBUUUUUUUUUUUUUBU
BBBBUBUUBUBUUUUUUBUUUBUUUUUBUUUBUUUUBUBUBUUUUUBUUBBUUBBUUBUUUUBBBUBUUUUBBUBBUBBUUBBUUBBUUBUBUUUUUBUBU
UUUUUUUUUUBBUUBUUBUUBUUUUUUUUBBUBBUUUBUUUBUUUBUBUBBBBBUBBBBUUUUBUUUBUUUBUUUBBUUUUUUUUUUUBBUUBUBUBBUUU
BUBUUUUUUBUUUUUUUUUBBBBUUUBBUUUUUUUUUUUUUUUUUUUBUBBUUBUBUUUUUUBUUUBUBBUBUUBUBBBUUUBUUUUUUBBBUBBBBUUUU
BUUUUUUUUUBBUBBUUUUUUUUUUUUUUUBUUUUUBUBBBBUUUBUUUBBUUBBUBBUUUUUUUUUUBUBUBUBBUUUUBUBBUUUUBUBUUUUUUUUBB
BUBUUUUBUBUUBUUBUBUUUUBUBBBBUBUUUUUUUUBBBUUUUUBUUUBBBUUUUUBBUUUUUBUUUBUUUUUBUBBBUBBUUUUUBBUUUUUBBBUUU
BUUUUUUUUUUUBBBBUBBUUUUUBUUUUUUBUUUUBUUUBUUUBUUUUUBUUUUUUUUUBBBBBUUUUBBUUBUUUUUBUUBUUUBUUUBBBUUUUUUUU
BUUUUUUUUUUUUBUUUUUUUUUBUBBBUBUUUUUUUBUUBUUUUUUUBUUUBUBUBUUUUUUUUUUBBBBUUUUUBBUBUUUUBBUUUBBBUUUBBUUUU
UUUUUUUUUUUUUUBUBUUUUUBUBBUUUUUBUBUUUUBUBBBUUUUUBUUUBBUUUUUBUUUUUUUBUBUUUUUUUUUUUUUUUUUUUUUUBUUUUBBUU
UBUUBUUUBBUBUUUUUUBUBUUBUBUUBUBUUUUUUBUBBUBUUUBBUBUUUUUUUBUBUUUUUUBUUBUUUUUUBUUUBBUBBBBUUUBUUUBUUBBUU
UBUUBUBUBBBUUBUUUUBUBBUUBBBUUUBBBUUUBBBBBUUUUUUUBBUUUUUUBBBBBUUUBBUBUUBUUBUUUBUUUBUUBUUUUBUUBBUUBUUUU
BUUUBUBBBUUUUUUBUBUUUUUBUUBBUUBUUBBUUUUBUUUBUUBBUUBUUUUUBUUBUUUUBBUBBUBUUUUUUUUBUBUUUUUUUUUUUUUUBUUBU
BUUUUBUBUUUUUBUUUUUUBUUUBUUUBBBBUBBBUUBUBBBBBUBBUBUUUBUUBUUUBUUUBUBUUUBBBUUUUUBBUBUUUUBUUUUBUUUUUUUBU
BBUUUUUUUUBUUUBBBBBUUUBUUBUUUBUUUUBUUBUBUUUUUBUUBBUUBBBBBBUBBBUUUUUUUUBUUUUUUUBUBBUBUUUUUUBUBUUUBUUUB
UUUUBUBBUBUUBBUUUUUBBUBBUUUUBUUUUUUUUUUUUUUUUUUUUUUUUUUUUUUUBUBUUUUUUBBBBUBBBUUBUBBUBBUUUUBBBUUBUUBBU
UUUBUUUUBUUBUUBUUUUUUBBUUUUBBBBBUUBBUUUUUBUUBUUUUUUUBUUBUUUBUUUUUUUUUUBUUUUUBUBUBUUUBUUUUBBUUUUUUUUBU
UUUUBUUBUUUBUUUUUUUUUBUUBBUUUBBBUBUBUBUUBUBBUUUUUUUBUUUUUUUUUBUUUBUUUBUUUUUUUBBBUUUUBUBUUUBUUUUBUUBUB
UBUBBBBUUUUUUUUUUBBUUUBBBUUUBUBUUUUBBBBBUUBUUUUUUUUUUUBUBUUUUUUUUUUUBUUUBBUBUBUUUUUUBBBBUUUUUUUUBUUBB
UUBBUUUUUBBUBBUUBUBUBUBUUBUUUUUUUBUUUBUUUBUBUUUUBBUUBBUUBUUUUBUBUBBBUBBUBUUUUUBUBUUUBUUUUUUUBBBBUUUUU
BUUUBUBUBUBUUBUBBUBBBUBUBUUBUUBUUUUUUUUBUUUBBUUBUUUUBUUUUUBBUUUBBUBUUUUUUUUUBUUBUUUUBBBBUUUUBBUUUBUUU
UBBUUBBUBBBUUBBUBUUUUBUBUUBUUUUUUUUUUUUUBUUUBUUUUUUBBUUUUBUUBUUBUUUUUUUUUBUBUUUUBUUUUUUUUUUBUBUUUBUUU
UUUBUBBUUBUBUUUUUUUUUBBBBUUBBUUBUBBUUUUBBBUUUUUUUUUBUBUUBUUUBBBUUBUUUUUUUUUBUUUBUUBUBUUUBUUUBBUBBUUUU
BUBUUBUUUBUBBBUUBUUUBBUUUUUUUUUUUUUUUBBUUUBBUBBUUUBBUUUUUUUBUUUUUUUUBUBUUBUBUUBUUUUBUBUUUUBUUUUBBUBUB
UBUUBUUUUUUUUUUUUBUBUBBUUUUUBUUBUBUBBUUBBUBUUBUBBBBUBBBUUUUUUUBUUUUUUUBBUUUUUUUBUBUUBUUUBBUUUBUBBUBUU
UUUUBUUUUUBUBUUBUBUBUUUUUBUUBUUBUUUUBBUUUBUUUBUUBUUUBUBBUUUBUUUUUBUUUUBUUUBUUUBUUUBUUUUUUBBUUUUUUUUUB
UBUBUBUBUUUUUUUUBBUUBUBUUUBUUBBBUUUBUBBUUBBUUBUBBUUUBBUUUUUUBUUBUUUBUBUUBUUUUBBBUUBUUUUUUUUBUUBUUUBUU
UBUUBUUUBUUUUUUUBUUUUBBUBUUUBBUBBBUUUUUBBUUUBUUUUUUUBUUUBUUUUBUBBUUUBUUBBUUUUUBUBUUBUUBUUBUBBUBBBUUUU
BUUUBUUUUBBUUBUUUUBUUUUUBBUUUBBBBBBUBBBUUUUBBUBUUBUUUUBUUUBBUUBUBBUUBUBUUUUUUBUBUUBUUUBBUUUUUBUUBUBBU
UBUUBUBUUUUUUUUUUUBUUUUBBBUUUBUUBUUUUUUBUBUUUUBUUUUUBUUBUBUUUUUUUUUUUUBUBUUUUBUUUUUUBBUBUUUUUUUBBBBUB
BBUBBUBUUBUBBUUUUBUUUUUUUUBUUBBUUUUUUUUUUUBUUBUBBUBUUUUUUUBUUUUUUUBUUUBBBBUUUUUUBUUUUUBUBUUUUUUBUBBUU
BBUUBBBUBUUBUUBUBBBUUBUUBUBBBBBBUUUBUUUUUUBUUBUUUBUUUUUBUUUBUUUUBUBUBUBUUUUUUUUBUUUBUBUUUUUBUUUUBUBUU
BBUUUUBBBUBUBBUUBBUUUUUBBBUBBBUUUUBUBUBBUUUUBUBUBBUUUBUBBUBUUUBUUUUBUUUBUUBUUBUUBUBUUUBBUBUUBUBUBUUUU
UBBUUBBBBUUBUBUBUUBBUUBUUUBUUUBBBUUBUUUUUBBUBUUUBBUUUUBUUBUBUBUBUUBUUUUUUUUUUUUBUUBUUUUBUUBUUBUBBBUUU
BUUUUUBUBBUUUUUBUUUUUUUUBUUUUUUUUUUUBBUBUBUUUUUBUUUBUUUBBUUBUBUUBUUUUUUUBBUUUUUBBUUUBUUUUUUUBUUBUUBUU
UUBUBUUUUUBUBBUBBUUUBBUBBBBUUUUUUUUUUUUUUBBUUBBBUUUUBUBBUBBUBBBBUBBUBUUUUBBUUUUUUBUUBUBUUUUUBBBUUBUBU
UUUBUUUUUBBUUUUBBUBUUUUBUUBUUUUUUBUBUUUUUUBUBUBUUBUUUUUUUUUBUUUUBUUUUUUUUBUBBUUUUUUUBBUBUUUUUUBBBUUBU
UUBUUUUUUBUUUUUUUUUUUBBUBUUBUBUUUUUBUUBUBUUBUBUUBUBUUUUUUUUUBUBUUUUUUUUBUUBUUUBBUBUUUBBUBUUUUUUUUUUUB
UUUBBUUUBUUBUUBUUUUUBUUUBUUUBUUUUBUBBBUUBUUUUUBUBUBUUUUBUUBUBUUBUUUUBUBUUUUUUBUUUUBBUBUUBUUBBUUUUBBUU
BUBUBUUUBUUUUUUUBUUUUUUUUBUBUUUUUUBBBUUUUUUUBUBBUUUUUUUUUUUUUBUUBUUBBBBUUUUBUUBBBUUBBUUUBUUBUUBUUBBBB
UUUUBBUBUBUBUUUUUBBUUUBUUBUUBUUUUUUUUBUUUUUUUUBBUBUBBUBUBUBBUUUBBBUBUUBUUUBUUBBUUUUUBBBUUUBUUUBUUUBUB
UUUUUBUBBUBUUUUUUBUUUUUBUUBUUUUUUUUUUUBUBUBUUUUUBUBBBUUUUBBBBUUUUBUBUUUBBUBUBUUUUUUBUUUBUBUBUUBBUUBBU
BUUUBUUUBBUUUUUUUUUUBUUUBUBUUBBBBUBUUBBBUUBUBBUUUUBBUUUUUBUUUUUBBUUUUUUBBBUBUUUUUBUBUUUBUUBUUUBUUUUUB
UUBUUUUBUUUUBBUBUBUBUUUUUUUUUBUUUUBUBBUBBBBBUUBBUUUBUUUUBUBUUUBUBBUBUUBUUUUUBUUBUUUUUUUUUUBUBUUUUBUUB
BUBBBUUUUBUUUUBUUUBUUUUBBUBUUUBUUUBUUUUUBBUUUBBUBUUBUUUUUUUUBUUUUUUBBUUUUUBUUUUUBUUUUUBUBUUUUBUUUBUUB
UUUUBBBBUUBBBBBUUBUBUUUBUUUUUUUUUUUBUUBUBUUUUBUBUUUUUUUUUUUUBUUBUUBBUBBBUUUUUUUUBUUUBUBUUBBUUUUUBBBUU
UUBUUUBBUUUBUUBUUUBUUUUUUUBUBUUBBUUBBUUBBUUUBUUBUBUUUBUUUUUBUBBUUUBUBUUUBUUUUBUUUUUBUUUBUUUUBUUUBBUUU
UUBUBUUBBUBUUBUUBUBUUUUUUUBBUUUBUUBUUUUUUUUUUBUUBUBUBUBUUBBUBUUUUUUBUBUBBUUUUUBUUUUUUUBBUUUUUUBUUUUUU
UUUBBUUBBUBBUUUUUUUUUBUUBUUUUUUBUUUUUBUBUBBBUBUUBUBBUBUUUUUUUBUUBBUBUBUUBBUBUUUUUBUUUUBUBBBBBUUUUBUUU
UUUUBUBUUBUUUUBBUUUBBBUUBUUBBBBUUBBUUUUBUBBBBUUUBBUBUUUUUUUUUUUUUUBBUUUBUBUUBUUBUBUUBUBUUBUUBUBUUUUUU
BBUBBBUUUUUUUBUBBUUUUUUUBUUBBBBUUUUBBUBBUUBUUUUUUUUUUUUUUUUUUUBUUUBBBBUUUUUBUUUBBBBUBUBBUUUUUBBUBBUUB
BUUUUUUUUBUUUUUUUUUBUUBBBUBBUBUUUBUUUBBBBBBBUUBBBBUBUUUUBUUUUUUUUUUUUUUBBUUUUUUUUUBUUUUUUUUUUUUBUUUUB
UUBBUBBUUBUUUUUUUBUUBUUBUUUBUBUUBUBUUBUUBUBUUBBUBUBUUUUUBUUUUUUUBBUUUUUUUUUUBUUUUUUUBUUUUUBUUBUBBUUBU
UUUUUUUUUBUBBUUUUUUUBUUUUUUBBUUUUBUBUBBUUBBBUUBBUUUUUUUUBBBBUUBBUBBBUUUBUBBUBBUBUBUUUBUBUUUUUUBUUBUUU
UUBUUBUUBUBBUUBUUBUUBUUUUBUUUBUUUUUUUUUBBBUUUBUUUUBUBBBUBUBUBUUBUUUUBBUBUUBUUUUUUBBUBBBBUUUUBUUUBUUUU
UUUUUBUBUUUUUUBUBUBUBBUUUBUUBUUUUUUUBUUUUBUUBUUBUUUUUUBUUUUBUBUBUUUBUUUBUUUBUUUBUUBUUUUUUBUUBUBBUBUUB
UUUUBUUUUUUBUUUUUBUBUBUUUUBBUUUUUBUUBUBUUUUBBBBUUUUUUUUUUUUBBBUUUUBUUBBBUUBUUUBUBUUUBUBUUUUUUUUBUBUUU
BBUUUBUBUUUUBUBBUUUUBUBUUUUBBBUUBBUUUUUUUUUUBUUUUUUBUUUUUUUBUBBUUBBUUUBBUUUUBUBUUUBBUUBUUBUUUBUUUUUUU
