UUUBUUBUUUUBBBUUUBUUUUBUUUBBBUUBUUBBUUBBUBBUUUUBBUUUUUUUUUBUBBUUBBBUUUBUBUUBUUBUUUUUUUUUBUBUUUUBBUUBU
UUBBUUUUUBUBUUUUBUUBBUUUUUUUUBUUUUBUUBBUUUUBUBBBUBUBUBUUUUUUUUUUBBUUUUUUBUUUUBUUBBBBUBBUUUUUUBUUUBUBU
BUBUUBUUBUUUUUBUUUUUBUBBUBBBUUUUUBUUBUUBUUUUBUUBUUUBUUBUBUBUUUUUBUBBUBBUBUUBBUUUUUUBBUBBBUUBUUUBUUUUU
BUUUUBBBUUUUUUUUUUBUBBBUUBUUUBUBBUBUBUBUUUUUUUUUBUBBUUUBUUUUBBUBUUUUUBUUUUUUUUUBUBUUUBUBUUUUUUBUUBUUU
UUUBUUUUBUUBUUBUBUUUUUUBUUUUBBUUUBUUUUBBUUUBBUBUUUUUBUUUUBUUUUUUUBUUBUBUUBUBUUBUBUUUBBUUUUUUBUUUUBUUU
UUUBUUUUBUUBBUUUUUUUBUBUBBUUBBUBUUUUUUUBBUUBUUUUUUBUBUBBBUUBUUUUUUUUUUBUUUBUUUBUUUBUBUUBUUUBUUUUBBBUU
UUUBUBUBUUUUUUBUBBUUUUUBUBUUUUBBBUUBUUUBBBUBBBUUUUUUUBUUBBBUUBBUUUUUUUUUBUUUUUUUUUBUBUUUUUBBBBUUBBUBB
BBUUBBUUUUBUBBBBBUBBBBBUBUUBUUBBBUUBBUUUUUUBUBUBBUBUBUBBUUBUUUUUUUBBUUUUUUBUUUUUBUUBUUUUUUBUUBUBBUUBU
BUUBUUUUUUUUBUUUUBBUUUUUUBUUUUUUBUBUUUUBBBUUBUUBBUUUBUUBBUBUUBBUUUUUUUUBUBBUUBUUBBBUUUUUUUBBBUUBBBUUU
BUBUUUBUUUUUUUBUUBUUUUUUBUUUUUUUUUBUUBUBUUBUUUUBUUBUBBUUUUUUUBBUUUUBUUUUUUBBUUUUUBBUUUUUUUUUUUBUUBUUU
BUUUUUUUUUBUUBBBBBUUBUUUUUBBUBBUUUUUUBBBUBBUUUUUBUBUUUUUBBBBUBUUBBUBUBUUBUUBUUUUUUUUUUUUUUUUBUUUBUBUB
UUUBUUUBUUUUBUUUUUUBUUBBUUUBUUBBBUBUUUUUBUUUBUBUUUUUUBBUUUUUUBUUBBUUUUBUUBBUUBUUUUBUUUUBUUUUUBBUUBBUB
UUUUUUUUUBUUUUUUBBUUBBUUUUUUBBUUUUUUBUBUUUUUUBUUUUUBUUUUUUUBUUUUUUUBBUUUUUUBUUUBUUUUBUUUUUBUBUUBUUBBU
UBUUBUBUUUUUBBBUBUUUUBUUBBUUUBBUUUUUUUBUUBUUUUBUUUUUBBUBBBUUUUBBBUUBUUUBBUUBUBBBUBUUUUBBUUBBUUUUUBBUB
BBUUUUUUUUUUUBBBUUBUBBUBUBUUBUBBUUUUUUUUBUUUUUUBUBBUUUBBUUUBUBUUUUUUUUUUUUUUUBUUUUUUUUBUBUBUUBUUUUBUB
BUUUUUUBUUUUUUUBBUBUUUBBUBUUUUBUUUUBUBBUUBUUBUUUBUUBUUUUBBUUUUUBUUUUBUUUUUBBUBUBUBBUUBUUUUUBUUUUUUUUU
UUBUBUBUUBUUBBBUUBBUUBBUBUBUBUBUUUBUBUUBUUUBUUUUUUUUUBBBUUUUUUUUUUBBUUUUBBUUBBUUBUUUBUUBUUUUBUUUUBUUB
BBUUUUUUUUUUBUBBUUBBBUBUUUUUUBBBBBUBUBBBUUUUUBUBBBBBUUBUUBUBUUBUBBUUUBUUUUUUUUUUBUBUBBUUUUUUBBUUBUUUB
BUBUUBUBUBUUBUUUUUUUUBUBBUUUUUUBUUUUUUBUUBBUBBUUUUUUUUUUUUBUBBUUUUUUBBUUBUBUUUUUUBUUBBUBBUUUBUUUUUUUU
BBUBBBUUUBBUUUUUUUBUBUBUUBUUUUBBUBBUUBBUUUUUUUBUUUUUUUUUBUUUUUUBBUUUUBUUUUUUUBUBUUUUBUBBUBBUBUBUUUUUB
BUUUUUUUUUUBBUUUUBBUBUUUUUBUBUUBUUBUUBUUUUUBUBBUUUUUUUUUUUUUBBBBUUUUUUBUUBUUUBUUUUBUUBUBUUUUUUBBUUBBU
UBUUBUUUUUUBUUUBUUUUUUUUBUUBUUUUBBUUUUBUUBUUUUUUBUBUBUUUUUUBUUBBUBUUBUUUUUBUUUUUUUUUUUUBBUBUBUUUBUBUU
UBUUUUBUUUBBBUUUBBUUUBBUUUUBUUUUUUBBUUUUUUUUBUBUBBUUUBBBUUUUUUUBBUUUBUUBUUBBUUBUUBUUUBUBUBUUBBUUUBUBU
UUBBUUUUBUUUUUUUUUUUUUUBBUBUUUUBUBUBUUUBBUUUUBUUBBUBUUBUBUUBUUUUUBBUUUUUBUUBBBBUUUUUUBUBUUBBUUBBUBUUU
UUUUUUUUUUUBBUBUUUBUUUUUUUUUUUUBUUUUUBUUUBBUUBBBBUUUUBBBUBUBUUBUUBUUUUUBUBBBUBUUUUUUUUUBUBUBUBUUUBUBU
UBBBUUUUUUUUUBUUUUUUBUUBUUUUBUUUBUBUUUUBBUBUBUBUUBUUUUBUUUUBBBBUBBUUUUBBUBUBBUBUUUBBBUUUUUBUUUBUBBUUB
BUUUBBBUUUBUUUUBBBUUBUUUBUUUUUUUUBUUUUBUBUBBUBUUUUBBBUUUBUBUUBUUUBUUUUBUUUBBUUUUUBUUUUUUUUUBUBUUUBBUU
BUUUUUUUUUUUUBUBBUUUBUBBUUBUUUUUUBUUUUUBBUBBUUUUBBUUBUBUBUUUBBUUBBBBUBBBUUUUUUUBUUUUBBUUBUBUUUUUBUBBU
BBBUUUBUBBUBBBUBUUUUUUBUUBBUUUUBUUUUBUUUUUUUBUBBUUUUBUUUUUUUUUUUUUUUUBBUUUBUBUUUBUUUUUUUUUUBUUUUBUBUB
UUUBBUUUBUUUBBUUBUUUBUUBUUUUUUUBUBUUBUUUUUUBBUUUUUUUBBUBBUUBUUUBBUUUBUUUUUBUUBUBBUBUUUBUUBUBBUUBBUBUB
UBBBUBBUUUBUBUBUUUBUUBBUUUUUUUBUUBUBBUBUUUUUBUUUUUUUUUUBBUUUUUUBUUBUUBUUUUUUUBUUUBUUUUUUUUUUBBUUUUBUU
UUUUUBUUUUBUUUBBUUUBUUUUUUUUUBUUUBUUBUUBUBUUUUUBUBUUBBBUUUBUUBUUUBBUBUBUUBUUUUBUUBBBBUUUBUUUUBUUUUUUU
BUUBBUUUUBBUBUUUBBUUUUBUUUUUBBBUBUUUUBBUBUBUBUUUUUUUUBUBUUUBUUUUUUBUUUBBUBUUUUBBUBBBUUBUUBBBUBUUUBUBU
BBUUUUBUBUBUBUUBUUUBUUUUBUBUUUUUUBUUUUUUUUUBUUBUUUUUUBBUUBUUUBUUUUBUUUUUUUUUBUUUUUUUUBUUUBUBBBBUUUUBU
UUUUBUUBUUUUUUUUUUBUUUUUUUBUUUUUUUUBUUUUUUBUUBUBBUUUUBUUUBUUUUUUUUUBUUBUUUUUUBUUBUBUUUUBUUUUBBUUUBUUU
UUUUUUBUUBUUUUUUUUUUUUBUBUUUUBBBUUUBBUUUUUUBUUUUUUBUBBBUUUUBBUBUBUBUUUUUBUUUBBUUBUBBUUUUUUBUUUUUUUUUU
UBBUUBUUUUUUUUBUUUUBUUUUUBUBUUUUUBBUUUUUUUUUUUUBUUUUUUUUUUUUBUUUBUUUUUUUBUUBUBUBUUUUUUBBBUUUUBUUUUUUB
UUUUUUBBBUBBUBUUUUBBUUUUUUUUUUUUUBBUBUUBUUUBUUUUUUUUUUUUUUUUUUUUUBUBBUUUBBUBUBUUUUBBUUUUBUUUBUBUUBBUU
BUUBUBUUUBBBUBUUUBUBUUUBUUBUUUBUUBUUBUUUUBBUUBUUUUUUUUUUBBUUUUBBBUUUBUUBUUBUUBBUUUUUBUUBBBUUUBUUUUUUU
UUUUUUBUUBUUUBUBUBUBBUUBUUUBUBUBUUUUBUBUBUBUUUUUUUBBUBUUBBBUUUUBUUUUBBUUUUBBUUBUUUUUUBUUUUBUUBBBUUUUU
UBBBBUUBUUUUUUUUBUUUUUUBUUUBUBBBUUUBBBUUUUBBUUUUUUUUUUUBUUBUUBBUUUUBUUUBUUUBUUUUBUUUUBUUUBUUUUUBBBBBU
BUBUBUUBUUBBBUBBUBUUUUUUUUUUUBUUUUUUUUUUBUBUUBBBUUBUUUBUUBBBUUUUUUUUBUUUUBBBUBUUUBUUBBUUUBBBUBUUUUUBB
UUUBUBBUBBUUUBUBUBUUUUUUUUUBUBUBUUUUUUBUUUBUUUUUUUUUBUBUBUBUUBUUBUUUBUUBUBUUUUBUUUBBUUUUUBUUUBBUBBUUB
UUUUUUUUUUUUUUBUUUBUBBUUUUUUUUBBUUUUBBUUUUUUBBUUUBUUBUUUUUUUUBUUUUUUUUUUUUBUUUUUBBUBBBUUUUUUUUUUUUUUU
BBUUUUUUBUUUUBUUUBUUUBBBUBUUUUUBUUUBBBBUBBUUUBUUUUUBUBUUUUBUBUBUBBUUUUUBBBUBBUBUUUUUUBUBBUUUBUBBBBBUB
UUUBUBUUUBUBUBUUBUUUUUUBUUUUUUUUBUUUUUUUUUUBUUUUUUUUBUUBUUUUUUUUUUUBUUBBUUUBUBUUUUBBBUBUBUUBUUUUUUUUU
BUBUBUBUUBUBBUUUUBUBUBUUUUUUUBBUUUUUUBBUUBBBBUUUUBBBUUBBUUBUUBUBBBUBUBBBUBUUUUUUUUBUBUUBUBUUUBBUBUBUU
BUUUUUUUUUUBUUBBUBBUUUBBUUUUBUBUUBUUUUUUUUBBUUUUUUUUUUUUBBUUUUUBUUUUBBBBUUUBUUUBUUBUUUBUBUUUUUBBUUBBU
UUUBBUBBBUUBUBUBUUUUUUBBUUBBUUBUUUUUUUUUUUUBUUUUBUUBBUUUUUBUUUBBUUUUBUUBBUUBBUBUUUUUUUBUUBUBUUUUUBUUB
BUUUUBUUBBUBBBUUBUBBUUUUUUUUUBUBUUUBUUUUUBUBUBBBUUUUUUBBBUBUBBUUUUBBUBUUUUUUUBUUUBUBUBBUUUBBBUUUUUUUB
UUUUUBUUUBUUBUBUBBBUUUUUBUBBUUUUUBUUUUUUUBUUUBUBBUUUUUUUUBBUUBBUUBBUUUBUUBUUUBBUBUUUUUBUUUBUUBUUUUUUU
BBUBUBBBUUBBBUBUUUUUUUUBBUUUBBBUUUBUUUUBBBUUUBBUUBUBBUUUUUUBUUUUUUBUUUBUUUUUBBUUBUUUUUBBUUUBUUUUBUBUU
UBUUBBUUUUUBBBUUUUUUBUUBBUUUUUBUUUUUUBUBUUBUBUUBUUBUUBBUBBUUBUUUUUBUUBUUUBUUBBUUUUUUUUUUUUUUBUUUBBUUU
UUBUUUBUBUUUUUUUUBUUUBUUUBUBUUBUBBBUUBUBUUUBBBBUUUUBUUUUUUUUUUUBUBBUUUUUBUUUUUUUBUUBUUUUBUUUUUBBUUBBB
UUUBUUUUUUBUBUUUBUUBBBBBBUUUUBUUBUUUUUBUUUUBBBUBUUUUUUUUUUUUUUBBUUUUUBBUUUUUBUUBUUUUUUBBBUUUUUUBBUUBU
UBUUUUUBBUUUUUUUBUBUBUUUUUUUUUBBUBUUUUUUUUUUBBUUUUUBUUUUBBBUBUUUUBUUBBBUBUUUUUUUBBUBUUBUUUBBUUUUUUBUU
UUUBUUUUUUBBUBUUUUBBUUUBUUUUUUBUUBBUBUBUUUUUBUBUUUUUUUBBBBBUUUBUUUUUBUUBUBBUUUUBUUUUUUBUUUBUUBUBUUBUU
UUUUUUBUUUUUBBUBBUUBUBBBUUUUUUUUUBUBUUBUUBUBUUUBBUUBUBUUBUBUUUUBUBBUUBBUUUUBBUUUUUUUUBUUUUBUBUUUUUBBU
BBUUBUBUBUUUUBUUBUBUUUBUUUUUUUUUUUUBUUUUUBUUUBBUUUUUBUBUUUUUUUUBUBBUBUUUUUBBUBUUUUBUUUBUUUUUUUUUBUUUU
UUBUUUUBUBUUUUUUBUBBBUBBUUUUUBUUBBUUBUUUUUBBUBUUBUUUBUBBBBBBUUUBBBUBBBUBUBUBBUUUUUUBBUUUUUUUBBUUUBUUU
BBUUBUUUUUUUUUBUUBUUUUUUUUUUUUUUUBBUUBUUUUBUBUBUBUUUUUBUUBUUUUBUUUUUBUUBUBUUUUBUUUUUBUBUUUUUUBBUUUUUB
UUUUUUBUUBUUUUUUUUUUUBUBUUBUUUUUUUUUBUUBUUUUUBUBUUUUUBUUBBBUBUUBUBUUUUUUBUUBUUUUUUBUUUBUBUUBUUBUUUUBU
BUUBBUUUUBUBUUUUBUUUUBUUUUBUBBUBUBBBUBBBUUBUUUUUUBUUUUBUBUUBUBBBBUBUUBBUUUUUBUUBUUUUBUUUBBUUUUUUBUUBB
BUBUBBBUUUUUBUBUBUBUUBBUUBBUUUBBUBBBUBUUUUBUUUUBUUUUBUBUBBUBUUUUUUBUUUUBUBUUUUUUUUBBUUUBUUUBUUUBUUUUB
UUBUBUUBBUBBUBUUUUUUUUBUUUUBUUBUBUUUUUBUUUUUBUUUBBUBUUUBUBUUUUUUUUUUBUUUBUUUBUBUUBBUUUUUUBUBUUBUUUUUB
BUUBUUUUUBBUUUUBUUBUUUBBUUUBBUBUUBUUBUUUUUUUUBUUBUBUBUUUUBUUUUUUUBBUBBUBUBUUUUUBBUUUUUBBUBUUUUBBUUUUB
BUBUBBUUUBBBUBUUBBBUUUUUUUUBUUUUBUUUUUBUUUUUUBBUBUBUBUBUBUUBBBUUBUUUUUUUBUUBBUUUUBUBUUBUUUUBUUUUUUBUU
BUBBBBUBUUBBBBUUUUUUUUUUBUUUBUUUUUUUUUUBUBBBUUUBBUUUBBBBUBBBUUBUUUUUUUUUBUBBBUUUBUUBUBUBBUUUUUUUUUUBU
UBUUUUUBUUUUUBBUUUUUUUUUUUUUBUBUUUUUUUUBUUBBUUUBUBBBBUUBUUBBUUUUUUBBUBUBUUUUUUUUUUUUUBBBBUUUBUBBBUBBB
UUUUUUBUUUUUUBBBUUUBBUUBBUUUUUUUBUUUUUUUUBUUUUUBUUUBUUUUUBBUUUUBBUUBUBUUBUBUUBUBUUUUBUBUUBBUUBUBUBUUU
UBBBUUUUBUBBBUBBBUUUUBUUUUUBUUUBBUBUUBUUBUUUUUBUUBUUUUBUUBUUUBBUUUBUUBUUBUUUBUUBUBUUBBBUUUUBBUUUUUUBU
BUBUBUUUUBUBUUBUUUBUUUUBUUUUUUUUBUBBUUUUBBUUUBUUUBUUUUBUUUUUUUUUUBUUUBUBUUUBUUUBUUBUUUBUUUUUBUBUUUBUU
UUBBUBUBUBUUUUBUUUUUUUUBUUUUBUUUBUUUBUUUUUUBUUUBUUUUUBUUBUUBUUBBUUUBUUUBUUUBUUUUUUUUUUUBUUUUUUUUUBUUB
UUUUBUUUUUUUUBUUUUUUBUUUUUUBUUBUUBUBUUUUBUUUUBUUUUBUUBUUUBUUUBUUUBUUUUUUBUUUUBBUUUUBUUBBUUUUUBBUUUUBU
UUUUBBUBUBUUUBUBUUUBUUBUBUUUUUUUUUUBUUUUBBUUUUBUUBUUUBUUUBBBBUUUBUBUUUUUBUUUUBUUUUUUUBUBUUUUUUUBBUUUU
BUBUBBUUUUUUUUUBUBBUUUBUBUBUUUUUUUUUUBUUBBUUUUUUBBUUUUUBUUUUUBUUUUUUUBUUUUUUUUUBUUUUBBBUBUUBBUUUBUUUU
UUUUBUBBUUUUBUUUUBUUBUUUUBBBBUUUUUUUBUUUUUUUBBUUUUUUUUBUUUBBUUUBUUBUUUUUBUUUUUUBUBUUUUUUUUUUBUUUBUUUU
UUBBBUUBUUUUUUUBUBBBUBUUUUUUBUUUUBUUUBUBUUUBUBUUUUBUBUUUUUUUUUBUUUBUBUUUUUBUBUUBUUBBBBUUBBUBUBUUUBUUU
UBUBBBUUUUUBUUUBBUUUUUUUUUUUBUUUUUBBUUUUUUUUUUUBUUUUUBBBUUUUUUUUUUBUUUUBUBUUUUBUBUBBUUUUUUBUBUUUUUUUB
BBUUUUUUBUUUUBUUUUUUUUUBUUBUUUBUUUUUUUUUBBUBUUUUUUUUUUUUBUUUUUUUUUUUUBUBUUUBBUUUUUBUUUUUUUUUUUUUUUUUU
BUBUUUBUUUUBUBUUUUUUBBUUBUBUUBUUBUUUUUUBUUBUUUUBUUBBUBUUBUBUUBUUUUBBBUUUUBBUBUUUBBUBBUUUBBUUUBUUUBBUU
UUUUUUBUBBUUUUUBUBUUUUUBUUUBUUBUUUUUUBUBUUBUUBUUUUUBBUBUBUUUUUUUUBBUBBUUUUUUUUUUBBUUUUUUUUUBBBUUUUBUB
UUUBUBUUUUBUUUBUUUBUBUUBBUBUUUBUBUUUBUBUUBUUUUBUUUBUUUUUUBBBBUUBBUUUBUUBUUUUUUUUUUBUBBUUBUUUUBUUUBBUU
UBUUBUUUUUUUUBBBUBBUUUUUUBUUUUUUBUUBBUUUBUUUUBUBUUBBUUBBUUBUUUUUUBBBUBUUBBBUUUBBBBUUBUUUBUUBBUBUUUUUU
UBUBUUUUUBUBUBBUUUUBUUBUBBBBUUBUUBBUUUBUUBUUUUUUUUUUUUBUUBUUUUUUBUBUUBBUUUUUUUBUUUUUUUUBUUBUUUUUBUUBB
BUUUUUUBUUUBBUUUBBUUUUUBBUUBUUUUUUUBUBBUUUUUUUUUUUUBBBBUUUUUUUBUUBUUUBBUUBBUBUUUUUUBUBUUUBUUUUUBUUBBU
UUUBBBUBUUUBUBBUBUBUUUUUBUBUUUUUBBUUUUUUUBUUUUUUUUUBUUBUUUUBUUBBBUUUUUUUUUBBUBBUUUUUUUBUBUUUUUUUUUUUU
UUUBUUUBUUUUBUBUBUBBUUUBUBBBUUUUUUUUUUBBBBUUBUBUUBBBBUBUUUUBBUUUUUUUUUUUUUUUUUBBUUBBUUUBUBUUUBBBUUBBU
UUUUUUUBUUUUUUUUUUUUUUBUUBUUUUBUBUUUUBBUUUBUUBUBUUBUBUUBBUUBBUUUBBUBUUUUUUUUUUBUUBUUUBUUBBUBUBUUUUUBU
BUUUUUUUUUBUBUUBUUUBUUUUUUUUUUUUUBBBUUBBBUBUBBUUBUUBUUUUUBUBBUUUBUBBUUBUBUBUUUUUUBUUUBUUUUUBBUUUUUUBU
UBBUUBBUBUUBUUUUUUUUUUBBUUUUBUBUUUUUBBUUUUUUUBUUBUUUUUUUBBUUUBUUUUUBUBUUUUBBUUBBUBUUBUUBUUBBUUUBBBUBU
UBUUBUUBBBBUBBUUUUUUUBBUUBUBUUBUBUBUBUUBBBUBUBUBUBBUUUBUUUUUUBUUUBBUUUUUUUUUUBBBBUBUBUUUUBUUUUUUBUBUU
UUBUBUBUUBBUUUBUBUUUBBUUBUUBUUBUBBUUBUUUUBBBUBBUUUUBUUUBUUUBUUBUUUUUBUUUBBUBUUUUBUBBUBBBUBUBUUUUUUBUU
UUUUUBUBUBUUUBUUUUUUUUUUUUUBUBUUUUUUUBBBUBUUUUUUUUBUUBUBBUUUUBBUUBBUUUBUUUBUUUUBBUUBUUUUUUBUBUUBUUBUU
BUUUUUBBUUUBBUBUBUBBBUUUUUBBUUBUBUBBUUBUBUBUUBUUUBUBUUUBBUUUUUBBBUUUUUBUUUUBBUUUBUUUBBUUUUBBBBUUUUUUU
BUUBBUBUBBUUUBUUBUUBBUUUBUUBBUBBBUUBUUUUUBUUUBBUUUUUBUUBUUUUBUUUUBUUUBBUUUUUBBUBBUBUBUBUUUUUBUUUUUBUB
BBUBUUUUBBUUBUUBUUBUBUBUBBBUBBUBUUUBUBUUBUUBUUUUUBUUUUUUUUUUUUUUUBUUUUUUUUBUUUUUUBUBBUUUBBBUUUUUUUUUU
UBUUUUUUUUUBBUUBUUUUBUUUUBUBUUUBBUUUUUUBUUUUUUUBUUBUBUUUUUUUUBUUBUUBUUUUUBUUUUUBUUBUUUUUUUUUUUUBUUUBU
BUUUUUBUBBUUUUUBUUBUUUUUUUUUUUBBBUUBUUBUUUUUUUUUUUUUBUUUUUUUBUBBUUBBUUUBUUUBUUUUBBUUBUUUBBBBUUUUUUUUU
BUUBUUBBBBBBUUUUUBBUUUBUUUUUUUUUUBUBUBUUBBBUUUUBUUUUUBUUBUUUUUUBUBUUBBBUUUUUBBBBBUBUUUBUUBUUUBUUUUUUU
UUBBBUUUUUUUBUUUUBUUUUBBUUUBUUUUBUBUUBUUBUUUUUBUUUBBBUUUUUUBUUBBUUUUUUUBUBUUUUBUUUUUBUUBBBBUUBUUUBUUU
