UBUBUBUBBUBBUBBUUBUBUUUBBUBBUBUBUUUUUUUUUUUUUBUUBUUUUUUBUBUBUUUUUUUBUUUBBUUUUUUUUBUUUUUBUBUBUUUBUBBUU
UUUBUBUUUUBBBBBBUUBBUBBUBUUUUBUUUUUUUBUUBUUBUBBBUUBUUUBBUUUUUUBUUBBUUUUUUUBUUUUUBUUUUUUUUBUUUBUUUUBUU
UBUBUBUUUUUUUUUUUUUBBBBUUUBUUBUBUUUBUUBUBBUBUUBUUBUUUUUBUUUBBUBBBUBBBUUUUUUUUUBUUBUBBUBUUUUUUUUUUUUBB
UBUBBBBBUUUBUBUUUUBBUUUUUUUUUBBUUUUUUBUUUBBBUBUBUBUUUBUUBUUBUBUUUUUBUUUUUUUBUUUUUUUUUUUBBUUUUUUBUBUUU
UBUUBBUUUUBUUUUUUUUUUUUUUUUUUUUBUUUBUUBUUUBUUUUUUUBUUUBUBBUUUBUUUUBUBBUUBBBBUBUUUUUUUUUUUUBUBUUUUBUUU
UUUUUUUUUUUBUUUBUUBUUUUUUUUUUUUUUUUUUUBUUBUBUUUBUUUUBBUUUBUBBBUUUUUUUBUBUBUUBUUUBUUUBUUUBUUUUUUUUBUUU
BUBBBBUUBUBBBUUBUUUUUUBBUUUUBUUUUUUUUUUUUUUUUBUBBBBBBUUUUUUUBBUUBUBUUUUUBUUUUBUUBBBUBUUUBBUUUBUUUUUUU
UUBBBBUUUBUUUBUBUBUBUBUUUUUUUBBUUBBUBBUUUUUUBUUBUUUBBUBBUUUBUUUBUBUUBUUUBBUUUBBUBUUUUUUUUUUUUUUUBUUBU
BUUUUBUUBBUUUUUUUUUUBUUBBUUUUUBUUUUUUBUBUUBUUUUUUBUBUUBUBUUUBBUUUUUBBUUUUUBUUUBUUBUUBUUBBBUUUUUUUUUBB
UUUUUUUUUBUBUUUBUUUUUUUUBUBBBUUBUBBUUBUBUUUUUUUUUUUBUUUUUUUUBUUUUBUUBBUUUBBUBBUBUUBBUUUBUUUUBUBUBBUUB
UBBBBUBBUBBBBUBUBUBUUUUUUUUUBUUUBUUBUBUUBBUUUBUUBUBBUUBUUUUUBBUBBBBUBUUUBBBUUUUUUUBUBUUBUBUBUUUUUBUUB
BBUBUBUUUUBUUUUUBBUUUUUBUBBUUBUUUBUUUUUBUBUBUBUUUUUBUUUUUBBUBUUUBUUBUUUBUBUUUUBUBUBUUUUBUUUBUUBBUUUUB
UUUUUUUUBUUUUUUUUUUUUUBBUUBUUBBBBBUUBBBUUUBUUUUBBBUUUBBUUBUUBUUBBUUBBBUUUUUUUUUUUBUBBBUUUBUUBUUBUUUBB
UUUUUBUUUUUUUUBUBBUUUUUUUUBUBBUBUUUUUUBUUBUBUBUBBUUUUUUBBUBUBUUUBBUBUUBUUUUUUBUUUUBUBUUUBUBBUUUUBUBUU
BUUBUUUUUUUBBUUBUBUUBUUBBBBUUUBUUUBUUUUUUBUBUUBUUUUUBUBBUUUUUUUUUBUUUUUUUBUUUUUBUUUUUUUUBUUUUUBUUUUBU
UUUUBUUUUUBUUUUBBUBUUUUUBUUUUBUBUBUUBUUUUUUUUUUUUUUUUUUUUUBUUUUUUUUBUUUBUUUUBBUBUBBBUUUBUBBUUUUUUBUUB
BUBUUBUUUUUUUUBUBUUBUUBUUUBUUBBBBUUBUBBBUBBUUBUUUBUUBUUBUUBUBUBUBUUUBUUUBBUBUBUUBUUUUUUUBUUBUBUUUUUBU
UUUUBBBUUBUUUBBUUBBUUUUUBBUBBUUBUUUUUUUBBUUUUBBUUUUBUBUBUBUBBUUUBBBUUUUUBUUBUUBBUUUBUBBUUUUBBUBBBBUUU
BBUBBUUBUUBUBBUBBUUUUUUUUUBUBUUUUUBUUUUBBUUUUUUUBUBUUUUUUBUUUUUBUUUUBUUUUBBBBUBUUUUBBUUUUUUUBUBUUUBBU
BUUBBBBBUUUUUUBBUUBUUUBUUBUUUUUUUUUUBUUUUUUUUUUBBUBUUUBUUUBUUUUUUUUBUUUUBBUBUUUUUUBBUBBBBBUBUUUUBUBUU
BUUBUUBUBUBUUUUUBUUUBBUBBUUUUUUUUUUBUUUUBUUUUUUUBBUUBUBUUUUUBUUBUUUBBBUUBBBUUBUBUBUBUUUUUBUUUBUUUUBUB
UBBUUUUUUUUUUUUUUUUUUBUUUUUUUUUUUUBBUUUUUUUBBUUUUUBUUBUUUUUUUBUUBUUUUBUBUUUUUUBBUUUUUUUUUBBBBUUBUUBBU
BUBUBUUUUBBBUBUUBUUUUUUBBBUUUBUUBUUBUUUUUBUUBUBBUUUUUBBUBUUUBUUUUUUBUUBBUBUBUBUUBUBUUBBBUBUUUUUBUUBUB
UUUUBUBBBUUBUUUUBUUUUBUUUUUUUUUUUBBUUBUUUUBUUBUUUUUUBBBUUUUUUUUUUUUUUBBUBUUUUUUUBUUUUBUUUBBBUUUUBUBUU
UUUBUUUUBBUUBUBBBUUBUUBBUUBUBUBUBUUUBUUBUUUUBBUUUUBUUBUUBUBUBBUUUUUUBBBBBUUUUUUBUUUUUBUBUBUBUBUUBBUUU
UUBBBUUUUBUUBBUUUUBUUBUUUUUUBUUBUUBBBUUUUUUUUUUBBUUUBUUUBBUUBUUUUUUBUUBBBUUUBUBBUBBUBUBUUUUUUBUUUUUUU
UUBUBUUBUUBUBBUUBUBUUUUUUBUUUBUBUUUUUUUBUUUUUBUBBUUBUBBUBUUBUBUBUUBUUUUUBUBUUBBUUUUUBBUBUUUUUBBUBUUBU
UBUUUUBBUUUUUUUUUUBUBUUUUUUUUUBUUUUUBBBUUBUUUUUBBUUUUUUBBUUUUBUUUUUUUBUUBUBUUBUUBUBUUBUBBUBBUBUUBUUUB
UUUUUUBUBUUUUUUUUUUBUUUUBUBBUBUBBBUUUUUUBUUBUBUUUUUBUBUUUUBUUBBUBUUUUUUUBUUUUUUUUUUBUUBUUUUBUUBUBUBBB
UBUUUBUBUUUUUUUBUUBBUUUUUUUBUBBBUUUUUBUBUBBBBUUUUBUUBBUUUBUUBUBUBUUUUUUBBUBBUBUUBUUUUUUUUUUBUBBUUUBUU
UUUUUUBUUUBBUUUUUBUBUUUUBBUUUUUUUUUUUUUUBUUUUBBBUUUUUUBUUUUBBUUBBUUUBBUUUBUUBUBUUBBBUUUUUUUUUUUUBUBUU
BUUUUUUBUUUBBBBUBUUUUBBUUUBUUUUBUUUUBUUBUUBUBUUUBUUBBUUUUUUBUUUBUBUUBUUBBUUUUUUUBUBUUBUUUUUBUUUBUUUUB
UUUUUUUBUUUUBUBUUBBUUBUBUBUBBUUUUUBBUUUBBBUUBUBBUUUBUBBUUUUBUUUBUUUUUBUUUUBUBUUUBUBBBUUUUBUUUUUUUUUUU
UBUUUUUBBUUUUUUUUUUUUUBUUUBBBBUUUBBBUUBUUUBUUUBBBUUUBUUBUUUUBUUBUUUBUBBUUBUUUUUUBUUBUUUBUUUUUUBBUUUBU
UUBUUUBUBBUUUBBUUUUBBUUBUUUUUBUBUBUBUUUUUUBUBUUUUUUUUBUUUBBUBUBUUUUUUBBUUUUBUUUUUBUBBUUUUUUUUUUUBUUBB
UBUUUUBBUBBBBBUUUUBBUUUBUUUUBUUBBBBBUUBUUBUBUBUUBUUBUBBUBUUUUBUUUUBUBUUBUUUBUUUUUBBUUUBUUBUBBUUUUBBUU
UUUUBUBBUUUBUUBUUUUUUUBUUUUBUBUUBUBBBUUUBUUUBUUBUUBBUUUBBUBUUBUUUUUUUUBUUUUUUUUBUBBBUUUBUUUBUUUUUUUUB
UBUUUUUUBUBUUUBBBBUUUUUUUBUUUUUBUUUBUBUUUBBUUBUUUUUUBUBUUUBBBBBUUUUBUUUBUUUBUUUUUUBUBUUUBUBUUUUUBBBUB
UUUUUUUUUBBBUUUBUUUUUBUUUUBBUBUUUUUBBUUUUBUUBUBUBUUBUUUUUUUUUBUUUUBUBUUUUUUBUUUBUBUUBUUUBUUUBBUBUUBBU
BUUBUBUBBBBUUUUBBUUUBUUBBUUBUBUUUUUUBUUUUUBUBBUUUBUBUBBUBUUUUUBUUUUBUUUBUUUUBUUUUUUUBBUUBUBUBUUBUBUUB
UUUUUUUUUBBBBBUUUUUUUUUBUUBUBUUUUUUUUUUUUUUUUBBBBUBUUUBUUUUUBUUUBUUUUBBBUBUUBUBUUBUUUBBUBUBUBUBUBUBBU
BUUUUUBUUUUUBUUUUUUUBUBBBUUBUUUUUUBUUUBUBUUBUUUUBUUBUBUUUBUUBUUBBUUBUBBUUUBUBBBUBUUUUUUBBUUUUUBUUBUUB
BUUUUBBUUUBUBBBUUUBBUUUUUUUUBUBBUUBBBBBUBUUUUBUUUUUBBBUUUBUUBUBUUUBUBBBBUUUUBBUBUUUUUUUUBBUUUUUBUUBUU
UUBUUUUUUUUUUBUUUUUUUUUUUUUUUBUUUUUBUUBUBUUUBUUUUUUUBUUBBUBBUBBUBBUUUBBBBUUUUBUUUUUBUUUUBUBBUBUUUUBUU
UUUBBUUUBBBBUUUUUUUUUUUBBUUUBBBUBBUUUUUBUUUUUUUBUUUUUUBBUUBUUUBUUUUBUBUBUUBBBUUUUUBUBUBBUBBUUUUUUUUUB
UUBBUUBBBUBUUUUUUBUUUUUBBBUUBUUUUUUUUUUBUBUUUBUUBUUUUUUUUUUUUUBBBBUBUUBBUUUUUUBUUUUUBBBBUUBUUUUUUUUBB
BUBUUUBUUUUUUUUUBBUUUBBUUUUBUUUBBUBUBBUUUUUUUBUUUUUUUUBBUUUUBUUUBUBUUBBUBUBBUBUUBUBUBUUUUUUUBUBUUBBUU
BBUUUBUUUBUUBUBBUUBUUUBBUUUUUUBUBUUUBUUBBUUBBUUUUUUUUUUUUUUUBBUUUUUBUBBUUUBUBUBBBUUUUUUUUUUUUUBBUUUUB
UBUUUUBBBUBUBUUUUBUUUBBUUUBUUUBBUBUUUUBUUUBUUUUBBBUUUUBBUUUBUUUUUUUUBBUUUUUUUBUUUUBBBBUUUBBUUBUBUUUUU
BBUUUUUUUBUBUBBBUBBUUUUUUUBUBBUUUUUUUUUUUBBUBUUUBUUUUUUUUUUBUUBBUBUUBBUUUUUBUBUUBUUBUUUUBBUUUBUUUUUUU
BBBUUUBUBUUUUUUUUBUBUUUBUBUUUUUUUUUUUUUUBUBBBBBUBUUBUBUUUUUBUBUUUUUUUUBBBUUBUBUBUUBUUBBUBBBUUBUBBUUUB
UUBUBUBUUUUUUUUBBUUUUUUUUBUUUUUUUUUBBBBUUUUUBUUUUUBBUUBUUUUBUUUUUBBUBUBUBUBUUUUUBUUUUBBBUUBUUUUUUUBBU
UUUBBBUUBUUBUUUUUBUBUUBUBUUBUUUUBBUBUBBUUUUUBBUBBUUBUUBBUUUBUBUUUBUBUBUUUBUUUBUUUUUUUUUBBUBBUUBBUUUUB
UUUUBBUBUUUBUUUBBUUUBUUBUBBBBUUUBBUUUUBUUUUUUUUBBUBBBUBUUUUUUUUUBUBUBBUBBUUBUUUBUBBUUUUUBBBUBUBUUBBUU
UBUBUUUUUUUBUUUUUUUUUUUBUBUUUBUUUUUUUUUUBUBUUUUUUBUUUUBBUUBUUUUUUUBBBUUUBUUBUUBUBUUBUUUBUBUUUBUUUBUBU
UBUUUBUBUUUUUBUUBUUBBBUUUUUUBUBUUUUBUUUBBUUBBUBUUUUBBUUBUUUUBUBUUUUUBUUUUUUUUUUUUUBBBUUUUBUUUUBUUBBBB
UUUUBBBUBBBUBUUUBUBUBUBBBUBUUUBUUBBUUUBBBUUUUUUUBBBUUUUBUBUUBUBUUUBUBUUUUBUBUBBUUBUBUUUUUUUUUBUUUUUUB
BBUUUUBUUUUUUBUUBUBUUUUUUUUBUUUUUUUUUUUUUUUUBUUUUUUBUUBUUUUBUBBUUUUUUUUUUBBBUUUUBUUUBUUUUUUBUBUUUUBUU
UUUBUUUUBUBBBUUBUBUUUBUUUUBUUUBUUBUUUUBUUUBUUBUUUBUBUBUBUUBUUUUUUUUUUUUUUUUBUUUBBUUBUUUUBUUUUBUUBBBBU
BBUUBUBUUUUUUUUUUUBUBUBUUBBUBUUUUUUUBBUBUUBUUUUUUBUUBBUBUBBUUUUBBUUBUUUUUUUUUBUUUUBBBUUUUBBUBUUBBUBUU
BBUBBUBUUBUUUBBBBUBUUBBUBUBUUUUBBUBUBBUUBUUUUUBUBBUBUBBBBBUUBUUUUBUUUUUUBBUBUUBUUUBUUUUUUBUUBUUUUUUUB
UUUBBUBBUUUUUBUUUUUUBUBUUUUUUUBUUUUBBBUBUUBBUBBUUUBUUBUUBUUUUUUBUBBBBUUUUUUUUUUUBUUUUBBUUUUUUUUBBUBUB
BBUUUUBUBUBBUBUBUBUBUUUBUUUUUUUUUUUUBBBUUBUUBBBBUUUUBUBBUUUUUUBUBUUUBUUUUUBUUUUUUUBUUUUUBBUUUBUUBBUUB
UUUUUBUUBUUUUBUUBUBUUUBUBUBBUUUBUUBBBUUUBBBUBBUBBBUBBUUUUUUUUUUUBUUUUUBUUUUUBUUUUUUUUUBUUUUUBUUUUUUBU
UUUUUUUBUUUBBUBBBBUUUUUUUBBUUUBUUUUUBUUBBBUBUUUBUBUBUUUUUBUUBBUBUUBUUBUUUUUUUUUUUUUBUBBUUBBUBUUUUUBUU
UUBUUUUUUUUBBUBBBUUUUUBBUBUUUUUUBUUUUUBUUBBUUUBUUBUUBUUUBBUBUBUBUUUUUUUUUUUBBUUUUUUUUUUUBUUBUUUUBUUUU
UBUUUUUBUBUUBUUUUUBUUUUUBUUUUUUUUBUUBBUUUUUUUUUUUUBUUUUUUUUBUUUUUUUUUBUUUBUUUUUUUBUBUUBUUUUUUBUUBUUUU
UBUBBBUBUUUUUUUUUBUBUBBBUUUBUBUUUUBUUUBUUBUUUBBUUUUUUUUUBBUUUUUBUBUBUBUBUUBUBUBUUUBBBUUBUUBUUUUUUUUBU
UUBUUBUBUUUBUUUBUUUBBBUUUUUUUUUUBUBUUUBBUBUBBUBUUUUBBUUUUBUUBUBUBBUBUUUUUBBBUBBUUBUUUUUUUBUUUUUUBUUUU
UBUUUBUUUUUUUUBUUBUUBUUUUUUUBUBUUBUUUUUUUUUUUUUUUBUUUUUUUUUUUUBBBUBUUUBUBUUUUUUUUUBUUBUUUBUUBUUUUUBUB
UBUUUUUBUUUUBBUUUUUBUUBBUBUBUBUUUUBUUUUUUBUUUBUUUUUUUUUBUUUUUUUUUUBUBUBUBBUBUUBUUUUUUUUUBBUUUUUBUUBBU
UUUUUUBUUUUUBBUBUUBUBUBUUUUUBBBUUBUUUUUUUUUUBBUUUUUBUBUUUBUUBUUUUUBBUBUUBUUUUBUUUBUBBUUUBUUUUUBBUBUUU
UUBUUUBUUBUUUBBUBUUBUUUUBUUUBBUUBUUBUUBUUUBBBBUUUBUUUUUBUUUUUUUUUBBUUUUUBUUUUUBBUUBUBUUUBUUUBUUUBBUUU
UUBUUUUUUUUUUBUUBUUUUUBUUBBUBBBUUUUUUUBUBUBUBUUUBUBUUUUBUUUUBBUUUUUUBBUUBUBBUUUUUUBUUUBUUBBUUUUUBUUBB
BUUUUUUUBBUUBUUBUBUBBUBUUUBUUUUUUUBUUBUBUUUBBUUUUUBUUUUUBUUBUUUUBUUUUUBUUUUUBUUUUUUUUUBBUUUUUUBUBBUUU
UUUUUUUBBUUUUBBUUUUUUBBUUBBBUUBBUUUBUBBUUBUUUBUUUUUBUUUBUBUBUUUUUBBUBBUBUUBBUUUUUBUUBUBBUUUUUUUBBUBBU
UBBUBBUUBUUBUBUUUUUUBBUUBBUBBBUUBBUUUUUBBUUUUUBUBUUBUUBUUUBBUUUUUUUBUUUUUUUUUUUUUBBUUBUBUUUUBUUUBUUUU
UUUUUUUUUUBUUUUUBUUBBBUUBUUBUUUUUBUUUBUBUBBBBBUUBUUBUUUUBBUBBUUUUUBUUUUUUUUUBUUBUUBUUUUUUBBUUUBUBBUUB
UBUBUUUUUUBUUUUUBUUUUBUBUUUBUUUUUBUUUUUUUBBBUUUBUUUUBBUUBUUUBUUUUUUUUUUUUUUUUUUUBUBUBUUUUUUUUUBUUBUBU
BUUUUUUBUUUUUBUUUUUUUUUBUBBUUBBUUBUUUBUUUUBBUUBBUUUBUUUBUUBBUUUUUUUUUUUUUUUUUUUBUBBUBUBUUBBBBBUBUUUBB
UUUUUUBUUUBUUBUBBBUUBUUUUBBUUUBBBUUUUBUBBBBBBUUUBBUBUUUUUBUBUBUBUBUUUUUUUUUUUUUBBBUUBBUUUBUUUUBUUBBBB
UUBUUUUUUBUUUUUUUUUBUBBUUBUUUUUBBUUUBBUUUUUUUUUUUUUBUBUUUUUBUUUUBBBUUBBUUBUUUUBUUUBUBUUBUUUUUUUBUUUUU
UBBUBUUBUUUUUUUUUBUUUUUUBBUBUUUUUBUUUUBUBBUBBBUUBBUUUUBUBUUUBUUUUBUBUUUUBBUUBUUUUUUBBUUUUUUBUBUUUBUUU
UUUBBUUUUUUUUUBBUUUBBUUUUBUUUUUUUUBUUUUUUUUBBBBUBBBUUUUUUUUBUUUUBUUUBUBBUBBUUUBUUUBUUUUUBUUUUUBBUBUUU
UBUUUUUBUBBUUUUUBUUUUUUUBUBUUUUUBBUBBBBBUUUUUUUBUUUBBUUUUUUUUBUUUUUUBUUUUUBBUUUBUUUUUUUUUBUBUUUUUUUBB
BUUUUBBBUBUUUUUUUUUBUBUUUBUBBUUUBUBUUUUUUBUUUUUUBUUUUBUUUUUUBBBUBBUBUUBUUBBBUBUUUUBUUUBUUUUUUBUUUUUUU
BUUUUUBUUUUUBUUUUUBBBUUUUUUUUUUBBBUBBUUUBUBUBUUUUUUUUUUBUUUUUUBUUUBUUUUUUBUUUBBUUUUUUBUUUUUUUUUUUUUUB
UUUBUUUBUBUUBUUBBUUUUBUUBUBUBUUUUBUUUBBUUBBBUUUBBUUBUUUUUUBUUBBBUBUUBBUBUUBUUUUUUUUUBBUUBBUUUUUUBUUUU
UUBUUBBUBBUBBBUUUUBUUBBUUBUUUBUUUUUUUUBUUUUBUBUBUBUBBUUBUBUUUUUUUUUUBUUBBUUBUBBBUUBBUBUUBUUUBUUUUBBUU
BUUUUUUUUUUBBUUBUBUUUBUBUUBUUUBBUUBUUUUUBUUUUUBUUBUBUUUUUBUBUUUBUUUUUUBBUUUUBUUUUUUUUUBUUBUUBUBUUUBUU
BBUUUUUUBUUUUBUUUUBBBBUUUBBBUUUUUUUBBUUUUUUUUBBUBUUUUUUUUUUUUUUBUUUUUUBBUUUBUUBBUBUBUUUUUBUUUUUUUBUUB
UBUUBUUUUUUUUUUBBBUUBUUUUUUUBBUBUUUUBUUUUUUBUUUBUUBUBBUUBUUUBBUBBUBUUBUBBUUUUUUUBUBUUBUUUBUUUUUUUBUUU
UUUUUUUUUUUUUBUUBBUBUUBBBUBBUUUUUUBUBUUBUUUUUUUBBUBBUBUUUUUUBBUUBBUUBBUBUUUUBUBUUUBBUUBBBBBUUUUBUUBUB
UUUBUBUBBBUUUUBUUBUUBBUBUUUUBUBBUUUUUUUUUBBUBUUBUBBUBBUUUUUUUUUBBUUBUUBUBUUUUUUBUUUUUBBUUUUUUBUBBUUUU
BUBBBUUUUBUBUBBUUBUBUUBBUUUBUBUUBUUUUUBBBUUUUBUUUUBBUUUUUUUBUBUUUUUUBUUUUBUBUUUBBBUBUUUUBUBUUUUBBUUBB
UUUBBUBBUUUUBUBBUUUUBUBBBUBBBUUUBUUUUBUUBBUBUUUBUUUBBUUBBBUUBUUUUBUUBUUUUBUUUUUUUBUBUUUUUUUUUUBUUBUUB
UBBBUUUUUUUUBBUUUBUBUUUBBUUUBBUUUBUUUBUUUUUUBUUBBUUUBUUBUUUUUBBBUUUUUBUBUUUBUUUBUUUUUUBUUUBUBUBUBUUUU
UUUBBBBBUUBBUUBBUUUUUBBBUUUUUBUUBUBUUUUBBUUUBUUUUUBUUBUUUUUBUBBUBUUUUUUUUUUUBUUBBBBUUUUUBBUBUUUUUUUUB
UBBUBUUUUUUUBUUUBBUBUUUBUUBBBBBBBUUUBUUUUUUUUUBUBBBUUUUUUUUUUBUUBUUUUUUUBUUUUUUUUUUBUUUBBUUUUUBUUUUUU
UUUUBUUUUUUUUUUUUUBUBUBBUBBUBUUUUBBUUBUBBUUUUBUUUBBUBUBUUUBBUUBBUUUUBUUUBUBUUUUUUBUUUUUUUUUBUUUBBBUUU
UUUUUUUUUUBUBBBBUBUUUUUBUBUUUUUBUUUUBBUBUUUUBUUUUUUUUUUUUUUBBUBUBUBBBBUUUUBUUUUBBUUUUBUBBUBUUUUUBBUBU
