UUUUBBUUBUBUUUUUUBBUBUUUBUBBUBUUBUUBBUBBUUUUUUBBUUBBUUUUBUBBUUUUUUUBUUUUBBUBUUUUBUBUUUUUUUUUUUBBUBUUU
UUBBBUUUUUUBUUUUBBUBBUUBUUUUUUUBUUUBBUBUUBUUUBUUBUUUUBUBBBUBBUUBUUBUUUBUUUUUUUBUBUUUUBUUBUUUBBUUUUUUU
UUBBUBBUUUUUBBUUUUUUUUUUUUUBUUBUBUBUUBUBUBUUUUBUUUUUBUUBUUBUUUUUBBUUUUUUUUUUBUUBBBBUUUUBBUUUUUUUUBUUU
UBUUBBBBUBUUUUUUUUBUUUUUUBUUUUUBUUBUBUUUBUUUUBBUUBUUUUUUUUUUBUUUUUBUUUUBUBBUUUUUBUBUBUBUBUUBUBUUUBUUU
UUUUUUUBUUUBUUBBUUBUBUUBBUUBUUUUBUUUUUBUUUUBUUBBUUUUUUUUBUUBUUBUUBUBBUBUUUUBBUUUUUUBBUUUUUUUUUUUUUUBU
UUUUBBUUUUBUUBUUBUUUBUUUUUBUBBBUBBUUUUBUUUBUUUUUBUUUUUUUBBBUUBBUBUUUBUUUUUUUUUBUBUUUBBUUUUUUBUUUUUUUB
BBUUBUBUBUUUUUUBBUBUUUUUUUUUBBBBUUBUBBUUUUUUUBUUUUUUBUBBBUUUUUUUBBUBUBUUUUUBBUUUUUBBUBUBUBUBUUUUUUUUU
BUUUUUBUUUUBUUUUUUBUUUUBUUUUUUUUUUUUUBUUBUUUUUBBUUUUUBUBUUUUUBBUBUUUUUBUUUUUBUUUBBUUUUUUUUUUBBUBUUUUU
UBBBUUUUBUUUBUUUUUUUUUUBUUBBUBUUBBUUUUUBBUBUUUUBUBUBUUUBBBUUBUUBUBBBBBUUBBBUUBUBUUUBBUUUUUUUBUUUUUBBU
UUBUUUUBUBUBBBUUUUUBBUUUUUBBBUBUUBUUUBUBBUBBUUUUBUUUBUUUUUBBUUBUUBBUUUBUBUUUBBUUUBUUBUUBBUUUUBUUUBBUU
UUUUBBBUUUBBBUUUBUUBBBUBUUUUUUUUBBBUUBUUUUUBBUBUUBUUUUUBUBUBBBBUUUUUUBBBUBUUUBUUUUBUUUUUUUUUBBUUUUBUU
BUBUUUUBUUBUUUBUUUUUUUUUUUBUUUUUUUUBUUUUUUUUBBUUBUUUUUUUUUUUUBUBUUUUBUUBUBUUBUUBUUBUUUUBBUUUUUUUBBUUB
BUUUUUUBUBUUBUBUUBBBUBUUUUUUUUUUBUBUUBBUUUUBBBUUUUUUBUBBUUUUUUUBUUBUBBUUUUUUUUUUUUUBUUBUUUUBBUUUUBUUU
UUUUUUBUUUBUUBUUUUUUUBBUUBBBBBUUUBBUUUBUUBUUUUUUUUUBUBUUBUBUUUUUUUUUBBUUUUUBUUBUUUBBUUUBUUBBUUUBBBUUU
BUBUUUBUUUBUBUUBUUUBBBUUUUUUUBUUUBUUUUUUBUUUBBUUUUBUUUUBBUBUUUUUUBUUUUUUBUUUBUUUUUBBUUBBBUUBBUBUBBUUU
UUUBUUUUUUUUBUUUUBUUUUBBBUBBUUBUBUUUUUBBBUUUBUBUBUUUUBBUBUBBBUUUBUBUUUBUUBUBUUBUBUBBUBUUBUUUBUBUBBUUB
UUUUUUUUBBUUBUUBUUUUUBBUUUUUUUUUUUUUBUBUUBUUUBUUUBUUUBBUBUBBUBUUBUUUBBBUUBBUUUUUBBUBUBUBBBUUUBUUUUUBU
UUUUBUUBUUBUUUUUUUUUUBBBUUUUBBUUUUUUBBBUBUBUUUBUUUUUBUBUUUUUUUUUUUUUBUBBUUUUUUUBBUUBUUUUUBUBBUUUUUUUU
UUUUUBBUUBBBUUBBBUBUUBBUUUUBUUUUUUUUUUBUBUUBUUUUBUUBUUUBUUUUUBUUUBUUUBUUUBUBUBBUUUBUUUUUUBUUBBBBUBUBU
UUUUBUUBUUUUUUBUBUUUUUUBUUBBUUUBBBUUUUUBUUUUUUUBBUUUUUUUBUBUUBUBUUBUUBBUBBUBUUUBUUBUUUUUBBBUUBUUUBUUU
UUBBBUBBUUUUUBBUBBUUUBUUUUBBUUBUUBBUUUBBBBUUBUUBUBUUUBBUUUBUUBBUBBBBBUUUUUUUUUBUUUBUUUUUUUUBBUBUBBUUU
UUUBUUUUBUUBUUUUBUUUUBUBUUBUBUUBUUUUUBBUUUUUUUUBBUUUBUUUUUBUBUUBUUBUUUBUUUUUBUUBUBBUUUUBUUBUBUUUUUUUU
BUUUUBUBBUUUUUUUBUBUBUUUBUUBBUUUUUBBUUBUBBUUBUUUUUBBUUUUBUUUBUBUBUBUBBUUBBUUUBUBBUBUUUBUBUBBBUUBUUBUB
UUUUUUBUUUBBUBUUUUBUBUUUUUUUUBUBUUUUUUBUBBUBBUUBBBUUBUUUUUUUUUBBBUUBBBBBUUUBUUUUUBUUUUBUUUBUUBBUBUBUU
UBUUUUUUUBBUUUBUBUBBUBBUUBUUUUBBBBUBUBUUUUBBUBUBUUUUUUUUUUUBUUUBUBBUUUUBUUUBUUBBUBUUUBBBUUUUUUUUUBBBU
UUBUBUUBUUUUBBUBBUUUBBUUUBBUUUUUUBUUUUUBUBBBUUUUUUBUBUUBUUUBUBUUUUUBUBUUUUUUUUUUBUUBBBUUBUUUUUUUUBUUU
BBUBUUBUBUUUBBBUUUBUUUBUUBBUBBUUUUUBUUBUBBBBUUUUBBUUUUUUUUUUUUBUUUUBUUUUBUUUUUBUBUBUUUUBUUBUBUUBUUUUB
UUUBUUUUUUBBUUBBUUUUUUUUUUUBUUUUBUUUBUUUUBUBBUUBUBUUUBBBUUUUBUUUBUBUUUBBUUUUBBBUUUUUUUUBUUUBUUBBUBUUB
UBBUUUBUBBUUUUUUBUUUUBUUUUUUUUBBBUUUUBBUUUUBBBBBBUUBBUUUUBUUUUUUUBBBUUUUUUBUUUUUUUUBBUUUUUUUUBUUUUUUU
UUUUUBUUBBUUUBUBBUUUUBUUUUUUBUUBUUUBUBBUBUUUBUUBBUUUUUUUUUUUUUUUBUUBBBUUUUUUBUUBUUUBUUUBBUUBUUUBUUUUU
UUUUBUUUUUUUUUUBUUUUUUBUUBUBBUBUUUUUUUUUBBUUUUUBUUBUUUUBUUUUUBUUUUBBUUBUUBUBUBUBUUUUBUUUUBUBBBBBUUUBB
UBUUUUBBUUUUBUBUUBUUUUUUBUBUBUUUUUUUUUBUUBUUUUUUUUUUUBUUUBBBUBUUUUUBUUUUBUUUUUUUUBBUUUUUUUUUUUUUUUUUU
UBUUBBBUUUUUBUBUBBUBBUUBUBUUBUUUUUBBBUUUUUBBBUBUUUUUUBBUUBUUUBUUUUBBUUUUBUUUUBBUUUUUUUUUUBUUUUBUUUBUU
UUUBUUUBUBUUBUUUUUUBBUUBUUUUUUUUUUUUBUBUBUUUUUBUBUUUUUUUBBUUUBUUUUUBUBUUBUBUBUBUUUUUUUUBBUUUBUBBBBUUU
UUBBUUUUUUUBBBBUUUBUUUUUBBUUBBUUUUBUBUBUBUUUUBBUUUUBUBUUUUBUBBUUUBBUUBUUUBBBUUUBUUUUUUBUUUUUUUUBUUUBU
BUUBUUUUBUUUUBUUBUUUUUUUBUUBBBUBBUBUBUBUUBUUUBUBUUBUUUUBUUUUUBBUUUUUUUUBUUUBUBUUUUBUUBUUUUUBBUUUUUBUB
UBBUUBUBUUUBUUUBUBUUUUUUUBBBBUUBBUUUBUUUUUUUBBUUBBUUUUBBUUUUUUUUBUUBUUUUUUBUUBUUUUUUUUUUBUUBBBUBUUUUB
BUUUBUBUUUUBUUUBUBUBBUUUUUBUUUBUUUBBUUUUUUUUUUUBUBUBUUBUUUUUUUBBBUBUBBUUUUUBBUBBBBUUBUUUUUUBBUBUUUUUB
UUUUBUBBUBUUBBUUBUUBUUUUUUUUBUUBBBBUUUUUUUUBUUUUBBBUUUUUBUUUUUUUUUUBBBUUUUBUUUUBUUUUBUUUBUUUUUUUBUUBU
UUUUUBUUUUUUBUUBUUBUUUUBUBUBBBUUUBUBUBUUUUUUUUUUUBBBUBBUBUUUUUUUUBBUUBBBUUUUUUUBBUUUBUUUUUBUUBUUUUUUU
UUBUUUBUUUBBBBUBUUUBUUUUUUUUUUUBUUUBBUBUUUBUBUBUUUUUUUBBBUBUUUBUBBBUUUUUUBUBBUUUBUUUUUUUUBBUBUBUUBUUU
UBUUUUUUBUUUBBUBUUUUUUUBBBUBUUUUBBUUUUUUUUUUUBBUUUUUUUUUUBUUBBBBBUUUUUUUUUUUUBBBUUUUBUBUUUUUUUBBUUUUU
UBBUBBUBUBBBBBUUUUUUUUBBUUUUUBUUUUUBBUUUBBUBUUUUUUUUUUUBBBBUUUBBBUBUUUUUUBBUUUBUUBBUUBUUUUBUBBUUUUUBU
UUUUUUUBUUBUUUUBBUUBUUUUUUUBUBBUBUUBUUBUUUBBUUUUUBBBBBUUUUUUUUUBUUUUUBUUUBUUUBUUBUUBUUBUUUUUBUBUBUUBU
BUUBUUUUUBUUBUUUBUUUUUUBUUUUBUBUBUUUBBUUUUUBUUBBBUUUUUBUUUUUUUUUUUUBBUUUUUUUUUUUUUUUUUUUUUUBUBUBUUBUB
UUUUUBUUUBBUUUUBBBBBUBUUUBUBBBUUUBUUBBUUUUUUBUUBUUBUUUUBUBBUUUBUUUUUUBBBBBUUUUUUBUBUUUUUUUUBUUUBBUUUU
BUUUUUUUBBBUUBUUUUUUUUUUUBUBUUBUBUUUBBUUUUUUBUUBBUUUUUBUUBBBUUBUUBBUUUUBBUUUUUUUUUUBUUUUUBUUUUUUUBBUB
UBUUUUUUUBUUUUBUUBUUBUUUUUUBUUUUUUBUUBUBBUBBBUBUUUUBUUUBUUUUUUUBUUUBUUUUBBBUUUUUUBUUUUUUUUUBUUUUUBBUB
UBBUUUUUUUUBUUBBBBBUUUBBUUUBUUUUUUUUUUBUBUUUUUUUUUUUUBBBUUBBUUUUBUBBUBUUUUUUUBUUBBUUUBUUUUBUUUUBUUUBU
UUUUUUBUBBBBBUUUUUUUUUUUUUBBUUUUBUUUUUBBBUUUBBUUUUUUUUUBUUUBUUUBUUBBBBUUUUUBBUUUUUBUUUUBUUUUUUBUUUBUB
UUUUUBUUUUUBUUUUUBBUUUUUUBBUBBUUUUUUUUUUUUUUUUUBUUUBUUUUUUBBUUBBUUUBBUBBUUUBUBBBUUUUBBUUUBBUUBUUUBBBB
UUBUBBUBUUUUUUUUUBUBBUUUUUUUUUBBUUUUUUUBUUUUBUUBUUUUUUUUUUUUUUUUUUBUUUBUUBBUBUUBUBBUBUUBBUBUUUBBBUBUB
UBUUUUUBUUBBUBUUUUUUBBBUUBUUUBUUUBUUBUBBUBUUUUUBBUUUBUBBBUUUUBUUBUBBUUBUUUBUUBBBBUUUUBUBUBUUBBUUBUUUU
BUUBUUBBUUBUUUUUBBUBUUUUUBBBBUBBUBUUUBBBUUUUUUUUBUUUBUUBUBUBUBUUUUBUUUUUBUUBUBUBUUBUUUUUBBUBUUUUBUBUB
BBUBUUUBBUBUUUUUUUUUUUUBBUUUUUBUUUUUUUUBUUUUUUUBUUUUBUUUUUUBBUUUBBUBUBUUUBUBUUBUBUUUBUUUBUUUUUUBBUUBU
UUUUUUUUUBUUBUBUBBBBBBUBUUUUUUBUUUUUBUUUBUBUBUUUUUBUBUUUUUBUBUUUUUUBUUUUBBUBUUUUUBUBBUUUBBBUBUUBUUUUU
UUUBUUUBBUUUBBUBBBUUUBUBUUUBUUUBBBUUUBUBBUBUUBUBUUUBUBBUBUBUUUBUUUUUBBUUUBBBUUUUUUBUUUUUUBUUUUBUUUBUU
BUUUUUUUUUUBUUUUUUUUUUBBBUUUUBBUUUUBUUUUUUBUUUUUUUBUUUUUBUUUUUUUUBUUBUUUUUBBBUBBUUUUBUUUUUUBUBUUBBBUB
BUUUBUUBUUBBBUUUBUUUBUUUUBBBUBUUUUBUUUUUUUBBBUBBBUUUBUUUUBBUUUUUUUUBUUBBUUUBBUUBBBUUUUUBUBUUUBUUUUUUB
UBUUBUUUBUBUUUBUUUUUUUBBUUBUUUBUUUBBBUBUUUBBBUUUUUBBUUBBUUBBUUBUUUBUBUBBUUBUBUUUBBUBBUBUUUUBUUUUUBBUU
UUUUBUUUBUUUUBBUBBBUUUBUUUUUBUBUUUUUBBUUUUUUUUBBBUUBBUBUUUUUBBBUUBBUUUBUBBUUUUUBUUBUUUUUUUUBUUUUUUBUU
UUBUUUUBUUUBBUUBUUUUUBUUBUBUUUBBUUUBBUUBUUUUUUUUUUBBUBUUBUUUBUBUUUUUUUUUBBUUUUUBUUUUUUBUUBUUUUUUUUBUU
UUUUUUBUUUBUUUUUUUBBUUUUBUUUUUBBBUUUUUBUBUUUUUUUUUUBUUBUUBUUUUUUUUBUBUBUUUUUBUUUUUUUUBUUUBBUUUUUBUBBB
UBBUUBUBUUUUBBUUUUUUUUBBUUUUBUUUBBBUBBUUUUUUBUUBUUUBUUUBBUBBUUBUUUUUUUUUUBUUUUUUUUUUUUUUUBUUBUUBUUBBB
UBUBUBUUUUUUUUBUUUUUUUUUBUUUUUUUUUUUUUBUUBBUBBBUUUBBUUUUUUUUBBUBBBUUBUUUUBUUUUUUUUUUUBUUUBUUUBBUUBBUU
UBBBUUUBBUUUUUUUBUBBUUBBUUBBUUUBUBUBUBUBBBUUBUUUUUUUUUBUUUUBUBBBUBBUUUBUBBUUBUUBBUBUUUUBUBUBUUUBBUUBB
UUUUBBUBUUUBUUBBUBUBBUUUUBUUUUUUUBBUUUUUUUUBBUBBBUUUUUUBBUBBUUUUBUUUUUBBUUUUUUUUBUUUBBUUUBUUBUUUUBUUU
UBBUBUUUUUUBUUUUUUBBUUUUBUUUUUUUUUUBUBUBBUUUUUBUUUUBUUUUUBUUBUUBBUUUBUUUUBUUUUUUUBBUUBUUUBUBUUUUUBBBU
UUUUUUUBUBUUUBUUUBBUUBBUBUUUUBUBUUUBUUUUUBUUUUUUUUBUUUUUBUBUBUUUBUBUUUUUBUUUUUBBBUUBBUUUUBBUUUUUUBUUU
UUUBUBUUUBUUUUUUBBBBBUUUUBUUUBUUBUUUUBBBBUBBUUUUUBBUBUUUUUBBUUUUBUUUUBBUBBUBBBUUUUUUBUUBUUUUUUUBUUUUU
UUUBBBUUUUUUUUUBUUBUUBUBUUUBUUUUUUBBUBBBBUUUUUUBUUBUBBBUUUUBUUUUBUUUUUUUUBBUBUBUUUBBUBUUUBUBUUUUBUUUU
BBUBUBBUBUUBBUUBBBUBUBBUUUUUBUUUUBUBBUUUBBUUBUBUUUBUUUUUUUUUUUUBUBUUUUUUBBBUBUUUUUBBUBUUBUBUUUUBUUUUU
UUUUUUUBUUBUUUUUUBUBUUUUUBUBUBBUUUUUUUBUUUBBBUBUBBUUBUUUBUUUBBUBUBBBUUUUUUBUUUUUUUUUUUUUUUUUUUBBUUUUU
UBUBUUUUUBBUBUBBUUBBUUUBUUUUUUUBUUBBUUBUUUBBUUBBBUBBUUUUUUBUUBUUUUUUUBUUUBUUBBUBUUUUUUUBUUUBBUUUUUBUU
BUBBUBBBUUUUUUBBUBBBBUUUUUUBBUUUBBBUUUBUBUUUBUUUBUUBBUBUUUUBUUUBBBUUBUBBUBBUUUUUBUBUUUUBUUUBBUUUBUUUU
UBUUBUBUUBBBBUUUUUBUUUUUBUUUUUUUUUUUUUUUUUUUUUUBBUUBUUBBUBUUUUUUUBUUBUUUUUUUBUUBUBUUUUUUUUBBUUUUBUUUU
UUUUUUUUUUUUBUUUUBUUBUUBBUUUUUUBUBUUUUUUUUUBBUUUUUUUUBUUBUBBUUUUUUUUBUBUUUUUUUBUUBUBUBUBUUBBUUUUUBUUU
UUUUUBBUUUUBUUUBBUBUUUBUUUUUUBBUBUUBUUUBBBBBUUBUUBBUUBBBUUUBBUUUUUBUUBBBUUUUUBUUUUUUUBUUUBUUUUUBUUUUU
UUBUUBUUUBUUBUUBBUUBUUBUUBUUUUUUBUUUUUUBUUUUUBBBUBBUUBBBBBBUBBUBUUUUUUBBUBUUUUUUUBUBUBUUBBUUBBUUUUUUB
UUUBUUBUUUBUUUUUUUUUUUUUUBUUUUBUUUUUBBBBBUUUUBUUUBUBUUBBUUUUUUUUUUUUUUBBUUUBUUBUUUBUUUUBBBUUUUBUUUUUB
UUUBUUUUUUUUUUBBUBUBBUUUUUUUBUBUUBUUBUBUUBBBUUBBUBUBBUUBUUUBUBUUBBUUUBUUBUUUUBUUUUUUUBUUBUBBUUBBBUBBU
UUUUBUUUBBUUBUUUUUUUUUUBUBUUBUUUBBUBUUBUUUUUBUBUBUBBUUUUUUBUBUBUUBUUBBUUBUUUUBBUBUUUBUUUBUUBBUUUUUUUU
UBUBUBUBUBUUBUUUUUUUUBUBUUBUUUUUBBUBBUUUUBBBUBUBUUBUUBUUUBUBUBBBBBUBUBUBUBBBUUBBUBUUUUUUUBUUBUUUUUUUU
BUBBUUUUUUUBUUUUUUUUUUUUUUUUUBUBUBUBUBUBUUUBUUUUBUUBUUUBBUBUBUUUUUBBUUUUBUUBBBUUUUUBBUUUUBBUUUUUUUUUU
UBUBUUBBUUUUUBUUUUUUUUUBUUUUBUUUUBUUUUUUUBBBUUUBUUUBUUUUUUUUUUUBUUUUUUBUUBUUUUUBUUUUUBUUUUUBBUUUUUBUB
BUUUBUBUUUUBBUUBUUBBUBUUBBUBUBUBUUBUBUUUUUUBUUUBUUUBBUUUUUBUUBUUUBUBUUBUUUUUUUBUBUBBUUBBUUUUUBUBUUUBB
UUBBUUBUUUUUBUBBBUBBUBBBUUUUBUBBBUBUUBUUUUUUUUUBUUUUUBBBUBUUUBBBUUBUBBUUBBUUUUUBUBUUBBUUBBUUUBUBBBBUB
BUBUUBUUUUBBUUUUUBBUUBUUUUUBUBUUBUUUUBBBBUUBUBUUBUUUBUBBUUBUUUUUUUUUBUUUUUUBUUUBUUUUBUBUBUUUUBUUUUUUU
UUUUUUUUUUUUUUBUUBUUUBBUUUBBUUBBUUUBBUUUUUBUUBBUUUUUUUUBBBUUBBBUBUUBUUUBUUUUUBUUBUBUUUUUUBUBBUUBUUUUB
UUUUUUUUUUUUUUUBUBUUUBUBBUBUBUUBBUUBBUUUUBBUBUBUUBUUBUUUUUUUUUUBUUBUUUUUBUBUUUUUUUUBBUUUUBBBUBUUBUUUU
UBBBBUUUBUUBBUUUBUUBBUUBUUUUBBUUUUUUUUUBBUBUUBUUUBUBBUBUUBUBUBUUUUBBUUUBUUBUUUUBUUUUBBUUUUUBBUUBUUUBU
UUBUUBUUUBUUUBUBUBBBUUBBUUUBBUUBUUUUUUBBUUBUUUUBUUBBUBUUUUUBUUBUBUBBUUUUUUUUBUUBBUUUBUUUUBUUUUUUUUUBU
UUUUUBUBBUUUUBUUUUBUBBUUBBBUBBUUBUUUBUUBUUBBUUUUUUBUBBUUBUUBUUBUBUUBBUBUUBUUUBUUUUUUUUBUBUUUUBUUUUBUU
BUBUUUUUBUBUUUBUUUBUUUUBUBUUUUUUUUBBBBBUBUUUBUBUBUUUUUUUUBBUBBBBBUUUUUUBUUBUUUBUUUUUUUUUUBUUUUBBUUUUB
BUBBUBUBUUUBUBBBUUUUUBUBUUBUBUUUUBUUBBUUUBUUUUUUBUUUUBBBUUUBBBUUUBBBUUBBUUBUBBUUUBUUUUBBUUUUUUUUBUBUU
UBUUUUUUUUUUBUUBBUBUBBUUBUUUUUUUUUUUUBUUUBUUBUBUUUUBBUBUUUUUUBUUUUBBUUUBBUUBUBUBBUUUUBUBUUUBUUUBBUBUU
UUBUUUUUUUUUUUUUBUUUBUUBBBBBUBUUUUUUBUUBBBUUUBBUUUUUBUUUUUBBUUUBUUBUUUBUUBBUUUUUUUBUBBUBUBUBUUUBBUBUU
BUUUBUUUUUUUUUBUUUUBUUUBUUUUUUUUUBUUUUUUBUUBUBUUUUUBUUUUBUUUUUBBUUUUUBUUBUUUBBBBUBUUUUUUBBUUUBUBUUBUB
UUBUUUUUBBUUBBBUUUUUUUUUBUUUBUUBUBUBBUBBBUUUUUUBUUBBUBUUUBBUUUUBBUUUUUUBBBUBUBBBUUBUUUBUUBBUBBUUUBBBU
UBUUUUUUUBBBUUUUUBBBBUUBUBUUBUUUUBBBUBBUUBUUUUBUUUBUBBUUUBBUUBBUUBUUUUUUUUUUUUUUBUUBUBBUBBUUUUBUUBUUU
BUUUUBUUUUUUUUBUUBUUUBUUUUUUUUUUUUUBBUUUUUUUUBUUUUUUUUUUUUUUUUUUUBBUBUUUUUBUUUUUUUBUBUUBUUUBUUUBUUUUU
