UUUUUUBUUUUBBUUBBUUUBUBUUUBUUUUUUUUBUBBUBUUUUUUUUUUUUUUBBUUBBUUUBUUUBBUUBBBUUUBUBUBUUUBUBUUBUBUBBBBUU
BUBUBUUUUUBUBUBUUBBUBUBUUUBUBBUUBUUUBBUUUUUUUUUUUUUUUUUUUBBUUUUBUUUUUBUUUUUUUUBBUBBUUUBUBBUUBUBUBUBBB
BBBUUUBBUUUUBUBBUUUUBUUUUUUUBUUBUUUBBUBUBUBUUBUUUUUBBUBBUUUUBUBUUUBUBUUBUUUUBUUBUUUUUUBUUBUUUBBBUUUUU
UUUUUUBUUBUBUBUUUBUUUUBUBUUUUUUBBUBUBUUUUUUUBUBUUBUBUBBUBBUUBUUBBBBBBBBUUBUUUBBBUBUUUBUUUBUUBBBUBBUUB
UBUUUBBBUBUUBUUBUUUUUUBBUUUUBUUUUUUUUUUUUUUUUBBBUBBBUUBUUUUUUUBUUBUUUUBUBBUUUBBUUUBUBUUUBUBUBUUUUBBUU
UUUUBUBUUUBUUUBBUBUBBUUUUBUBUUBUUUUBBUUBBUBBBUUUBUUBUUUBUBUBUUUBBUUBUUUBUUUBBUUUUBUUUBUBUBBUUUUUBBUUU
UBUUBUUUUUBUUUBUUBUBUUUUUUBUUUUUUUUBUUUUUUUUBUUUBBBUBBUUUBUUBUUUBBUUBUBUBBUUUUUUUUUUUUBBBUUBUUUBUUBBU
BBBBBUUBUBUUUUUUUUUUBUUUUUUBUUUUUUUUUBUUUUUUUUUBUBUBUUBUBUUUBUBUUBUUUUUBUUBUUUBUBUUUUUBUUUUUBUUBBBUBU
UUUUUBUUUUUBBUUUUBUBBBUUUBUUUUUUBUUBUBUBUBUUUBUBUUBBBUBUUUUBUUUBUUUUUBUUUBUUUUUUUUBUUBUUUUBUUUUUUUUBU
BUUUUUBUUUUUUBBUUBBBUUBBBUUUUUUBUUUUUUUUUUBBBBUUBBUUUUBBUBUUBBUUBUUBUBUUUUUUUBBBUUUUUBUBBBBBUBUUUUUUU
BUBUBBBBBUUBUBUUUBBUUUUBUBUUBBBUBBUBUUUUUUUUUUBUUUBUUBUUUUUUBUUUUUBUUUUBBUBUUBUUBBUUUUUUBBBUBUUUUUUBB
UUUBBUBUUUBUUUUBBUUUUUUBBUBUBBBUUBUUBUBUUUUUUBUUBUUUUUBBUUUBUBUUUUBUBBBUBUUUUBUUBUUUUUUUUUBBUUUUUUBUU
UUUBUUUUUUUBBUBUUUUUUBUUBBBUUBUBUUUUUUUBBUUBBUUBUUBUUUBBUUUBBUBBUUUUBUUUBUBUUUUUUBBUBUUUUUUUUUUBUUUUU
UUBUBBBBUUUUUBUUUUBUUUUBUUUUBUUUUUBUUUBUUBBBUUUBUBUUUUUUBBUUUUBBUUUBUBUUBUUUUUUUBUUUUBUUBBUBBUBBUBBUU
UBBUBUUUBUBUUUBBUUUUUBUBBUUUUBUBUUBUUUUUUBBUBBUBUBBUBUUUUBBUBBBUUUUBUUUUUUUUUUUUUUBUBUUBBUUUBUUBUUUUB
UUUUBUUBUUBUBBUUUUUUBUUUUUBBBUBBBBUUBUBUUUUUUBBUUUUUUUUBUBUUUUUUBBUUUUUUBUBUBUUUUBUUUBUUUUUBUUUBUUBUU
UBBBBBBBUUUBUBBUUUBUUUUUUUUUUUBUUBBBBUBUUUUUBBUUBUUUBUUBBUUUBUUUUUUUUUUUBUBBBUUUUUUUBUUUUBUUUBBUUUUBB
UUUUBUBUBBBUUUBUUUUBUUUBBUBUBUUUUUBUBUUUUUUUBUUUUUUBUUUBUUUUBUUUUUUBUBBUUBUBUBUUUUUBBUBBUUUUBBBUUUUUB
UUUBUUUUUBBUBUUBBUBUUUBUBBBUUUUBBBUUBUUBUUUUBUUUUUUBUBBUUUBBUUUUBUUBUUBUUUBUUUUBUUUUBUBUUUUUBUBBBBUBU
UUUUBUUUBUUUUUBUBUUBUUBUUUBUUUBUUBUUBUUUUBBBBUUUUUBUBUBUBBBUUBBUBUUUUUUBBUUUBUUBUUUUUUBUBUUBUBUUUUUUU
BUUUUUBBUUUUBUUUBUBUUUBUBBBBUUUBBBBUUUUBUBBUBUBUBBUBUBBUUUUBUBUUUUUUUBUUUUUUBUBUUUUUUUUUUUBBUUUUUUUUU
UUUUBUUUUBUUUUUBBBUUUBUUBUUUUBUUUUBUUUBBUUBUUUUBUUBUUBUUUUUBUBUUUUBBUBUUUUBUUBBBUUUBBUUUBUUUBBUUUUUUU
UUUUBUBUBBUUBBBUBUUUUUBBUUBUBBBUUUUUUBBBUUUBUBUUBBUUBBBBBUUUBUUBUBUUUBBUUUBUUBUUUUBUBUUUUUUUUBBBBUUUB
BUUBUUUUUUUUUUUBBUUUUBBUUBBUUBBUUUBUUBBBBBBUUBUBUBUUUUUBUUUBUBUBUBBUBUUUUUUUUBUBBUBUUUUUUUUBUUUBUBUUB
UUUUUUUUUUBBUBUUUUUUUUUBBBUUBUUBBUUUUUBUUUUUUUUBUUUBBUBUBUUBUBUUBUUUUBUUUUUUUUUUUUBUBBBUUUUUUUUUUUUUU
UUUUUUUUUUUUUUUUUUUUUBBUUUUUUBBUUUBUBBUUUBBUBBUUUBBBBBUBUUUBUUUUUUUUUBUUUUUBBUBBUBUBUUUBBUUUUBUUUUUBB
BUUBBUUUUBUUUUUUUUUBUBBUUUUUBUUUUUUUBUUBUBUBUBUUBUBUUUUUUUBBUUBUUBBUUUUUUUUBBUUUUUBUUUBUUUUUUUBUUUUUU
BUUBUUBUUUUUUUBUBUUBBBBUBUBUUUUUUBBUBUUBUUBBUUBUBUUUUUUUBBUUUBUUUUBBUBBUUBUUUUUBBBUUUUBBUUUUUUUUUBUUU
UBBBUUUUBBBUUBUUUUUUBUUUUUBBUBUUBBUUUBUUUBBUBUUUUUBUUUBUBUUUUUUUUUUBBUBUBUUUBUUUUBUUBUUUUUUUUUBUUBUUU
BUUUUUUBUUBUUUUUBUUUUUBBUUUBBBUUBBUBUBBBUBUUBBUBUBBUBUBUBUUUUUBBUBBBBBUUBBUBBUUUUUUUUUUUUBUUUBBBBUUUB
UBUUUUUUBBUUUUUBUUUBUUUUBBBBUBBUBUUBUUBBBBUUUUUUUUBUUUBBUBUBUUBUUUBUUBUBBUUUUUUBUUBUUBUUBUUUUBUUUUUUB
BUUBBUBUUUUUUBUBBUUUBUUUBBUUUBUBBBUUBUBBUUUUBUUBUUBUUUUUUUUBBUUBUUUUBUUUUUBUUBUUUUUBUBUUUBBUBUBUUUUUU
UUUBUUUUUBBUUUBBUBUBUUUUUUBBUBUUUUBBUUUBUUUUUUUUUUUBUUBBBBUUUUBUUUUUBUUUUUUBUBBBUUUUUUUUBBUUUBUUUUUUU
UUBBUBUUUBUBUBUUUBBUUBUUUUUUBBUUUUUUUUUUUUUBUUUBUBUUBUBUUBBBUBUBBBUUUBUUUUBUUUUBBUBUUUUBUUUUUUUUUUUUU
UBBUUUBUBBUUBUUUUUUUUUUUUUUUUBUUBUUBUBBUUUUUUBUUUUUBBUBUBUBUUUUUUUUUUBBUUUBBUUBUUBUUUUBBUUUUUUBUUBBUU
UUBUUUUBUUBUUUUUUUUUUUBUBBUUBUBUUUUBUUUUUUBUBUUUBUBUUBBUUUUUBBUBUUBUUUUUBBBBUBUUUBBUUUUUUUUBUUUUUUUUU
UUUUUBBUUBBUBUUUUBUUBUUUBUBUUBBBUUBUUBUUUUBBUUUBUBBUBBUUUBBBUBUUUUUUBBUUBBBUUUUUUBUUUUUUUUUUUUUUUBUBB
UUUUBUUBUUUBUBBUUBBUBUBBUBBUUUBUUUBUUUUUBUUBUUBUUUUBUUBUBUBUUUBUBUBBUUUBUUBUUUBUBUUUUBBUUUUUUUUBUUBBU
UUBUUBBBUUBUBUBUUUUUUUUUUUUUUUBUBUUUUUUUUUBUUUBBUUUUUUBUUBUUBUUBUUUUUUBBBUUUBBUUUUUUUUBUUUBUBUUBBBBUU
BBUUBUBUBUUUUBUUUUUUBUUUBUUUUUUBBUBUBBBUBUBUUUUBBUUUUBUBUUUUBBUUUUUUUUUUUUUUUBUUUUBUUBBUUUUBUUUBUBUUU
UBUUUUBUBUUUUBUBUBUUUUUBBUUUBUUBBUUUBUUUBBUUUUUBUUBUBBUUUUBUUUUUUBUUUUUUBUBUUBUBBUBUBUUUUBBBUUUUBUUUU
BUBUUUUUUUUBBBBUUUUUBUUBBUUBBUUUBUUBBUBUBUUUBUUUBBBBBUUUBUUUBBUUUBBUUUUUUUUBUUUBBUUUUUUBUUBBUBUBUBUBB
BUUUBUUBUUUBUBUUUUBUBUBUUUBUUUBUBUBBUUUUUBUUUUUUUUBUUBUUUBUUBBBUBUUUBUUBUUBUUUUUBUUUUUUUUUUUUUUBUBUUB
UBUUUUUUUUBUUUUUBUBBUBBUUUUUBBUUBUBUBUBUBUUBUUBBUUUUUBBBBUUUUUUUBUBUUUUUUBUUUBUBBUUBUUUBUUUUBUUBUBUUB
UUBBUBUBUBUUUUUBUBBUUBUUBUUUUUBUUUUUUBUUBUUBUUBBBUBUUUBUBUUBBBUUUBBUUUUBUBBUUUBBUUUBUBUUUBBUBBUUUUUUB
UUUBUUUBUBUUUBUUBUBUUBBUBUBUUUUUUUUBUUUUBUUBUBBUUUUBUUUBUBUUUUUUUBUUUUBUUUUBBUBUUBUUBUBUBBUUBBUUBUUBU
UUBUBBBUBBUUUUUUBUBUUUUUBBUBBUUUBBUUBBUUUUUBUBBUUBUUUBBUUBBUUBBBUUUBBUUBUUUBBUBUUBBUBBUBUUUUBUUUBBUUU
BBBUBUUBUUUBUUUUUBUUUBUBUUUBBUUUBUBUBUBUUBUUUUUBUBUUUUUUUUBUBUBBBBUUUUBUBUUUUUBUBBUUUUUUUUUUUUUUUUBUB
UUUBUBUBBBUUUUBBBBBUBUUUBUBUUBUUUUUUUUUBBUUUBBUUUUUBBUUBBBBUUUBUUUUBUBUUUUUBUUUBBUUUBUUUUBUUUUBBUBBUU
UUUUUUUUUBUUUUBUUUBBUUUUUUUBBUUBUBUBBUBUUBUBBUUUUBBUBUUBUUUUUUUUBBUUUUUUUUUUUBUUUUBUBBUUBUUUUUUUUUUUU
BUUUUUUBUUBUUUUBUBBUUUUUBBUBUUBUUUUUUUBUUUBBUBBUBUBUUBUUBUUUBUUUUUUUUBUUBUBBUUUUUUUUUUUUUUBUBUUUBUUUB
UUUUUUUBBBBUUUUBUUUUBUUUUUUBUUUBBUUUUUUBUBUUUUBUUBUBUUBUUBUUUUUUUUUUUBUUBUUUUUUBBBUUUBUUUBUUBBBBUBUBB
UBUUBUUUUUUUUUUUUUBBUUUBUUUUUBUUUUUUBBBUUUUUUBBUUUUUUUUUUUBBBBUUBUUBUUUUUUUBUUBUBUBUBBBBUBUUUUUUUUBUB
BUBBUBUBUUBUBUUUBBBUUBUBUUUBBBUUUUUUBBUUBUUUUUUBUUUBUUBUUBUBUUBBUBUUUBUUBUUBUUBBUUUUBBBUUUUBBUUBBUUUB
UUBBBUUUBUUUBUUUUUUUBUUUUUUUBUBBBUBUUUUBBUUBUBUBUUBBUUBUBBUBBUUBBUUUUUUUBUBUUUUUUUBUBBUBUBUBBUUUBUUUU
UBUBUUUUUBBUUUUUUUUUBBBBUBBUBUBUUUUUUUBBUBUBUUUUUBUUUUUUUBBUBUUUUUBUUBUBUBUBUUUUBBUUUBBUBUBUUUUUUBUUB
BUBUUUUUBUUBUUUUUUUBUBBUBUBUUBUUUUBBUUUUBUUUBUUUUUUUUBBUBUUBBUBBUBUUBUUBUBUUUUBUUUBBUBUBUUUBUUUUUBUBB
UBUBBUBUUUBUUUBUUUUUUUUBUUBUUUUUUUUUUUBUUBUBUBBUUUUUUUUUUUBUUUUBUBUUBUBBUBUUUUBBUUBUUBUBBUUUUUUBUUUUB
UBUUBBUUUBUBBUUUUBUUUUBBUUBUUUBUUBUUBUUBBUBUUUUUUUUUUUUUUBUUUUBUUBUUUUBBUUUUUUBUBBUBUUBBUBUBUBBUBUBUU
UBBUUBBUBUUUUUUUBUBUUUUBUUUUBUUBUUBUUUUUBBUUUUUUBUBBUUBUBBUUUUBUUUUUUUUBUUUUUUUBBBUUUUUUBBBBBUBBBBUUU
UUUUBBUUUUUUUUUUBBUUUUUBBBUBUUUBUUBBUUBUUUUUUUUUUUUUUBBBUUUBUUUUUUUUUBUBUUUBUBUUUBUUBUBUBUBBUUUUBUUUB
UBUUUUUUBUUUBUUUUUUUUUUBBBUBBBUUUUUUBUUUUUUUBUBUBUBBUUBBBBUUBUBUUUUUBBBUUUUBUUUUBBBUUUBUUUUUUUBBBBUBB
UUUUUUBUUUUBUUUUUUUBUBUUBUUUUBBUBBBUUUBBUUUUBBBUBUBUUBUUUUUUBBUBBBUUUUUUUUBUUUBUUBUBBUUUUBBUBUBUUUUBU
BUUUUUUUUUUBBUUBUBUBBUUBUBUBUUBUUBBUUBUUBBBUUUBUUUUBUUUUUUUUUUUUUUUBUUUUBUUUBUUUBUUBUUUBUUUUUBUUBUUUU
BBUUUUBUUUUUUBUUBUUUUUBUUBUUUBUBUUUUUUUBUUBUUUBUUBUUUBUUUUUUUBBBUUUUUUUUBBBUUUBBUBBUUUUBBUBUBUBUBBUBB
BBUUUUUBUUUBUUUUUUBUUUUBUBBBBUBBUUUUUBUUBUUBUUBUUBUUUUBBUUUUUUBUUUBBBBUBBUUBUBUUUUBUUUUUBBUUUUUUUBUUU
UUUBBBUUUBUUUBBUBBUUUUUUBBUBUUUBBUUUBBBUUUUUUUBUBUBUUUUUUBUUBUUBBUUBBUUUBUUBUUBUUUUUBUBUBBUUBBUBBBUUB
UUUUBBUBUUUBUUUBUBUUUUUBUUUBUBBBUUUBUUUBUUUUBUBUUBUUUBUUUBUUUBUUUUUBUUUUUUUUUBBUUUUBBUUUBUUUUBBUUUUBB
BBBUUUBUBBUBUUUUUBBUBUBUUUUUUBBUUUUBUUUUUUUUBUBUBBUUUUUBBUBUBUBBBBBBUUUBUUBUUUUUUUUUUBUBBUBBUBUUUUBUU
UBUUBBBUBUUBUUUUUUUUUUBUUBUUUBBBUUBUUBBBUUBBUUBUUUBBUBUUUBUUBUBBUBUUBUUBBUUUBUBUUUUUUUUUUUUBUUBBBUBBB
UUBUBUUBUUUUUBUUUBUUBUUUUUBUUUBUBBUUUUUUBUUBBBUUUUUUBUUUUUUUUUUUUUBUBUBBBUUUBUUUUUBBUBUBUBUUUUUUUUUBU
UUUUUUUBBUUUBUUUUUUUUUUUUUBBUUUUUUBUUUUUUUUBUUUBBBUUUBUUUUBUUBUUUUUBBUUUUUUUBUUUBUUUBBUUBUBUBUBBUUUBU
UUUUUUUBBUUBBBBBBUBBBUUBBUBBBBUBBBUUUUBUUUUUBBUUUUBUUUBBUBUUBBUBUBUUBUUUUUUUUUBUUUUUUBUUBUUUUUUUUUUUB
UUBUUBUUUUBUUUUUUUBUBBBUUUUUUUUUUUUUUUUUUBUBUUUUUBUBUUUUBUUUUUUBBUUBUUBBBBUUUUUUUUUBBUUBUUUUUBUBUBBUU
BUUBBUUBUUBUBBUBUBUUBUBBUBBUUUUUBUUUUUUUUUBBUBUUUUUBBBBUUUUUUUUBUUUUBUUUUUUUBUUUUUBBUUUUUUBUUBUUUUBBU
BUBUUUUBUUUUUUUUUUUUUUUUUUUUUUUBUUUUUUUUBUUUBUBUBUUBUBUBUBUBUUUUBUUUUUUUBBBUUUUBBBBBUUBBUUUUBUUUUUBBU
UUUUUUBBUBUUUUUUUUUUBBUUUUUUBBUUUBUUUBBUUUBUBBUUUUUUUUBUUBUUUUBUUUUUUUBBBUUUUBUUUUBUUBUBBUBUUBUBUUUUB
UUUUUBBUBUBBBUUUBUUUUUUUUBUUBUUUBUUUUBBUBUUBUBBUBUBBUBUUUUBUBUUBUUUUUBBUUUUBUUUBUBUUUUBBUUBUUBBUUUBUU
UUUUUUUBUBUUUUBBUBUUUUUBBUUUUUUUBBUUUBUBUUUBBUBUUBUBUUBUUUUUUBUBUBUUUUBUBUBBUUBUUUBUUUUUUUBUBBUUBUUBU
UUBUBBUUBBUUUUUBUUUUUUBUBUUUUUUBUUUUUBUUUBUBUUUUUUUUUUUBUUBUUUUUUUUUBUBUUUUBBUUUUBUUBUUUBBUUUUBUBBUUB
UBUUUUUUBUUUUUUBBBUUUUBBUUUUUUBUBUBUBBBUUUUUUUUUBUUUUBUUUUUBUUUUUUUBUBBUUBBUUBUBUUUUUBUUUBUUUBUBUUUUU
UUUUBUBUUBUBUBUUUUBBBUBUUUUBUUBUUBUUUUUUUUUBUUUBUBBUUBUBUBUBUUUUUUBBUUBUUUBBUUUUBUUUUUUUUBBBUBUUBBBUU
UUUUUUUUUUUBUUUUUUUUUUUUUUBUUBBUUUUBUUUUUUUUUUUBUUUUUBUUUBBUUUBUBUUUUBUBUUUBBUUUUUBBBUBBUUUUUUUBUUUUU
UUUUBUUBBUBUUBUBBUBUUUUUUUUBBBUUUUUBUUUBBUUBUUUUUUBUUBBBBUBUUUBUUUBUUUUBUUUUUUUUBBUUBUUBUUUBUUBUUBUUU
BUBBUBUUBUUBUUUUBUUUUUUBUBUUBUUBBUBUUBUBBUUUUUUBBBUUUUUUUUBBUUBUUUBUUUUBUUUUUUBUUUBUUBBUUUUUUUUUBUUUB
UBUUBUUUBBUBUUUUUUUUUUUUUUBBBUUUUBBUBBUUUUUUUBUUUUUUUUBUUUUUUUBBBBBUUBUUUUBUUBUUUUBUUBUUBUUUBBUUUBUBU
BBUUUUBBUBBUUUUUUBUBUUBBBUUBBUBBBUBUBBUBUUBUBUUBUBUBUUUUBUUBBUBUUUUUUBBUUUUBBBUBUBBBUBUUBBUUUBUUUUUUU
UUUBUUUUUUUUUUUUUUUUUBBBBUBBBUUUBBUUBBUUUUBBUUUUUBBUUUUUUBUUUUUBUUUUBUBUUUBUUUUBBUUUUUUUUBUUBBUUUBBBU
UUBUUBUBUUBUBUBUUUUBBBBBUUUUBBUUUUBUBUUUUBUUBUBUUUBBUBUUUUBUUUBUBBUBUUBUUUUBUUUUUBUUUBBBUBBBUBUUUBBBU
UUUUUUUUUUBUUBBUBUUUUUUUUUUBUBUBUUBUBBUUUUBUUUUUUUUBUUUUBBUBUUBUUBUUUUBBUUBUUUUUUUUBUUUUUUUUUBBUBUUUB
BUUUUUUUUUBUUUUUUUUUUUUBBUBUBUUUUUUUUUBBUUUBUUBUUUUBUUUUUUUUUBUUUUBBUUUBBUBUUUUUUUBBUUUUUUBUUUUUUUUUU
UUUUBUBUBBUUUBBBUUBUUUBBUUUBUUUBUUUUUUBUUUUUBUBUUUUUBUUUUUUUUUUUUBUUUBUUBUUUBUUUUUBUUUUBUUBUUUUUUUBUU
BBBBUUUUBUUUBUUUUUUBUUUBBBUBUBUUUUUBUUUBUUBUUUUBUUUBUUBUUUBUUUUUUUUUBUBUBBUUUUUUUUBUUBUUUBUUUUBBBUUUU
UBUBUUUBUUBBBBUUBUUUUUUUUUBUUUBUUUUUUUUUBUBUUUUUUBUUUBBUUBBUUUUUBBBUUBUUUUUUUUBUUUUUBUUUUUUUUUUUUUUUU
UUBUBUUUUBUUUUUUUUBUBUBBUBUBUBUUBBBUBUBUUBUUUUUBUBBUBBUUBUUUUUUUUUBBUUUBUBBUUUBBUUBUUUBBUUUBUUUUUUBUU
UUUUBBUUUUUBBUUUBBBUUBUUUUUUUUBUUUUBUUUUUUUBUUUUUUUUUUUUUUUUUUBUBUUUUUUUUBBBBUUUUUBUUUUBUUUBBUBUUBUUB
BUUUUUBUBUUUBUUUUBUUBBUUUUUBUBBBUBUBUUBBUBUUBBUUBBUUUUBUUUUBUUBBUUBUBUUBUUUUUUUUUBUUBBBUUBUUUUUBUUUUU
BUBUUBUUBUUBUUBUUBBBUBUBUUUUBUUBUUUUUUUUUUUUBUUUUBUUUUUBUUUUBUBBUUUUUBUUUBUUBUUBUBBBUBUUBUUUBBUBBUUBU
UBBUUBBUUBUUUBBBUUUUUBBBUUUUUUUUBUUBBUUUUUBUUBBUUBBUUBUUBUUUBUUUUUUUUUBUUBUUUUUUUUUUUUUUUUUBUUUUUUUUU
BUBUUBUUUUBBBUBUBBUUUUBBUUUUUUUBBUBBUUUUBUUUUUUBUUUUUUUUUUUUUBUUUUUUUUBUUBBUUUUUBUUUUUUUUBUUUUUUUUBUB
UUUUBUUBUBUUBBBUUUBBUBUUUUUBUUBBUUUBBUBUUBUUUUUUBBUBUBUUUUBBUUUBBUUBUUBUUUBUBUUUBBBBUBBBUUUUUBUBBUUUU
