UUBUUBUUUUUUUUBUUUUBUUUUUUUUUUUBUUBUBUUBUUUUUUUBBUBUBUUUUUUUUUUUUUUBBBUUUUUUUUBBUBUUUUUUUUBUUUBBUUUUB
UUBUUUUUUUBUUUUUBUBUBUUUUBUUBUUUUUBUUUUBUUUUUUUUUBUUUUUBUUUUUUUUBUUBBUBBUUBUUUUUUUUUUUUUUUUUBBUUBBUUU
UUUUUBBBUUBUUBBUUUUUUUUUUUUUUBUUBUUUUUUUUUUBUUBUBBBUUBUUUUBUUUBUUUUBUUBUUUUBUBUUUUUUUUUUUUBUUBUUUUUUB
BUBUBBUUUBUUUUUUBUUBUUUBBBUUUUUUUUUUUUUUBUUUUBBBUUBUUUBUBUUUBUUUUUUUBUUUUUUUBBBUUUUBUUUUBBUUUBUBUBBBU
UUUUBUUUUUUBUUUUBUUUUBBUUUUUUUUUBUUBUUUBUUUUBUUUUUBUUUUBUUUBBUUUUUBUUUUBUUUUUBUUBUBUUBUBUBUUBUUUUBUUU
UUUUBUBUBBUUBUUUUUBUUBUBUUUUBBUUBBUUUUUUUBBUUBUBBBUBBBBUBUUUUBUUUUUUUBUUBBBUUUUUBBUUBBUUUUUUBBUBUUBUU
BUBUUUUUBUBUUUUUBBBBBUUUUUUUBUUBUUUBBUUUUUBUUBUUUUBBUBBUBUBUBUUUUBUUUBUBUUUUBUUBBUUUUUBBUUUUBBBUUBUUU
UUUUBBUBBUUUUBUUBUBUUUBBUBUUUUUUUBUUBBUBUBUUUUBBUUUUUUBBUUUBUBUBUBUBUBUUUBBUBBBBUUUUBBUUUUBBUUUUUUUUU
UBUBUUUUBUUUUBUBUUUUUUUUBUUUUUBBBUUBUUBUUUUUBUUUUUUUUBBBUUBUBUUBUUUUUUBBBBUUBBUBBUUBUUBBUUUUUUUUUBUUB
UUUUUBUUUUBUBBUUUUBUUUUBUUUUUBUUUUUUUUBBBUUUUBBUBBUUBUBUUUUUUBUUBBUBUBBUUUUUBUUUUBUUBUBUUBUUUUBUUBUUB
UUBBUUUUUBUUUUBBUUUUUUBUBUBUUUUBBUUUUUBUUUUUUUUUUUUBBUBUUUUBUUBBUUBUUUUUUBUUBUBUUUUUBBBUBBBUUUUUUUBUB
BBUUBUBUUUBBBUUUUBUUUUUUUUBBUUUBUUUUUUUUUUUBUUUUBUUUUUUUUUUUUUUUBUUBBBBUBUUBUUBUUBUUUUUUUBUUUBUBUUBUU
UUUBBUBUUBUBUUBUUUUBUUBUUUUBUUUUBUUUUUUUUUBBBUBBBUUUUUUBUBBBUUBBUBUUUUUUBUBBUBUUBBUBUUUBBBUUUUUBUBBUU
UUUBUUUBUBUUUBUUBUUUUUBUBBUUUUUUUBUUUUUBUUUBUBUUUUBBUBUUBUUUUUUUUUBBUUUBBBUUBUUUUUUUUUUUUUBUBUUBUUUUB
UUBUUUUBUBUBUUBBBUUUUUUUUUUBUUBBUUUUBBUBBUUUUBUUUUUBUUBUBUUBBBUUUUBUUBBUUUBUUUBUBUUBUUUUBBUUBUUBBUBBB
UUBBUUBUUUBBBBUBUBUUUUUUBUUBUBUBBUUUUUUUUBBUUUBUUBBUUBUUUUBUBBUUUUUUUUUUUUBUUUUUUUUUBUBBBUUUUUUUBUUUU
UUBUUUUUBUBUBUBUUBBUUUBUUUUUBUBUUUBUUUUUBUUUUUUUUUUBUUBBUUBUUBUUUBUBUUBUBUBBBBUUUBUBUUBUUBUBUUUBUUBBU
UUBUUBUUUBBUUBBBUUUBUUUBUUUBUUUUUUUBUUBBBUUUBUUUUBUBUUUUBUBBUUBBUUBUUUUBUUBBUBUUUBUBBUBUUUUUBBUUBUBBB
UBBBBBUUUBUUBUUUUBUBUBUBUBUUUUBUUBBUBUUUUUUUBBBUUUUUBUUBUUBUUBUUUBUUUUBUUUUUBUBBBUUUBUUBUBUUBUBBUUUUU
UBBUBUUUUUUUBUUBUUBBUUBUUBBBBUUUUBUUUUUBUUBBUUUUUUBUUUUUUUBBUBUUBUBUUUUUUUBUUUBBUUBBUUUBUUUUUUBUBBUBU
BUUUUBUBBUBUUUUUUBBBUUUUBBBUUUBUBUUUUUUUUBUUUUUBBUBUUUBUUUUUUBBBUBUBUUUBUBBBUBBUUUUUUBBUUUUUUBUUBBBUU
UUBBUUUBUUUUUUUUBBUBBUUBUBUUUUBBUUUBBUUUUUUUBBBUUBUBUUUBUBBUUBUBUUUUUUUBUBUUBBBUBUUBUUBBBUBUUUUUBUBUB
UUUUUUUUBUUUBUUBUUUUUBUUBUUUUUUBUUUBUUBUBBBUUBBUUUUBUUBUUUUUBBUUUBBUUUBBUBUBUUBUUUBUUBUUBUUUUUUUUUBUB
UUUUUBUUUUUUBBBUUUUUBBUUUUBUUBUUUUUUUBUUUBUUBUUBUUUUBBUBBUBBUUUUUUBUBUBUBUUUUUUUUUUUBUUUUUBUUUUUUUUUU
UBBUBUUBBUUUUUUUBUUBUBUUUUUUUBUBUUBUUBUBBBUBUUUUUUUBUUUBUUBBUUBUBUBUUUUBBBUUUUUUBBUUBUUUUUUBUUUBUUBUU
UBUUUUUUUUUUBUUUBUUUUUUUUBUBBBUBUUBBUBBUBBUUUUBUUUBUUUBUUUUBUUUUUUBUUUUUBUBBUBUUUUUUUBUUBBBBUUUBBUUBU
UUBBBUBUUUUUUUUBUUUUBUUUBBUBUUBBBBUUBUUBUUBUBUUUBUBBBUBUBUUUBUUUUUUBUBUUUBUBBUUUBUUUUBBBBBBUUBUUUUBBU
UUUBUUUUUBUUUUUUUUUBUUUBUBBUUBBUUUUUBUUUBUUBUBUUUUUUUBUUUUUUUBUBUUUUUUUUUUUUBUUUUBBUUUUBUBUUUUUUUUUBU
UBUUUUUBUUBUUUUUBUUBUUUBUUBBBBBUBBUUUBUUUUBUUUUUUBBBBUUBUUUUBBUUUUUUUUBUUUUUUBUUUBUUBUBUUUBBUUBBUUBBU
BUUUUUBBUBUUUUUUBUUUBUUBUUUUBUUUUUBUUUBBUBUUBUBUUBUUUUBUUUUUUBUUUBUUUUUUUBUBBUUUUUUUUBUUBUUUUUUUUUBUB
UUBBBUUUUUUBUUUUUUUUBUUBBUUUUUBUUUUUUUUUBUBBBBUBBUBUUBUUUUUBUUBUUUUUUUBUUUUBUUUBUUUUBBUUUUBUBBUBUUUUU
UBUUUUUBUUUUBUUUBUBBUBUBUBUBBBUUBUUUUUBUBUUUUUBUBUUUUUBUUUUUUBUUUBUUBUUUBUUUUBBBUUBBUBUUUUUUUUUUUUUBU
BBBUUUBUUUBBUUUBBUUUUUUBUBBUUBUBBUBUBUBBUUUUUUUBUUUUUBUUBUUBUBUUUUUBBUUUUBBBUBUBBUUUUUUUUUUBUUUBUUBBU
BUBUUUUUBBUUUUUUUUBUUUBUUUBUUUUUUUUUUUUBUBUBUUUBUUUUUUBUBUUUUBUBUBUBUUUBBBUBUUUUUUUUUUBUUUUUUUBUUUUUU
UUUBUUUUUUBUBBUUUUUBUUUUUUBUBUBBUUUUUBUBUUUBUBBUUUBUBUBUUUBUBBUUUUUBUUUUBUUUBUUUUUUUBUBUUUBBBUUUUUUBB
UUUUUUUUBBUUUUUUUBBUBUBUUBUUUBUUUUBUBUUBUBUUBUUBUUUUBUUBBUUUUUBUUUBUUUUUBBUBUBUUUUUBUUUUBUUUUBUUBBBUU
UUUUBUUUUUBBBBUUUUUUUBUUUBUUUBUUUUBUUUUUUUUUUUBUBUUUUUUUUUUUUBUBUBBBUUUBBUUUBUBUUUBUUUUUUBBUUUUUUBUUU
BUUBBUUBUUBUUUUUUUBUUUUBUUBBUBUBUBUUBUUUUUUUUUUUBUUUUUUBBUUUUUUUUUUUBUBUBBUUUUUUUBUBBUUBUUUUUUUUBUUBU
UUBUUUUUBBUUUUUBBUUUUBBBUUBUUUUBUBUUBUBUBUBUUUUUUBUUUBUBBUUUUBBUBUBBUUUUUUBBUUUBBUUUBUBUUBUUBBUBUUUUU
BBUBUBBUUUBBBUUBBBUUUBUUUUBBUBBBUUUUUUUUBUUUUBBBUUBBBUUUUBUUUUUUUBUUBUBUUUUUBBBUUUUUUUUUUUUUUUBBUUUUU
BUUUUUUUUUUBBBBUUUUBUBBBUBBUUBUUBUUBUUUUUUUUUBBUUUUUUBUBUUUBUUBUUBUUBUBUUUBBUUUBBBBUBUUBBBUUUUUBUUUBU
UUUUUUUBUUBBUUUUBUUBUUBUBBBUUUUUBBUUUUUUUUUUUUUUUUUUUUUBUBUUUUUBBUUUUUUUUUUUUBUUBBBUUUUBBBUUUUBUUBUUU
UUUUBUUUUUUUUUBUBUUBUBUUBUUUUUUBUBUBUUUUUBUUUUBUUUUUUUBUUUUUBUUBUBUBUUBBBUUUUBUUUBBBBUUBUUUUUUBUUBBUB
UBUBUBUUBBUUUBUUUUUUUUUBUBUUUBBUUUBBBBBBUUUBUUUBUUBUUBUUUUUUUUUUUUBUUBBUBBUUUUBUBUBUBUUBUUUBUUBUUUUUU
UUUBBBBUUBUBUBBBBBBBBUUUUUUUUUBBUUUUUUUBBUBUUUBUBUBBUUUUUBBUUUUUBUUUUUUBUUBBUBUBBUBUUUUUUUUUBUBUBBUUU
UBUUUUBBBBUBBUUUUUUBBBBUBUUBUUUBBUBUUBUBUBBUUUBUUUUUUBBBBBUUBUUBUUUUUBUUUUUBUBBUBUUBUUBUUUBBBUBUUUUBU
BUBBUUUUUUBUBBUBBUUUBUBUUUBUUUUUUUUUUBBUBUUUBUUUUUBUUUBUBBUUBUBUUUUUUBUUUUUBUUUBUUUBUBBUUUUBUUUUBBUUU
UUUUUBUUUBUBUUUUUUBUUUUUUBBUUBUBBUBUUUUBBUBUUUUUUUUBUUUUUUUUUUBUBUUUUUUUBUUUUUBUUUUUBBUUBUBBBUUBUUUUB
UUBUBBBUUBUUUUBBUUBUUBUUUBUUUUUBUUUBBUBUUUUUUUBBUUUUUBBBUUBBBUUUUBBUBUUUUBUUUUBUBUBUUUUUUUBUBUBUUUUBB
UUUBUBUUBUUUUUUUUUUUUUBBUUUUUUUBUUUUUUBUUBUBUUUUUUBBUUUBUUUUBUUUBUUBUUBUBUBUBUUBBUUUBUBUBUUBUBBUBBUUU
BUBUBUUBUUUUUUUUBUUUUUBBBUBUBUUUUUBUUUUBUUUUBUUUUUUUBBUUUUUUUBBBBUUUUBUUUUBBBUUUUUUUUBUUBBUUUUBUBUBUB
UBUBUBBUUUUUUBUBUUBUUBUBUUUUBUUBBUBUUBBUBUBBBBUBUUUUBUUBBUUUUBBBUUUBBUUBUUUUBUUUUUUUUUUUBBUUUUUUUUUBU
UBBUUUUBUUUUUBUUUBBBBUUUUUUUUUBUUBBUUUUUUBUUUBBBUBUUUUUUUUBUUUBUUBUUUUUBUUUBUBUUBUUUUBUUBUBUUUUBUUUUB
BUUBBBUUUUUUUUUUUUBUUUUUUUBUBBUUUUBUBUUUUBBBBUUUUBBUUBUUUUBUUUUUUBUUUUUBUBUUUBBBBUBUBUBUBBUUBUUUUUUUB
BUUUUUUUBBUUUUUUBUUUBUUUUUUUUUUBBBBUBUUBUUUBBUUUUBBBUBUUUUUBUUUBBUUUUUUUBUUBUBBUBUUBUBUUUUUUUUBBUUUBB
UBBUUUBUBUUUUBUBUUUUUUBBUUUUUUUUBBBUUUBBUUBUUUUUUUBBBUBBUUUUUUUUUUUBUUBUBUUUBUBUUBUUUUUBBUBBUBUUBUUUU
UUUUUUUUUUUUBUUUUUBUUUBUBUUUUUUUUUUUUUUUBUBBUUBBBBBUUUBBBBUUUBUUUUBUBBUUBUUUUUUBUUBUBUUUUBBBUUUUBUUUU
UUUBUBBBUUUUUUUUUBBBUBUUUUUUUUBUUBUUBUUUUUUUBUUUUUUUUUUUUBBUBUUUUUUUUUUUUUUUBUUBUBUBUUUUBBUUUUBUUUUUU
UUUUBUUUBUUBBBUUUUUBBBUBUBUUUBBUUUUUUUBBBUUBUUUUUUBUUUUUUUUUUBUUUUUUBUUUUUBBUBUUUBUBBUBBUUBUBBBUBUUUB
BBBUBUUBUBUUUBUUUUUUUBUUBBUUUUUUUUUUUBUUUBBBBUUBUUUUUUUUUUUUBBUUUUUBBUBUUUUUUUUUUUUUUBUUUBUUUUUBUUUUB
UUUUUUBBBUUUUUBBBUBUUUUUUUUUUUBUBUUUUUBUBUUUUUBUBBBUUBBUBUUUBBBBUUUUUUUUUUUBBUUUBBBUBUUBBUUUBUBUBUUUB
UUUUUUUBUUUBUUUUUUUUBUUUBUUUUUUBUUUUUUUUBUUUUUUUUBUUUUUUUBUUUUUUUUBUUBUUUBUUUUUUUUUUUUBUUUUBUUUBUUUUU
UBUUBBBUBUUUUUUUBBBUUUUUBUUUBBUUUBUUUUBBUBUBUUUUBUUUUUUUUUUUBBBUBUUUUUUUUBBBUUBUBBBBUUUBUUUUUBBUBUUUB
UUUUBUUUBUBBBBBUUBUUBBUUBUUBBUUBUUUBUUUBBBBUUBUBBBUBUUUUBUUUUUUBBUBUBUBUUUUUBUUBUUBUUBUUBBBUUBBUBUBBB
UUUUUUUUBUUUUBUUUUBUUBUBUBBUUUBUUUBUUUBUBUUUUUUBUUUBUUBUUBBUUUUBBBUUUUBUBUUBUUUUBUUBBUBUBUBUBUUUUBUUU
UBBUUBBUUBUBUUUUBUBUBBUUBBUBUBUUBBBUUUUUUBUUUUBBBUBUUUUUUUUBUUUBBUBUUBUUUBBUBUBUBBUBUUUUUUUBUUUUBUUUU
UUUUUBUBUUUUUBUUUUUUBUUUUUUUBUUBUBUUUUUBUUUUUUBUUUBBUBUUBUUBUBUUUUUUUUUBBUBUBUUBUBUUUBBUUUBUUUUUBBBBU
UBUUUBBUUBUUUUBUUUUUBUUUUUUBUUUUUUBUUBUUBUUUUUUBBUUUUBUUUUUBBUUUUBUBUUBBBUUBBBBUUUUBUBUUBUBUBUUBBBUUB
UUUBUUUUUBUUUBUUBBUUBUUBUUBUUUUBUUUBUUBBBUUBBBBUBUBBUBUBUUUUUUBUUUBUUUUUUUBUUUUBBBBUUBUBBUUBUUUUUBUUU
BBBUUBBUUBBUBUBUUUBBUBBBBUUUBUUUBUBUUUUUUBBUBUUUBUUUUBUUUUBUUUUBUBBBUUUBUUUBUUBUBUUUUUUUUUBUUBUUUBBBU
BUUUUUBBUUUBUUUUUBUUBUUBUUBUUUUUBUUBUBUUUUUUUUUUUUUBBBUUUBBUUBBUUBUBBUUUBUBBBBBUBBUUUUBUUUUUBUUBUUUBU
UUUUUUBUBUUUUUUUUUUUBBUUUUUUBUUBUUUUBUUUBUUUUUBBUBUUUUUBBUBUUUUUUUUUBBBUBUUBBUUUUUUBUUUUUBUUUUBBUUUBU
BUUBUUBUBBUBBUUBUUUUUUUUBUUUBUUUBBBBUUUUBUUUUUBUBUBBBBBUUUBUUBUUUBUUBUBUUBUUUBUUUUUUUUBUUUBBUBBBUUBBU
UUUBUUBBUBBUUBUBUBUUUUUBBUBUBUBUBBBUBBUUUUUUUUUUUBBUBBUBBUBUBUUBUUBUUUBBUBUBUUUUUUUBBBBUUUUUBUUUUUUBU
UUUUUUBUBUUUBBUUUUUUBUUUUUUBBBUBUUUUBUBBBBUUUUUUUUUUUBBUBUBBBUUBUUUBUUUBBUUUUUUBUBBBUBUUBBBUBUBUUUBBB
UUUUUBBUBUBUBUUBUUBUBUBBUUUUUBUBBUUBUUUUBUUBUUUUUUUUUBBUBUBUUUUUUUUUUBUUBUUUBUUUUBUUUUBUUUBUUBUUUBUBU
UUUBBBUBUBUUUUUBUUUUUUUBUBUUUUUUUBBUUUUBUBBUUUUUUUUUUUUUUUBBUBUUBUUUBUUUUUUUUUUUUUUUBBUUBUUBBUUUUUUUU
UUUUUBUBUBUUUUBUUUUUUUUUUBBBBUUBUBBUUBUBUBUUUUBUUUBUBBBUUUUUUUUBUUBBBUUUUUBBUBUUUUUBUUUUBBUBBBUUBUUUB
UBBUBBUBBUUUUBUUUUUUBUUUUUUUUBUBUUUUUUUUUUBBBUBUBUUUUBUUUUUUUUUUUUBUUUBUBUBUBBUUUUUUUUUBUUBBBUUBUBUBU
BBBUUBUBBUUBBBUUUBBUUUUUBUUBBUUUUUBUUUUBUBBBBUBUUUUBBBUUUBUUBBBUUUUBUBUUUUUUUUBBUUUUUUUBUUUUBUUUUBUBU
BUUBUUUBUUUBBBUUBUUUUBUUBUUUUBBBBUUUUUUUUUUBUUUBBUUUBUUBUUUUBBUBUUUUUBUBUBUBUUUUUBUBUBUBUUBUUUBUBUUUB
UUUUUUBUUBUUUUBBUBUBBUUUBBUUUUBUBUUBBBBUBUBUBBBUUBUBUUUUUBUUUUBUUBUUBUUUUBBBBUUUBUBUUBUUBUUUUUUUUUUUU
UUUUUUUUUUUUUUUUBUUUUUBBUUBUUUBBUUUBUUUUBUUUBUBUUUUUUBUUUBUUBUUBBUBUUUUUUUUBUUUUUUBUUUBUBUUBUBUUUUUUU
UBBUBBBUUUUUBBUUBBUBUUUUBBUBUUUBUUBUUUUUBUUUUUUUUUBUUBUUBBUBBUUBUUUUBBUUUUUUUUUUUBBUUBBUBBUBBUUUUUUUU
UUBBUUUUUUUUUBUBBUBBBUBBBUUUUUUUUUBUUUBBUUUUBUUUBUUBBUUUUUUBUBBUUBUBUUUBUBUUUUBUBBUBUUUUUUBUBUUUUBUUB
UUUUBUUUUBBUUBUBUUBBUUUUUUUUBUUUUBUUUUBUUUBUBUUUUBUUBUBUUUUBUUUBBUUUUUUBUUBUUUUUUUUUUBUBBUBUUUUBBUUBU
UUBUUUUBUUUBBBBBBUBUUUUUBUBUBUUUUUUBUBUUUUUUBBUUUUUUUUUUUUBUUUUUUBBUBUUUUUUUUBUUUUUUUUUBBBUBBBBBUUUBU
UUUBUUUBUUUUUUBUBUBBUUUUUBUBUBBUBBUBUBUUUUUUBUUUUBUUUBUUUUUUBUBBBUUUUUUBUUUUUUUUUUUUUUBUUBUBBUUUUUUUU
UUBUUUBBUUUBUUBUUBBBBBUUUUUUUUUUUUUUUUBBUUUBUUBUUUBUUBUUBUUBUUUUBUUUBUUUUBUBBUUUUUUBUBBBUBUUUBBUBUUUU
BUBBUUUBUUUBUBUBUUUUUUBBUUUUBUUUBUUUUBUUBUUUUBUBUUUUBBUBUUUBUUBUUUUUUUUUUUUUUUUBUUUBUUUUBUUBUBBUUUUUU
UUUUUUUBUUUUUUUBBUUUUBBBBUUUUBBBBUUBUBUUUBBUUBBBBBUUBUBUUUUBUUUUUUUUUBUUUUUUUUUUUBUUBUUUUBBUUUBUBUBUB
BUUUUUBUBUBUUBUBBUBBUUBUBBUBUUUBBUUUUUBUUBUBBUUUUUUUBBUUBUUBUUUBUUUUUUBBUUUUUUUUUBBUUUUBBBBBUUBUUUUUU
BUBBUUBUUUUUUUUUUUUUUUUUUUUUBUUUUBUUUBUUBUUUUUBUUUBUUUUUUUUUBUBUBUBBBUUUBUBBBUUUUUUUBBUUUBUUUBBUBUUBU
UUUUUUUUUBUBUUUUBUBUBBUUUBUUBUBUBUUBBUUBUUUUBUUUBUUBUUUUBBUBBUUBUUUUUBUUBUBBUUBBUBBUUBBUBBUUBUUUBUUUU
BUUUBUBUBUUBUUUUUUUUUBUUUUUUUBBUUUUUUBBBUUUBUUBUBUUUUUUUUUBUUUUUUUUBUUBUUUUUBBUUBBUBUUBBUUUBUBUUUUUBU
BUBBUUUUUUUUUUUUUBBBBUUUUUBUUUUUBUBUUUUUBUUUUUUBUUUUUBUUUUUUUUUUBUUUBUUBUUUUBUUUBUUBUUUUUUUUBBUUUUUUU
UUBUUUUUUBUUUUUBUUBBUUUUUUUUUUUBBBBUUBUUBUUBUBUUUUUUBUUUBUUBUBUBBUUUUUUBBUBUUUUBUUBUBUBUBUUUUUUUBUUUU
BUBUBUUBUUBUUUUBUBUUBBUUUUUBUUUUUUUUUUUUUBUBBBBUUUUUUUUBUUUUUUBBUBUUBBUUUUUBBUUBBUBUUBBUBBUUUBUUUUUBB
UBUUUUUBBUUUUUUBUBUUBUBUBBUUUUUUUUUUUUUUUUBUUUBBUUBUBUUBUUBBUUUUUBUUUUBUBUUUBBBUUUUUUUUUUUUUBUUUUUUUU
UUUUUUBUUUBUUUBUBBUBUBUUBUBUUUUUUUUUUUUUUUBUBUUBBUBUUUUBUUBBUUUBUUBUUUUUBUUUUUBUUBBUBBUUBUBBBUBUUUBBU
BUBUUBUBUUUBUBUBBBBUUUUUUUUUBUBUBUUBUUUUBUUUBUUUUUUUBUBUBBUUUUUUUUUUUBBBBUBUBUUUBUUUBUUUUBUUBBBBUBBUU
