UUUBBBUUUUUUUBUUUBUUUUUUUUBUUBUUUUUUBBUUUBUBUUUUUBUBUUBUUUUUUUUUUBUUUUBUUBUUBBUUUUUUUUUUUBUUUUUBBUUBU
UUUBBUUUUUUBUBUUUBUUUBBUUUUBBUBUUUBBUUUUUBBUBBUUUBBUUUUBUUUUUUBUBUBUUUUUUBUUUBUUUBBUUUUBUUUUUBBUUUUBU
UUUBBUUBUUUUUUBUUBBBUBUUUUUUBBBBUUUUUUBUUUUUUUUUUBUUUUUUUUUUUBUUUBUBUUUUUUUUUBUUUUUUUUUUBUBUBUUBUBUBU
UBUUBUUUUBUBUUUBBBUUUBUUBBUUBUBUBBUUUUUUUUUUUUBUBUUUUBUUUUUUUBUUUUUBUBBUUUBBBBUUUUUUBUUUUBUUBUBUUUUUB
UBUUUUUUUUUUUUBBUUBUBUUUBBUBUBUBUUUUBUBUUUUBUUUUBUUUBUUUBBUUUUUUUUUUUBUUUUBUBUBUBBUUBBUUBBUUUBBUUUBUU
UBBUUUBUUUUBUUUBUBBUUUUUUUUUUUUBUUUUUUBUUUBBUUUBUBUBBUUUBUUBBBUUUBUBBUUUUUUBUUUUUBUBBUUUBUBBUUBBBUBBU
UUUBUBUBUUBUBUUUBUUUUBBUUBBBBUUUBBUUUBBUBBBUBUUBBBUUUUUUBUUUUUUUUUUBUBBUUUUUBBUBUUUUBUUUUUUBUUUBUUUUU
UUUUUUUBUUBBUUBBUUBUBUUUUBUUBUUBBBUUUBBUBUBUBUUUUBUUUUUBUUUUUUUUUUBBUUUBUBUUUUUUBUUUUUUUUUUUBUUBUUBUU
UUUUBUUUUBBUUBBUUUBUUUUBUUBUUUBUUUBUUUUUBBBUBBBUUUBBBUBUBBUUUUUUUBUUBUBBUUUBUUUBUUBUBBBBBUUBUBUBBUBUU
BBUUUUUBBBUUUUBUBBUUUUUBUUBUUUBUUBBUBUUBUUBUUUUBUUUUUBUBUUUUUUUBBUBUUBUUBUUBUUUBUBUBBUUUUUUUUUUUBUUUB
UBUUUBUUUUBUUUUBBUUUUUUUBUUBUBBUBUUUUUUUUUUUUUBUUUBBUBBUUUUBBBBBUBUBUUUBBUBBUBUBUUBUUUUUBUUUBUUUUUBUU
BBBUUUBUUUBUBBUBUUUUUUUUBUBUUUUUBBUBBBUUUBBBUUUUUBUUBUUUBBUBUUUUUBUUUBBUBUUUUBUUUUUUBUBUUBBBUUUUUUUUB
UUUBUBUBUUBUUUUUBUBBBUUUBBUUUUUUUUUUBUUBBUUUUUBUUUUBUBUUUUUUUUUUUUUBBUBUBBUUUUUBUUBUUBUUUUUUUUUBUBUUU
BUUUUUUUBUUUUUUUBBBUUUBBUUUBUUUUUBUUUUUBUUUBUUBBUUBUBBUUUUUUBUUUUUUUUUUUBUUUBUBUBBUUUUUUBUUUUBUBUBUUU
UUUUBUUUBBUUUBBBUUUUUUUUBUUUUUBBUUUUBBUUBUBBBUUBUBBUUUBUUBBUBUUUUUBBUUUUBBUUUBBBBUUUUUBBUUUBUUBUUBBUU
UUBUBUUUBUUUUUBUUUBBUUUUBBUBUUBUUBBBBBUUUUBUUUUUBBUUUUBBUBUUUUUUUUUBUUUBUUUUUUUBUUBUUUUUBUBUUUUUUUUBU
BBUBUUBUBBUUUBBUBUUUUUBUBBBBUUUUUUUUUUBUBBUUUUUUUUUBBUUBUBBBBBBUUUUBBUUUUBUUUBUUBBUUBBUUUUUBUUUUBUUBU
UUUUUUBUUBUUBBBUUUUBUUUUUUBUBBUUUBUUUBBUUUUBUUBBBUUUUBUBBBBBUBBBUBUUBUBUUUUBBBUUUUUBUUUUBBUUUUUUUUUUU
UUBUUUUUUBBUUUUUUBUUUUUUBBUUUUBUUUUUUUUUUUBUUUUBUUUUUUUUUUUBUBUUUUBUUUUUUBUUUUBUUBUUUUUUUUBUUBUUBUBUU
UUUUUBUUUBUUUBUUUBUBUUBBUBUUBUUUUBUBBBBBUUBUUUUUUUBUUUUUUUUUUUBUUUUUBBUUUUBUBUUUUBUUBUBBBUUUUUBUUUUBU
UUUUUUUUBUBUUBUBBBUUBUUUBUUUUUUBUUBBUBUUUBUUBBBBUBUUUBUUUUUBUUUUBUBUUUUUBBUUUUUUUBUBUUBUUUBUUBBUUUBBU
BUUBUUUBBUBUUUBUBBUBUBUBUUUBBBUBUUBBBBUUUBUUUBUBUBUUBUUUUBBBUUUUUUUUBUBBUUUUUUBUBUUBUUUBUUUUBUUUUUUBU
UBBBUUUBUBBBUUUUUUBBBUBUBUUUUUBBBBBBUBUUUBUBUBBUUBUUBUBBBUBUBBBUBBUUBBUUBUUUUUUUBUUBUUUUUUUUUUBUUUUBU
UUBUUUBUBBUUUUUUBUUUUUUUBUUUUUUUUBUUUUUUUUBBBUUBBUUUUUUUUUUUBUUUBBUUUBUBUBUUUUBUBUBBUUUBUUUUUUUUUBBBB
UUUUBBUBUBBUBUUUBUUUBUBUBUUUUBUUUUBBUBBUUUBBUUBUUUUUBUUUUBUUUBUBUUUBUUBUUBUUBUUUUBUUUUBUUBUUUBUUUUUBU
UUBUUUBUUUUBUUUBUUBUBUUUUUBUUUUBBBBUUUUUUUBUUUBUBBBUUUUBBUBBUUUBUUUUUUUUBUBUUUUUUBBUUUBBBBUUUUUBUUUUU
UUUBBUBUUUBUBBBUBUUBUUBBUBBBUUBBUUUBUBUBBBUUUBUUUUUUBUUUUUUBUUUUUUUUUUUBUBBUUUUUBBUBUBUBUBUUUBUBUBUUU
BBUUUUUUUUBBUUUBBUBBBUUUBUUUUUUUUUBUUUUUUUBUUUUBBUUUUUUUUUBBUBBUUUUBUBBUUBUUUUUUUUUUUUUUUUUUUUUBBUUUB
UUUUUBUUBUUUBUBUBUUUBUUUBUUBUUUUUUUBUUUBUBBUUUUUUUUUUUUUUBUUUUUUUUBUUUUUBUUUBUBUUBUUUBBUUUBUUBUUUUUUB
UUUBUUBUBUUUUBUUUBUUBBUUUBBBUUUUBUUBBBBUBBUBUUUUBUUUBUBUUUBBUUUUBUUUUBUUBUBUUUUUBBUUUBUUUUUBUUBUUUUUU
UBUUUUUBUUUUUBBUUUUUUBBUUUUUUUBUUBUBUUUUUUBBBUUUUUUUUUBUUUBBBUBBBUUUUUBBUUUUUUUBBBUBUUUUUUUUUBBBUUUUU
BBUUUUBBUBUBUBUUUBUUUUUBUUUUBUUUUUUBUBBUUUUUBBBBUUUBUUUUBUUBUUUBUUUBUUBUUBUBUUUBBBUUUUBUUUUUUUUUUBBUU
UUUUBBUUBUUUBUUBUUUUUUBUUUUBUUUBBUBUBUUBUUUUUUUUUBUUBUUUBUUUUBBBUUUBUBUUBBBUUUUBUUUUUUBBUUUUBUUUUBUUU
BUBUBUUUUUUBUUUUBBUUUUUUBBBBUUUUUBUUBUUUUBBUUUUUBBBUUUUUUBUUUUBBUBUUUUUUUUUBUBUUUUUUBUUBUBUBBBUUUUBUB
UBUUUUUUUUUUUBUUUBBBUBBBUUUUUUUUUUUBUBBBUUUUUBUUBUBBBUUBUBUBUUUUUUUUUUUBUUUUUUBUUUBBUUBBBBUUUUBBBBUBB
BUUUUUUUUUUUBUUUUUUUUUUUBUUBBUUUUUBUUUUBUBUUUUUBUUUUUUBUBBBUBUUUUBBUUBUUBUBUUUUUUUUUBUUUUBUUUUUUUUBBU
BUUBUUBBBUBUUUBUUUUUBBBUBUUBUBUUUUBUUUUUUUBUUBUUUBUUUBBBUBUBBBUUUUUUUUUUUBUBUUUUUUUUUUUUUUUBBUBBUBUUU
BBBBUUUBUUUUBUUBUUUUUBUUUUUUUBUUBUUBBBUBUUUUUBUBBUUUUBUBBUBUBBUUUUUBUUUBUBBUUUUUUUUUUBUUUUBUUUUUBBUUB
BBUBUBUBBUUUUUUUUUBUBBUUUBBUUUUBUUUUBUUUBUUBUUUBUBBUBUBUBBBUUUUUBBUUUUUBUBUUBBBUUUBUBUUUUBUUUUUUBUBBB
UUUUBUUUBBUUUUUBUUUBUBUUUBUUUUUUBUUBUBUUBUUUUUUUUUUUUBUUUUUUBUBUUUUUUBUBBBUUBUUUBUUUBUBUBUBBBBUUBBUUU
UUBBUBBBBBUUUBUUUBBUUUBBBUUUBUUBUUUUUBUUUUBBUUUUUUUUUBUUUBUUBBUUUUUUUUUUBBBUUBUBUBUUUUUUUUBUBUUUUBUUB
UUUUUUUBUBUUUBBBUUUUUUUBUBUUUUBUUUUUBUUUUUBBBUUUUUUBUUBUBBUUUBBUUUUUUUUUBUUUUBBUBBUBBBUUUBUUBUUUUUBUU
BUUBUUUUUUBUBBUBUUUBBUUUUUBBBUUUBBUBBUBUUUBUUUUBBUUBUBUBBUBUUUBUUUUBUUUBUUUUUUUUUUUUUUBBUUUUBBBUUUUUU
UUUBBUBUUBUUBBUUUUUUUBUUBUUUUUUBUUUBUUUUUUUBUBUBUBUUUBUUBUUBUBUBUBBBUBUUBUBUBUUUUUUBUUUUUUUBUUUBUBBBU
UUBUUUUUBUUUUBUUUUBBUBBBBUUBUUUBUBUBUUBUUUUUUUUUBUUUUUUUBUUBUUBUUUBUUUUUUUUBUUUBBUBUBBBBBUUUBBBUUUUBU
UUUUUBUBUUUUBUUUUUBUUUUBUUUUUUBUUUBUUUUUBBUUUUUUUUUUUBBUUUBUBUUUUUUUBUUUUUBUUUUUUBBBBUBUBUUUUBUUUUUUB
BUUUUBUUUUUUUBUUUUUBUBUUUUUUBBUUBBBBUUUUUBUUUUUUUUBUUBUUUUUBBUUUUUBUUUUUUUUUUUBUUUUBBUUBUUUUUUBBUBBUU
UUUUUUUUBBUUBUUUUUUBUUUBUBUUUBUBUUUBBUBUUBUUUBBUUUUBBUUUUUUBUUUUUUUBUUBUUUUUUUBUUUUUUBUUUUBBUUUUUUUUU
UUUUBBUUBBUBUBUUUUUUUUUUBBUUBUUUUUUUBUUUUUUUUUUUUUUUBUUUBBUBBUUUUUBUBUBUUUBUBUUUUUBUUUUUUUUBUUBUUBUUU
UUUUBUUUUUBUUUUUBUUUUBUUUUUBBUUUUUUBUBUUUUBUUUUUBUUBUUUUUBBUUUBUBUBUBUUUUUBUUUUBUBUUBUUUUBUBUUUUBUUUU
UUUUBBUUUUBBUUUUUUUUBBUUBUUUUBUBBBUUBBUUUBUBUBBUUUBBUBUUUUBUBUUBUBUUBBUBBUBUBUUUUBUUBUUUUUUBBUUUUBBUU
BUUBUUUUUBBBBUBUUUUUUBUUUBUUUUUUBBUUBUUBBUBBUBUBBUBUBUUUUUUUUBBBBUUBBUUUUUUUUUUUUBBUUUBUUBUUUUUUUUUUU
UUUUUUUUUUUUBUBUUUUUBBUUUBBUUBBUBBUUBUUBUUUBUUBUUBUUUUUBBUUBUUUUBUUUUBUBBBUUUUBUUUUBUUUBUUUUUBBBUBUUU
BUBUUBUUBBBUUBBUUUBUUUUBBBUUUBUBBUBUUUUUUBUUUUBUUBUUBUUUUUUUUBUUUUUUUUUUBBUUBUUBUUUBUUUUUUUUBUUUBUUUU
UUBUUBUUBUUUBUBUUUUUUUUUUUUBBBUUUBBUUUUUBUUBUUUUUUBUUUUUBUUUUUUUUBUUUUUBBUUBBBBBBUUBUUUUUUUUBUUUBUUUU
UUBBBUBBUBBUUBUUBBBUUBUUUUUUUUBUUUBBUUUUUUUUBUUUBUUUUUBUBUBBBUUUUUUBUUUBUUUBUBUUUBUUUUUUUUUUUUBUBUUUU
UUUUBBBUBUBBUUUUUUUUUUBUBUUUUUBUBUBBUUUUBUBBUUUUUUUBBBBUUBUUUBUUUUUUBUUBBUUUUUUUUUUUBBBUUBBUBUUUUUUUU
UUUUUUUBUUBBUBUBBBBUUUBUUUUUBUBUUUBBBBBUUUUUBUUUUUUBUUUUUBUUUUBUUBUUUUUUUUUUBUUUUUBUUUUUUBUUBBUUUBUBU
UUUUUUUUUUUUUUBBUUUUBUUBUBUUUUBBUUUUBUBUUBBUUUUUBUBBUUBUBUUUBUBBUUUUUUBUUUBUBBBBUUUUBUBBBBBUBUUUUUBUB
UUBUUBUUUBUBBBUUUUBBUUUUBUUUUUBUUUBUBUBUUUUUUUUUUUUUUUUBUUBUUUUUUUUUUUUUUUUUUUUBUUUUUUUUUUUUBUBUUUUBU
UBUBUBUBUUUUBUUUBBBUBUUUUUUBUUBUBBBBUBUUUBUBUUBUUUBUUBBUBBUUUUBUUUUBBBBBUUUBBUBUUBBUBUUUUBUUUUUUUUUUU
BUUUBUUBBBUUBUUBBUBUUUUBBUUUUBUBUUBUUUUUUUBBUUUUUBBBBUUUUBBUUUBUBUUUUUUUBUBUUUUUUBUUUUUUUUUUUBUBUUUUU
BBUBUUUUUUUUUBUUBUBBBUUBBUUUUUUUBUUBUBBUUBUBUUUUBUBBUUUBUUUUBUUUBBUBUBUBUUBBUUUUBUUBUUBUUBUBUBBUUUUBU
UUUBUUUBBUUUUBBBUBUUUUUUUUUBBUUBBUBBUBUBUUUUUBUUUUUUUUBBUUBUBUBBUUUUBUUUUUUUUUUUUUBBBBBUBBBUUBBBUBUBU
UUUUUBBUUUUUBUUBUUUUUUUUUUUUUUUBBUBBUUUUUUUUBUUUUUBUUUBUUUBUBUBUUBUUBUUBBUUUUUBBUUBUUUUBUUUUUBBUUUUBU
UUUUBUUUBUUBUUUUBUUUUBUBUUUUUUUUUBBUUBUUUUUUBUUUBUUUUUUUUUUUUBUUUUBUUUBUUUUBUUUBUUUUBBUUUBUUUBUUUUBUU
UUBUUUBUUUUBUBUUUUBUBUUUUUBUUBUUUUUUUBUBBUBUUUUUBUUUUUUUUUUBUBUUUUUUUBUBUBBUUBUUBBUUUBBUBUUUBUUUUUBUB
UBUBUBUBBUUBUUBUUUBBBUUUUUUUBUBUUUUBBUBUUBUUUUUBUUBBBUUBUUUUBBUUUUUBUUUUBUUUBUBUBUUUBUUUUUUBUUUUBUBUU
UUBUUUUUBUBUUUUUUUUUUUUBUUUUUUBBBBBBUUUBUUUBUBUUBUUUBUUBUUBUUUUBUUUUBUUUBUUBBUUBUUBBUBUBUUUUUBBUUUUUU
UUUBUBBBUUUUBUUBUBUUUBUUUUUBBUUUUUUUBUBUUBUUUUUUUUUUUBBUUUUBBUUUBUUUUUUUUUBBBUUUUUBUUUBUUUBUBUUUUUUUU
UUUUUBBBUBBUUBUUUUUUUBUUUBBUUUUUUUUUUUUBUUUUBUUBBBUUUBUUUBBUUBBUBUUBUBBUUUUBBUBUUUUUBUBUBUUUUUUUUUUUU
UUUUBUBUUUUUUBUUUBBUUBUBUUUBBBBUUBBUUUUUUUBUUUBBBUUUUUBBUBUUBUUBUBUUUUUUUUUBBUUBBUUBUUUUBUUUBBUUBUBUU
UUUUUUBBUUUUBBUBUUUBBUBUUUBBUUBUBUBBUUUUUBUBUUBBUUUUBUUUBUBBUUUUUUUUUBBUUUUUUUBUBBUUUUUUUBUBUUUBUUUUU
BUUBUUBUBUUUUUUBBUUUUUBBUUUUUUBBUBUUUUUUUUUUUUUUUUUUUBUUUUBUBUUUBUBUUBBBUUUUUUUUUUUBUBUUBUBUUBUUBUUUU
BUUUBUBBUBUUUUUBUUUUUUUUUBBUUBUUUUUUBBBUUBUBUUUUBUBUUUUUBUUBBUBBUBUUUUUUUUUBUBUUUUUUUUBBBUUUBUUUUBUBU
UUBUUUUUUBUUBBBUBUUBUUUBUUUUUBUBBUUBBUUUBUUBUUUUUUUUUUUBUUBUUUBUUBBUUUUUUBBUBUBUUBUUUUUUUUBUUBBUBUUBU
UUUUBUUBUUBUBUBBUUUUBBUUUUBUUBUBUUUBUUUUUUUUUBUUUUUBBUUBBUBUUUBBUBUUUUUBUBUUUUBUUUBUUUUUBBBUUUUUUUUUU
BUUBUUBBUUUUBBBUUUUUBBUUBBUUUUUUBUBUUUUUUBUUUUBUUUUUUBUUBUUUBUUUBBBBBUUUBBUBBUUBUBUUBUUUUUBUUUUBUUUUU
UBUUUBUBUUBUBUUUUUUBUUUBUUUUBUBUUUUBUUBBUUUUUBUBBUBUBBUUUUUBUUUUUBUUUBUUUUUBBBUBBUUUBUBBUUUUBUUUUUUBU
UUUUBUUBUUBUUUUUBUUUBBBBUUUUBUUBUBUBUUBBUUUUBUUBBUUUUUBUUBUUBUBBUUBUUUUUBBBUBBBBBBUBBUUUUBUUUUUUUBUUB
UUUUUUBBUUUUBUBUBBBUUUBUBBUUUBUUBBUUUUBUUUUBUUUUBUUUUUUUUUUUUUUUUUUBUUBUBUBBUUUUUUUUUUUUBBUBUUUUUUUUU
UBBUUBUUUUBUBUUUUUUBUBUBUUUUUUUUUUUUUUBUUUUUBUUBUBBUBBBBUUUUBUBUUUBUUUBUUBUUUUBBUUUUUBUBUUUUUUBUUBBBU
UUUBBUBUUBUBBUUBBUBBUUUUBBBUUUUUUUUUUBUUUBUBUBBUUUBBUUUBBBUUBBBBBUUBUBUUBUUUUUBUUUUUUUUUUUUUUUUUBBUUU
BBUUUBBUUBBUBBUBUBUBUUBUUBUBBBUUBUBBBUUBUUUBUBUUUUBUBUUUUUUUUUUBUBUUUUUUBUBUUUUUBUUBBUUUUBUBBBBBBUUBU
UBBUUUUUUUUUUUBBBUUBUUBUBUUUUBBBUBUBUUBUUBUBUBBUUUUUBUUUUUUBUUUUUBUUBUUUBBUUUUBUUUUBUBUUUUUUUBBUUBBBB
BUBBBUUUUUBBBBUBUUUUUUUUUBUUUUBBUUBUUUUUUBUBUUUUUUUBUUUUBBUBBUBBUUUBUUUUBUUUUUUUUUBBBUBUUBUUUUUBBUBBU
BUUUUUUUUUUBUUUUBUUUUBBUUUUBUUUBUUUUUUUBUUUBUBUUUUUUUUUBBUUUBUBUUBUBUUUUUUUUUUUUUUBBUBBUUUUBUUUUBUBUU
BUUUUUUUUUUUUUBBUUUBUUUUUUUUUBUUBUBBUUUUUBBBUUUUBBBBUUUBUUUUUUUUUBUUBUUUBBUBUBUUUUBUUBBUUBUUUBUUUUUBB
UBUBUUUUBBBUUUUBBBUUUUUUUBUUUUUUUUUUUUUUUUBUUUUUBBUUBUUUUUBUBUUBUUUBUUUUBBUBBUUBBUUUUBBBUBBUUBUBUBUUU
UUUUUUUBUBUUUBBUUUBBUUBUUBBUUBBUUBBUUUUBBBUUUUUUUUUUUBUUUBUUUUUUUUUUBUBUUBUBUBBUUUBUUUUUBBUUUBUUBBUUU
UUUBUBUUBUUUUUBUBUUUBUUUBUUBBBUBUUBBUUUBUBUUUBBUUUUBUBUUUUUUUUUUUUBBUUBUBUUBUBBUUUUUBBUUUUBUUUUUUUUUU
UUBUUBUUUUBBUUUUUUBUBUBBBUUBUUBUUUBUUUBUUBBUUUUUUUUBUBBBUUUBBBUBUUUUUUUUUUUUBUUUBUUUUUBUBUUUUBUUUUUBU
UUUUUUUUUUUUBUUUUUUUBBBUBUUUBBBUBUBUUUUUUUUUUBUBUUBUUUUUUUUUBBUBUUUUBUUUUUUBUUUUBUUBUBUUUUUBUBBUUBUUU
UUUUUBBUUBBUUUUUUUUUUUUBUUUBUUUBUBUBUUUBBUBBBUUUUUBUBUUUUUUUUUUBUBUUBUUUBBUUUUUBBUUBUUUUBUUUBUUUUUUBU
UUUBUBUUUUUUUUUUUUUUUBUBUUBUUBUUBUUUUBUBUBUUBUBUUUUUUUBBBUUUBUUUUUUUUUUUUUUUUUBBUUUUUUUBBBUBBBBBUUUUU
UBBUBUBUUUUBUUBUUUUUUBBUBBUUUUUUBBUBUUUBUUUUUBUBUBUBUUUUBUUUUBUUUUBUUUBUUUUUUUUBUUUUUUUUUUBUUBUBBUUUU
UUUBUUUUUUUUUUUUUBUUBUUUBUBUUBBUUUBUUUUUUBUUUUUUUUUUBUUBUUUUBUBUUBUUUUUBBBUBUUUUBBBUUUUBUUUUUUBUBUUUU
UUUUBUUUBUUBUBUBBUBUUBBUUBUUUBUUUUBBUUUUBUUUUBUBBUUBUUUUUUBUUUBUUUBBUUBBUBBUUBUBBUUUUBBUUBBUUBBBUUUUU
UUBBUUUUUUBUUUUUBUBUUBBBUUUUUUUBUUBBUUUUUUBUUUUUUUUUUUUBUUUUBUUUUUUUUUUUBUUUBBUUUBUUUUUUUUUUBUUUUBBUU
BBUBBBBUBBUUBUBUUUBUBUUUUBUBUUUUUUUUUUBBUBUUUUBUUBUUUBUUUUUUUUBUUBBBBUUUUUBUUBUBUBUUUUUBUUBUUUBBBBUUB
UUUUUUUUUUUBUUBUBUBUUBUBBUUUUBUBBBBUUUUBBBUUUUBUUBUBUBUUBBUUUUBUUUUUUUUUUUBBUUUUUUUBUUUUBBBUUUUUUBUUU
