UUUUUUUUBUBBUUBUBUUUUUUUUUBUBUUUUUUUUBUUUUUUUBBBUBUBUUUUBUUUUUUUUBUBUBUUBUUUBUUUUBBUUBUUBBUUUUUBUUBUB
BBUUUUBUUUUUUUBUUBUUBUBBUUBBUUUUUBUUUBUUUUUUUUUBBUUUBUUUBBUBUBUUUUBUUUUUBUUUUUUUUUUUBUUBUUBUUBUUUUBUB
UBUUUUUUUBUUBUUUBUUUUBBBBUUUUBUUUBBUUUUUBUUUUBUUUUBUUUBBUBBUUUUUUBBBUUBUUUUUUUUUBUUBBBBUUUUBBUUBUUBUU
UUBUUBUUUUUBBUBUUBBBUUBUUBBUUUUUBUUUUBUUUUUUBUBUUUUUUUUBUBBUBBUUBBBBUUUUUUUUBUBUUUBUUUUUUUBBUUBBUUUBU
UUBBUUUUBUBBBUUUUUUUUBUUUBBBUBBUUUBUUUBBUUBUUUUUUBUUUUUBUUBUUBUUUBUUBBUUBUUBUUUUUUUUUUBUUUUBUBUUUUBUB
UBBUUUUUUUBUBUUUBUBUBUUUUBUUUBBUUBBUUUUUBUBBUBUUUBUUBBUUBBUBBBUBUUUUUUUUUBUUUBBBUUBBBUBUUUUUUBUBUBUUU
UUBBUUUUUUUUBUUBUUBUUBUUBUUBUUBUBBBBBBUBBUUUUBBBUUBUBUUUUUUUBUUBUUBUUUBUBUUBUUBUUUUUUUBBUUUBBBUBBBUUU
BBUUUBBUUBBUBBBBUUUUUBBUUUUUUUUUUUUUUUUUUUBUBUUBUUBUUUUBBBUUUUUUUUUUUUUUUBBUUUUUUUUUBUUUUBUBUUUUBBUUB
UUUBUUUUUBUUUBBUUUUUUUBUBBUUUUBBBUUBUBUUBUBUUUUBUUUUUUUBUUUUUUUUUUBUUBUUUUUUBUUUUUBUBBUBUUUBBBUUUUUUB
UBBUUBBUBBBBUUBUUUUUUUBUBUUUUUBUUUUUUUUBBUUBBUUBUUBUUUUUUBUUUUUBUBBUUUBUUBUBBBUUUUBUUUBUBBBBBBUUBBUUU
BUUUUUUUUBUUBBUUUBUUUBBBBUUBUUUBBBBUUUUUBBBBUBUUBUBBUUUBUBUUUBUBBUUUUUUBUUUBUUUUBUBUUUUUUUBUUUUUUUUUB
BUUUUBBUBBBUBBUUUUUUUBBUUUUBUBBUBUUUBUUUBUUUUBUBUUUUBBUBUUUBUUBUBUUUBUUBUBBBUUUBBBUUBUUUUUUBUBBUUUBBB
UBUUUBUUUUUBUBBUBUUUUUBUUUUUUUUUUBBUUUBUUBBUUUBBUBUUUUUUUUBUUUUBUUUUBUUUBUBUUUUUUUUUBUUBUUBUUUBBUUUUB
UUBUUBUUUUUBBUUUBUBBUBUUUUUUBUUUUUUBUBBUUUUBUUUUUUBUUUBUBUBBUBBUUUUUUUUUUUUBUUUBBBUBUUBBUBUBUUBBUBUUU
BUBUUUBUBUBUUBBUBBUUUUUUUUUBUUUBUUUUUBUUUUUUBUUBUBUUUBBBUUUUUUUUUUUBUBBUUBBUUUBBUUBUUUBBUUUUUUUUUUUUU
UUUUUUBBUBBBUUUUUBBBUBUUUUUUBUUUUUUUUUBBBUUBUBUUUBUUBUUUBUUBBUUBBUUBUBUBUBUUUUUUUUBUBUUUUBUUBBUUBUUUU
UUUUUBUUUUBBUUUUUUUBUUBBUUBBUUBUBBUUUUUUUUUUUBUBUBUBUUUUUBBUUBUUUUUBBUUUUBUUUUBUUUUBUUUUUUUBUUUUUUUBU
BUUUBUUUBUUBUBBBUUUBUUBUUBUUUUUUUUBBUUUUUUUUUUBUUUBBUUUUUUUUUUBUBBUBBUUUUUUUUUUUUUUBUUUUUUUUUUUBBUUBU
BUUUUUBUUUUBUUBBUUBBUUBBBUBUUUUBUUUUBUUBUUUUUUUBUUUUUUUUUUBUUBUUUBUUUUUBBUUUBUUBUUUUUUUBUBUUBBUUBUUBU
BUUBUUBUUUUUUUUBBUBUBUUUUBUUUBUUUUUUUUUUBUUUBUUUBUUUUBUUUUUUUBBUUUUBUBBBUBUUBBUUUUBBBUUUUBUUUUUUUUUUU
UUBBUBUUUBUUUUUUUUUBBUUUUBUUUUUUUUBUUBBUUUUBBUUUUBUUUUUUUUBUBUUUUBBBUBUUUUUUBUBUUUUBUUUUBUUBUUUUUUUUU
UBBUUUBUUUUUUUBUBUUUUUUBBUUUBUBUUUBBBBUBUUUBBUUBBUUUUUUUBUUUUUBBUUBBBUUUBUUUUUBBUBUUUBBBUUUBBUUBBUUBU
UUUBUUBUUUBBBBUUUUBUUUUUBUUUUUUUBUBUUUUUUBBBUUUUUUBUUUUBUUUUUUBUUUBUUUBUBBUUBUUBBUUUUUUBUUBBUUUBBBUBB
BUBBUBUUUBUUBUBBUBUBBBUUUUUUBUUUUUBBBUUBUUUUUUUUUUBUUUUUUBUUBUUUBBBBUUBBUUUUUUUUUUUUBUUBBUUUUUUUUUUBU
BBUUUUBUUUBUUUUUBUUUUUBUBUBUUBUUBUUUBUUBUBBBUBUBBBBBBUUUUBUBUUUBUUUBUBBUUUBBUBUUBUUUBUBBUUBUBUUUUBUBB
UBUBUUUBBBUUBUBUUBBUBBBUUBUUUUBBUUUBUUBBBBUUUBUUBBBUBUUUUUUUUUUUUUUUBUUUUUUBUUUUUUUBUUUUUUBUUBUUBBBUB
UUUUBUBUUBBBBUUUUBUUUBUBUUUUBBBBBUUBBUBUUBUUBUBUUBBBBUBUUBUUBUBBUUBUBBBUUBUBUBUBBBBUUUBUUUBUBBUUUBUBB
UUUBUUUUUUUBBBUUBUUUBUUUUBUBUUUUBUUUUUUUBUBBBBUUUUUBUBUBUBBBUUUBUUUUUUBUUUUUUBUUUUUBUBUBUBUUUBUUBUUUU
BUUBUUUUUBUBUBBUUUUUUUUUUUUBBBUUUBUUUUBUBUUBUBUUUUUUUBBUUUUUBBBUUUUUUBBUUBUBUUBUUBBBUUBUUUBUBUUBUUBUB
BUUUBUBUUBUUUUUUBUUUUUUBUUBUUBUUUUBUUBUUUUUUBUUUUUUUBBBUUBUUUUUBUBBBUUUUUUUBUUUBUUUUUBBBBBUBBUUBUUUUU
UBBUUUUUUUBUUUBUUUUUUUUUBBUUBUUUUUBUUUUUUUBBBBBBBBUBUUBUUBBBUUBUUUUBBUBBBUUUUUUBUUUBUUBBUBBUBBUBBUBBU
BUUUUBUBUBUUBBBUUUBUUUBBUUUUUUUUUUUBBBUUBUBUUUBBUBUBBUUUUUUBUBUUUUUUUBUUUBUUBUBBUUBUBUUUUBUUUUBBUBUBU
BUUUBUUUUBUUBUBUUUUUUUUUUBUUBUUBUUUBBUUUUUUBBUUBUUUUUBBBUBUUUUUUBUBUBBBBUUUBUBUUBBUBBUUUBUUUUBBUUUUUU
UBUUUUUUBUUBBUUUUUUBBUBUBUBBUUBUUUBUUUUBUUUUBUBUUUBUUUUUBUUBUUUUBUUBUUUUUUUUUBUUUUBUUBBBUUUUUUUBUUUUU
UBUBUUUBBBUUUBUBUUBUBUUUUUBUUUBUBUUBUBUUUBBBBBUBUUBUBUUUUUUUUUUUBUBUBBBUUBUUUUUUBBBUUUUUBBUUUUBBUUBUU
UUBUUUUUUBUBBBUBUUUUUBUUUUUUUUBUBUUBBBUBUUUUUBUUUUUUUBUUUUUUBUUUBBBUUBBUUUBUUBBBUUBUBBBUUUUUUUBUUUUBB
BUUUUBUUUBBUUUUUBBBBUUUUUUUUUBUBUUUUUUUUBUUUUUBUUUUBUUUUBUUUUBBUUBUUUUBUUUBBUUBBUUUUUUUUUUUUUUUUUUBUU
BUUUUBUUUBBUBUBUUBUBBUUUUUUUUBBBUUUUBBUUBBBBUUBUBUUUUUUUUBUBUBUBUUBBBBBUUBUBUUUBUUUUUBBUBBUBUUUUBBUUU
UUUUBUUUUUBUUBBUBBUUUUBUUUUBUBBUUBBUUUUUUUUUUUUUUBUBUUUBBBBUUUBUUUUUUUUUUBUBUBUUUUUUUUUUUUBUUUUUBUUUB
UUUUUBBBUUUBUUUBUBUBBUUUBUUUUUUUUUUBUBUUBUBUUUUUUBUUUUUBUBBUUUBUBUUBUBBUUUUUUUUBUUUBBUUBUUBUUUBUUUBUB
UUUUUUUUUUUBBBUBUUUBBUUBUUUBUUBUUBUUUUUBUUBBUUUBBUUUUUUUUUUUBUBUUUUUUBUUBUUUUUUUUUUUBBBBUUUUUBUUUUBUU
UUUUUBUUUUBUUUUUUUUUUUUBUUUUBBUUUBUUUUBUUUUBBUUBUBUUBUBUBBBUUUBBUBUBUBUBUUUUUBUUUUBBUUUUUBUUBUBBBUUUU
UUBUUUUUUBBBUBBUUUBBUUUUUBUUBUUBUUUUBUUUUUBUUBUUUUUUUUUBUUUUBUBUBUUUBUBUUBUBUBUUUUUBBUUBUUBUUUBBBBUUU
UUUUBBBUUBBUUUUBUUUUUUUUBUUUUUUUUUUUUBBBBBUUUUUUUUBUUUBUBUBUUBUUBUUUUUUUUBBUUUBBUBUUUUUBUUUUUUUUUUUBB
UBUBUUUUUBBUBUUUUBBUUUUUBUUUUUUUUUUBUUUUUUUUBUUUUUUUBBUBUUBBUUUBUUUUUUUUUBUUUUBUBUBUBBUUUBBUUUUUUUUBB
UUUBUUUUUBUUUUBUUUBBUUBUUBUUUBUUUBBUUUBBUBUUUUUUUUUBUUBUUUUUUUUBUBBBUBUUUUUBUUBUUBBUUUUUBUUUBBUUUUUBU
UUUBUUUBBUUUUUBUUBUBUBUBBUBUUUBBBUBUBBUUUUUUUBUUUBBUBBBUUBUUBBUBBUUBUUUUUUUUUUBUBBUUBUUUBUUUBUBBBUUUB
UUUUUBBUUUUUUUUUUBUBUBBUUUUUUUBBUUUBUUUUBUUUUBUUBBUUUUBUBUUUBBUUUUBUBUUUUUBBUUUUUUBUUBUBUUUUUUUBUUUBU
UUUUUUUUUBBUUBUBUBBUUUUUUUBUUBUUUUBUBUUUBUUBUUUUBUUUUUBUUUUUBUUUUUUUUUUBUUUUUUUUUUUUUUBUBBUUUUUUUBUUB
UUUUUBUUUUBBUUUUUUBUUUUUUBUBUUUUUUUUBUUUBBUUUUBUUBUUUUUUUUBBUUUUBUUBBBUUUBUUUUBUBUBBUUUUUUUBUUBUBUUBU
UUUUUUUUBUUUUBUUUUUUBUUUUUUUBUUUUUUUBBBUUUUUUUUBUUUBUBBUUBUUUBUBUUUUUUUBUUUUUBBUBUUUUBBUBUUUBBUUUUUUB
BUBUUBUUUBUUUUUBBUUBUUBUUUBUUUUUUUUBBUBBUUUBUUUUUUUUUUBUUUBBBUBBBBUUUUUBUUUUBUUBUUBUBBUBUUUBBUUUBUUUU
UUBUUBBBUUBBUUBUUBUUBUBUUUUUBUUUUBUUUUUUUUUUUBUUUUBUBUUUUBUBUUBBUUUUBUBBUUUUUUUUUBUBUUUBBUUUUUBBBUUUB
BBBUUBUUUUUBBBUUUBUBBBBBBBUBUUUUUUBUUUUUBUUUUBUUBUUUUBBBBUUUUBUUBUUUUUUUUUBUBUUBUUUUUUUBUBBUUBUUBUUUB
UUUUUUBUBBBBBBBUUUUUUBUUUUUUUUUBUUUUBUUUUUUUBUUUBBUUUBBBUUBUBUBUUUBBUUUUBUBUUUUUUUBBUUUUUUUUUUUUUUBUU
BUBUBUUUUUUUUUUBUUUBBBUUUUBUUUBUUBUUUUUBUUUBUUBUUUUUUBUUUBBUUBBUUBBBUUUUBUBUUUUBUUBUBUUUUUBUUUUBBUBUB
UUUUUUUUUBUUBUBBUUUUBUUUUUUUUBUUUUUUBUBUUUUUBUUUBUUUUUUBUUUUUUBBUBUUUBUUBBUUUUUUBUUBUUUUUUBUBUBBUUBUU
UBUUBBBUUUBUUBUUBUBUBBUUUBUUBUBUBUUBUUUUUUUUUUUUUUUUBBBUUBUUUUUUUBUUBBBUUUUUUUUUUUUUUUBUUBBUBUBUUUBBU
UUUUUUUUUUUUBUBUBUUUUBBUUUUBBUBUUUUUUBUUUBUUUUBUUUUUUUUUUUUUBUUUUBUUUUBBUUBUUUBUUUBBUUUBUBUUBUUUBUUBU
UUUUUUUUUUUBUUUUUBUBBUUUBUUUUBBUUBUUBBUUUUBBUUUUUUUBUBUBUBUUUBUUUBUUUBUUBUUBBUUUUBUUUUUUBUUUUBBUBUUUB
UUUBBUBBBUUUUUBUUUUBUUUUBUBBBUBUBUUUUUUBUUBBBBBBUUUBUBUUUUUUUUUBUBUUBUUUBUBUUUUUUBBBUBBUUUUBBUUUUUUBU
UUBBUUUUUUUUUUUUUBUUBUUUBBUUUBBUUUUBBUUBBBBUUUUBUUUUUUBUBUUUUBBUUUUUUUUUUUUUUUUUUBUBUUUBBUBBBBUBUUUUU
UUUUBUUUBUUUUUBUUUUUUUBUUUUUUUBBUUUUUUBUUUUUUUUUUUUUBUBUUUBBUUBBUBUUUBUUBUUBBUUBUUBBUUUUBUUUUUBBUBUUU
UUBUUUUUBBBUBUBUUBBUUBBUUUUUUBBUUUUUBUUUUBUUUUBBUBUUUUUUBUUUUBBUBUUUUBBUUUUUBUBBUUBUUBUUUUUUUBBBUUUUU
UUUUBUUUUUUBUUUUUUUUUUBUUUUUUUUUBUUBUBBBUUUUUUBBUBBBBUUUUUBBUUUUBUUBUUBUUUUBUUUUUBUBUBBUUUUUUUUUUUUBB
BUUUUUBUUBUUBUUUBUUUBBBUBUBBUBBUBUUBUUUUBBUUBBBUUUUBUBBBUUBUUUUUBBUUBUUUUUBBUBUUBUUUUBUUBUUUUBUUUUBBU
UUUUBBBUUUBUUBUUUUBUBUUUBBUUUUUBUBBBUUUUBBUBBUUUUBUUUBUUBUUUUBBUUUUUUBBUUUUUUUUUUBBBUUUUUUBBUUUUUBBBU
UUUUUUUUBUUUUUUUUUUUUUUBUBUUBBUUUUBUUUUBUUUUUUUUUUBUUUUUBBUUUBUUUUBBBUUUUUUBUBBUUUUUUBBUUUUUUUUUUUBBU
UUBUUBUBBUBBBUBUUUUBUUUUUUUUUBBUUUUBUUBBUUUBUUBUBUBUUUUUUUUUUUUUUUUBUUUUUUUUUUUBUUBUBBUUUBUUBUBUUUUUU
UBUBUUUBBUUBUBUUBUBUUUUBUUUUUUBBUUUBUBUUUBUBBUUUUUBUBUUUUBUUUBUUBUUUBUUBUUUUUBUBUBUUUUUUBUBUBUUUBUUUU
UUUBUBBBUBUBUUBUUUBBUUUBBUUBUUUUUUBUUBBUUUBBUUUBUUUUUUBBBBUUUBUUUUUUUUBUUUUUUBUUUBUUBUBBBUUBBUUBUBUUU
UUUBUUBBUUUUUBBUBBUUUUUUUBUUUUBUBUUUUUBUBUUUUUUBBUUBUUUUUUUUBUUUUBUBUUUUBBUBUUBBUUBUUBUUUUBUUUUUBBUUU
UBUUBUBBUUUUUBUUUUUUBUUBBBUBUUUBBUUBBUBBUBBUUUBUBUUBUUUUUUUUBUBUUUBUBUUUBBBBBUBBBUUUUUUUBBUUBUBUBUUBU
UBUBUUUUUBUUUBUUBUUUUUUBBUUUBUBUUBUBBBUUUUUUBUUUBBBBUUBUBUUUUBUUBUBBBUUBUBUUUUUUUUUUUUUUUBUBUBUUUBUUU
UBUBUUBUBBBUUBUBUBUBUBUUUBBUBBUUUUUBBUUBUUUUBUUUBUBBUBUUUUUBBUUUUUBUBUBUBUBBBUUUUUBBUUBUUBBBUBBBBUUBB
UUUUUBUUBUUBUUUUUUBUBUBUBUUUUUBBUUUUUUUBUUUUUUUUBUUUUUUBUBUUUUUBUBUUUUUUBUBBUUUBUBUUBBBUUUUUUUBUUBBBB
BBUUUUBBBUBBBUUUBUBUUBBUUBBBUUBBUBUUBBBUUBUUUUUUBUUBUUUBBBUUBUUBUUBUUBUBUUUUBUUUUUUUUUBBBUUUBBUUUBUUB
UUBUUBUUBUBBUUBUBUBBBBBUUUUUBUBUBBUUUUUUUUUUUBBUUUUBUUUBUBUBBBUUUBUUUUUUBUUBUBBBBUUUUBUUUUUBUUUBUUUUU
UBBBUUBBBUUBUUBUUUBUUUBBUUBUUBUUBUBUUBUUUBUUUUBUUUUUUBUBUBUUBUUUUUUUUBUUUUUBBBUUBUUUUBUUUUUUUUBUUUUBB
UBUUBBUBUUUUBUBUBBBBUUUUBUUBUUUBBUUUUBBBUBUBUBUBUUUUUUUUUUBUUBUBUUBUUUUUUUUBUUUBBUBUUBUBBBUUUUBUUUBUB
BUBUUBUUBUUUUBBUUUUUUBUUUUUUBUBUBBUUUUUBBUUUBUBUBUBUBUUUUBUUBBUUUUUBUBUBUUUUUUUUUUUUUUBUUUUUUBBUUBUBB
BUUUUUBUUUBBUUBBUBUUBUBUUBUBUUBUBUUUUUBUUBUUUUBBUBUUUBUBUUUBUUUBUUUUUUUUUUBUUBUUUUUUUBUUBUBUBBUUUBUUU
BBUBBUUUUUUUUBBBUUUUBUBUBBUBUUBBUUUUUUBUBUUUBBUUBBUUUBUUBUUBUUBUUUUBBUBUUUUUUBUBUBBBUBUUBUUBBUUUUUUBB
UUUUBBUUUUUBUUUUUBUUUUUUUUBUUUUUUBUBBBUBBUBBBUUUUUUBUUBUUUUUUBBUUBUBUUUUUUUUBUUBUUUUUBUUUUUUUBUUBUBUU
BUUUBUBBUUUUBUUUUUBBUUBUUBBUUUBBUBUUUBUUUBUUUUBBBBUUUUUUUUUUUUBUUUBBBBBBUBUBUUUUUUBUUUUBUUUUUUUUBBBUU
UUUUBUBUBBUUUUUUUBUUUUUUUUUUUUUBBUUBUBUUUUBUUUUUBUUBBUUUUUBUUUBBBBUUUUUBUUUUUUUUBUUUUUUUUUBBBBUUBBBUU
UUBBUUBUUUUBBUUBBUUUUUBUUUBBUBUUBBBUUUUUUUUUUUBBBUUUUBUUUUBUBUUUUUBUBBBUUUBBUUBBUUUUUBUUBUBUUUBUUUUUU
UBUUBBUUBUUBUUUUBBUBBBUBUUUUBUBUUUUUUUUBUUUUUBUUUUUUUBBUUUUUUUBUUUUBUBUUUUBUBBBUUUUUUBBUUBUBUUUUUUUUU
BUUBUUUUUBBUUUBBBBUUUBUBUUUBBUUBUUUUUBUUBUUBBUUUUUBUBBUUUBUUUUUBUUUBUUUBUUUUUUUUUUUBUUBBUUUUBUUUUUUUB
BUBBUUBUUUUBUUBUUBUBUUUBUBUBBUBUUBUUUUBUUUUBUUUUUUUUUUBBUBUBUUUBUUUUUUUUBUUUUBUUBBBUUBUUUBUBUUUUUBUUB
BUUUUBUUUUUUUUUBBBUUBUUUUBBBUUUUUBBUUUBUUUBUBBUUUUUBUUUUUUUUUUUUBUUBBBUUUUUBUUUBUUUBUUUUUBUUUBUBBUBUU
UUUUUUUUBBBBUUUBUUUUUUBBUBUBBBBUUBBUBBUUUUUUUUUBUUUBBUUUBBUUUUUBUBUUBUBUBUBUBBUUBBBUUUUUBBUUUUBUUUUBU
UUUUUUUUUUBBBUBUUUUBUBUUBBUBUUUUBBBUBUUUUUBUBBUUUUUUUUUUBUBUUBBBUUUUUUUUUBBBUBUUUUUUUUUUUUUUBUUUUBUUB
UUBUUBUBUBUUBBBBBBBUUUUUUBBUUUUBBBBUBUUBBUUUUUUBUBUUUUUBUUUBUBUBUBUUUUUBUBBBUUBUUBUUUUUUBUUUUBBBBUBUU
UUBBUUUUBUUBUBUBUBUBUUUUUBUBBUUUUUUUBUBUUUUUUBBBUUUBUUUBUUBBUUBUUBBBUUBUBUBBUUUBUBBUUUBUUUUUUUUUUUBUU
BBUUBUUBUUBUUUUUUBBUBUUUUBUUBBBUBUUUUBBUBBUUBUUBUBUUUUUUUBUBUUBBUBUBUUBBUBUUUUBUBBUUUUUUUUBUUBBUUUBBU
UBUBBUBUUUUUUUUUUBUUBBUUUUUBBUBUUUUUBBUBBUUUUUUBUBUUBUUUUUUUBUBUUUUUUUBUUBUUBBUBUUBUBUUUBBUUUBUBUUBUU
UBBUBBUUBUUBUUUUUUBUBBUUBUBBUUUBUUBBUUUUBUUBUBUUBUBUUUUUUBBUBBUUUUUBUBUUBUUUUUUUUBBUUUUUUBUUUUBUUUUBB
UUUUUUUUBBUUBUBBUBBUBBBUBBUBBUUUUBUUBUUUUBUUUUUBUUUUUUBBBUBUUUUBBUBUBBUBUUBBBUUUUUUUBUBUBBUUUBBUBBUUU
UUUUUUBUBUUUUBUUUBUUUUUBUUBUUUUUUBBUUUUBBUBUUBBBUBUUBUUBUBUBUUUUUUUBUBUBBUUUUBUUUUUUUUBUUUUUUUUUUUUUB
BBUUBUUBUBUUUUBUUBBBBBBUUUBUBUUUUBUUBUUBBUBUBUBBUUUBUBUUBUBUBUUUUBUUBUUUUBUUUUBBBUUUBUUBUUUUUUBUUBBUU
