UUUUUUBUUUUUBUBUUBUUUBBBUUUUBUUUUUUUUUUUUUBBBUBUUBBUUUUUBBUUUUUBUUUUUUUUUBBUUUUUBUUUUBUUUUUUBUUUBUUUB
UUUUBUUUUBUUUUBUUUUUUUBBUUUUUBUUUBUUUBBBUUUUUUUUUUBUUBUUUUUUUUUUUBBBBUBUUUUBUUUBUUUUBUUUUBBUUUUUUUUUU
UUUUUBBUBUUUUUUUUUUBUUUUUBUUUBUUUUBUUUBBUBUUUUUUUBUUUUUUUUUUUUBUUBUUBUUBUBBUUUBUUUUUBUUUUUUUUBUUUBBUB
UUUBBUUUBBUUBUUBUUUUUUUBUUBUUUUUUBUBUUUUUUBUBUUUBUUUUUBUBUBBBBBUBUUUUUBBUUBBUUUUBUUUUUUUUUUUUBUUUBBUU
BUUUUUUUUUUUUUBUBUUUUUUUUUUUUBUUUUBUUUUBUUBUUUUUUUUBUUUBBBBBUBBUUUUUUUUUUUUBUUBUUUUUUUBUUUUUBUBUBUUUB
UUBUUUUBUUUUBBUUUBUUUUUUUUBBUUUUUBUBUUUUBBUBBUUUBUUUUBBUUUUUBBUBBBUBUBUUBUUUUBUBUBUUUUUBBUUUUBBBUUBUU
UBUUBBUUUUUBBUUUUUUUUUBBBUBBBBBUUBUUUUUUUBUUUBUBUUUUBUUUBUBBUBUUUUUUUBUUUBUUUUBUBUBUUBUUUUUUUUUUBUUBU
UUBUUBUBUUBUUBUUBBUUBUUUUBUBUBBBBBBUUUBUUUUUBUUUBUUUBUUUBUUUBBBBUBUUUUUUBUUUBUUBBUBBUUUBUBBUUUBBBUUUU
UUUUUBUBBUUUUBUBUBUBUUBUUBUUUUUBUUUUBUUUBUUBUUUUUUUUUUUUUUUBBUUUUUUUUUBBUUBUBUUBUUUBUBUUUBBUBUUUUBBBU
UBBBUUUUUUUUBBUBUUUUUBUUUUUUUBUUUUUUBBBUUBUBUUUUUUUUUUUUUUUBBUBUBUUBBBBUUUUBUBUUUUUUUUUUBUUUUBUUUBBBU
UBUBBUUUBUUBBUBUBUUBBUUUUUUUUUBUBUUBUUUBUUUUUUBUUBUBBUUUBUBUUUUUUUUUUUUUBUBBUBUUUUUUUUUUBUBUBUUBBUUUU
BUUUUBUUUUBUUUBBBUUUBUUUUUBUUBBBUBUUUUUBBUBUUBBUBUUUUBBUUUBBBBBUBUBUBUUUUUUUBBUUUUUBUUUUUBBBUBBUBUBUB
UBUUUUUBUBUBBBBUUUUUBUBBUUUBBUUUUUBUUUUUUUUBUUUBUUUUUBUBUUUUBBUUUUUUUBUBUUUBUUBUUBBUBUUUUUUBBUUUUBBUU
BUUUUBBUUUBBUBUUUUUBBUUBUUBBUUUUUUUUUBUBUBUBBBUUBUUUUUBBUUUUUBBUUUUUUBUUUUBUBUBUUBUUUUUUBBUBUUUBBUUUU
BUUUUBBUUUUBUUUBUUUUBUUUBUUUUBUUBBUUUBBUUUBUBUUUUUUUUBUUBUUUUBUUUUUBBUBUUUBUUUBUUBUBBUUUUBUUUBUUUBBUB
BUUUBBUUUBUUBUUBUBUUUUUUBUUBUUBUUBBUBUBUUUUUUBUUUBUUBUUUUUBUUUUUBUUUUBBUUUUBUUUBBUUUBBUUBBUBBUUBUUUBU
UBUUUUUBUBUBUBBBUUUBUUBUUUUUUUUUBUUUBUUUUUBUUBUUUUUUBUBUUBUUUUUUBUUUUUBUUBUUUBUUUBUUUUUUUUUUUBUUUUUUU
UUUBUBUUUUBBUBUBBBUUBUBUUBUUUUUUUUUBBUUUUUBUUBUUUUUUUBBBBUUBUUUUBUBUUUUUBUUUUUUUUUBBUUBUBUUUBUUBUUBUU
UUUUBUUUUBBUBUUBUUUUUUBBUBUUUUUUBUUUUUUUBBUUUBBUBUUUUUUUUBUBUUBBBUBUUBUUUUUUBUBBUUBUUUUUBBUUBUBBBBUUB
UBBUUUUBBBBUUUUBUUUUUUBUUBBUUUUBUBUUUUBBUBBUBUUUUUUBBUBUUUUUBBUUBUUUUUUBBUBUUUUBUUUBUUUUUUUBBUUUBUUUB
UBUUBBUBBUUUBBUBUBUUUUUUUUUUUBUBUUUUUUUBBUBUUUBUUUUUBUBUUBUUUBUUUUUBUUUUUBBUUUUUBUUUUUUUUUUUUBBUUUUUU
UUBUUBUUUUUUUUUUUBUUBUUUUUUUUBUUUBUUUUUUUUBUUUUUBBUUUUBBBUUBUUBUUUBUUBUUBBBUUUBUBUUUUUUBUUBBBUBUUBBUB
UUBBBBUUUBUUBUUUUUUUUUBUUBUUUBUBUUBUUBUUBUBBUUUUUBUUBUUUUUUUUUUUBUUBUBUUUUBUUUBUUUUUBUUUUUBUUUUUUBUUU
UBUBUBUUBBUUUBUBUUUUUUUUBUBUUUUUUBBBUUBBUBUUBUUBBBBBUUUUBBUUBUUUUUUUUBUUUBBUUBBBUBBUUUUUBUBUBUUUUBUBU
BBUBUBUBUBUBUUUUUUUUUUUBUUUBUUUUBUBUUBUUUUBUUUUUUUUUUUUUBBUUUUUBUUUBUBUUUUBUUBBUUBUBUUUUUUUBUUBBUUBUU
UBUUUUUUUBUUUBBUUUBUBUUUUBUUUUUBUBUUUUUUUBBUBUUBUUUUUUBUBUUUUUUBUUBUUBUBBBBUBUBUUUUUUUBUUBBUUBUUBBUUU
BUUUUBUUUUUUUUUUUBUUUUUUUBUUBUUBBUUUUUBBUUUUBUUUUUBUUUBUUUUUBUUBBUUUBUUUUBBUBUUBUBUUUUBBBUUBUUBUBUBBB
UUBBUUUUUUUUBBUBUBUUUBUUUUUUBUBUUBUBBBUUBBUUBBUBBUUUUBBUUBUUBUUUUUBBUUUUUUUBUUUUUBUUUUUUBUBBUUUUUUUBU
BUUUUUUUUBUBUBUUUUBUUUUUUBUBUUBUBUUBUUBUUUBBUUUUUUUUBUUUUUUUBBUUUUBBUUUBBUBUBUBUBUUUUUBUUUUUUBUBUUBUU
UUUUUUBUBUUUBUUUUUUUUUUUUBUBUUBUUUBUUUBUBUUUBUUUUUUUUUBBUBUUBUUUUUUUUBBBUUUUBBBBBBUUUUBUUUUBUUBUUBBUU
UUUUUUBUUBBUUUUUUUUUUUUBUUUUUUUUUUBUBBUBUUBUUUUUUUUUBBUUUUBUUUUBUUBUUUUBUUUUUUBBUBUUUUUUBUUUUUBUUUUUU
BUBUUUUBUUBBUUBUUBUUBBBUUBUBUBUUUUBUUBUUUUUBUBUBUBBUUUBUUUBUUUUUBUUUBUBUUUUUUUUBBBBUUUBUUUUUBBUUBBBUU
BBUBUBUUUUUUUUUUUBUBBUUUUBBUUBUUUBUBUUUUUUUUUBUUBUUUUUUUUBUUUBBUBBBUUUUBUUUUUUBUUUBUBBUUUUUBUBUUUUUBB
UUBUBUUUBBBBUUUUBUUUUBUBUUUUBUUUUUUBBUBUUUUUBUUUUUUBUUBBBUBBUBUBBUUUBUUUBBUUUUUBUBUUUUBUUUUUUUBUUBUBU
UUBUBUUUBBUUUUBUBBUUUUBBUUUUBUUBBUUUUUUUUUUBUBUBUUUBUUUUBUUBUUUUUUUBBBUUBUBUBBUBUUUUUUUUBUUUUUUBBBUBB
UUUUUUUUUUUUUUUUUUUBUUBUUUUUUUBBBUUBBUUUBBUBUUBUUUUUUUUUBUUUUUUUUUBUUBBBUUUUUBBUUBUUBUUBUBUUBUUUBUUBU
UUUUUUUUUUUBUUBUBBUUUUUUUBUUUUBUBBUBUUUUUUUUBBUUUBUUUUUUUUUBUUUBUUBUUUUBUBUUUUBUBUUUBUUUBBUUUUUUUUUUB
UUBBUUUUUBUBUBBUUUBUUUUUUUBUUBUUUUUUBBBBBUBUUBUBUUUUBUUBUUBBUBUBUUUUUBUUBUUBUBUUBUBBUUUUBBBUBUBUBUUUU
UBUUUUUBUUBUUUUUBUUUUUUUUBUUUBUUBUBUUBBBBUUBUUUUUBBBUUUUBUUBUUBUUBBUUUUBBUUUUUUUUUUUUBUBUUBBUUUUUUUUU
BUUBUUUUUUUUUUUBUUUUUUBUUUUBBBUBBUUBUUBUUUUUUBUUUUUUBBBUBUBUUUUUUBUBUUUBBUBUUBBBUUUBUBUUUUUBBUUBUBBBU
UBBUUUUBUBUUBUUUUBUUUBBUUBBUUBUUUUUUUBUUUBUUUUBBBUUBUBBUUUUUBBUUUUUUUUUUBUUUUUUUUBBBUBBUBUUBUUUBUUUBB
BUBUUUUUUUUUUUBBBUUUUBBBUUBBUUUUUUBUBBUUUUBUBUUBBUUBUBBUUBUUUUUUBUUUUUBBUUBUUUUUUUUUBUBUBUBUBBUUUBUUU
UUBUBUUUUBUUUUUUBUUUBUUBBUUUUUUBBUUUUUUBUUBUUUBUUUUBUBBUBUUUUBUUBUUUUBBUBBBBUUBUUUBBUUUUUUUUUUUBUBUBU
UBUBUUUUUUBUUUBUUBUUUBBUUUUBUUUBUUUUUUBUUUUUUBBBUBBUUUBUUUBBUBBUBBUBUUUUUUUBBBUBUUUUUUUUBBUBUUUUUUBUU
UUUBBUUUUUBBUUUUBUBUBBBUUUBUUUUBUUUUUBBUUUUUBBBBUUBUUUBBUBUUBUBUBBBUBUUBUBUUUUUUBUBBBUUBBUUUBBUUUUUBB
BUUUUBBUUUUUBBBUBBUBUUUUUUUBBUBUUUBBUUUBUUUUUBBBUUUUUUUUUUBUBBUUBBUUBUUUUUUUBUBUBBBUUUUUBUUUBUBUUUUUU
UBUBUUUUUUUUBUBUUUUUBUUBBBUUUBUUUUBUUUUBUUBBUUUUUUBUBUUUBBUUUBUBUBUUBBBBUUBUUUUBUUBUUUBUUUUUUBUBBBUBU
BUUUBUUUUUUUUUUBBUUBUBBBBUBUUUBUUUUUBBBUBUUBBBBUUUUUUBUUUUUUUUUUUUUUBBUUUUBUUUUUUUUUBUUUUBBUUUUBUBUBU
UBUBUBUBBUUBUUUUBBUBUBUUUBBUBUBUBBUUBUBUUBUUUUBUUUBUUUUBBUUUUUBBUUUUUBBUBUUUUUUUBUBUBBBUUUUBUBUUBUBUB
UBUUUUUUUUBUBUUUUBUUBUBBUUBBUUBBUUUUUBUUUBUUUUUUUUUBUUUUUUUBUUBUUUUBUUUUUBUUBBBUUBUUUUBUUUBUBUUUBUUBU
UBUUUBUUUBBUBUUUUUUUUUUUBUBUUUUUUBUUBBUBUBUUUUUUUUUUBUBBUBBUUBUBUUUUUBUUUUUUUUBUUUUBUUUBUBBUBUUUUUUUB
BUUUUUUUBUUUUUBBUUBBUBUUBUBBUUUBUBUUBBUBBUUUUUUUUUBUUUBUUUUBBUBUUUBUUUBBBBUBBUUUUUBUBBBUBUUUUUUUUBUUU
BUUBUBUUUBBUUBBUBUUBUBUUUBUUUUUBUUUUUUUBUBUBUUBUUBUUUBUUBUUBUUBUBBBBBUUUBUUUUUUUBBBUBBUBUUBBUBBUUUUUU
UUBUUBUUUUUBBUUBUUBUUUBUUUBUUUUUBUUUBBBBUUUUBBBUUUUBUUUUBUUUUBUBBUUUUUUUBUUUUUUUUUBUBUUUBBBBUUBBUUUUU
BUBUUUBUBUUBBBUBUUUUUUUUUBBUUUUBUUUUBBUBUBUBBUUUUBUUUUBUUUUUBUUUUUUUBBUUUUUUBUBUUUBUUUUBUUUUUUUBUUBUU
BUUBUBBUUUUUUUUUUUUUUUUUUUBUBBBBUUUBUBUUBBBUBUUBBUBUUUBUUUUBUUUUBBUUUUUUBUUBUBUUUBUUUBUUBUUUUUBUBUUBB
UUUUBBUUUUUUUUUUUUUUUUUBUBUUUUUUUBUUBUUBBUUUUBUUUUUUUBUUUUUUUUUUUUUBUBUUUUUUBBUBUUBUUUBUUBBUBUBUBBBBU
BBUBBUUUUUUUUUBBUUUBBUBBUBUBUUUBUUUBUUBUUUUUUUUUUUUUUUUUUBUBBUBBBUUUUUUUUBUUUUBUUBUUBUBUBUBBUUUBUUBUU
UUUUUUUUBUUUBUUBUBUUUBUUUBUUBBUUBUUUUUBUBUUUBUUUUUBUBUUBUUUBUBBUUUBUUUUBUUUUBUUUBUBUUUUUUBUUBUUUUUBUB
UBUUUUBBUUUUBUUUBBUBUUUUUUUUUBUUBUUUBBUUUUUUUBBUUUUUUBUUBUUUBUUUUUUBUUUUBUUUUBUBBUUUUBUUUUBBBUUBUUUUU
UUUUUUUUUUUUUUBUBUBUBUUBBUBUUUUUBBBUUUUUUUUUUUUBBUUUUBUBUUUBBUBUUBBBUUBBUUUUUUUUUUBBUBUUUUUBUUUBUUBUB
BUUBUUUUBUUUUBUBBUBUUUUBUBUUBUUBUBUUUUUBUUBUUUUBUUUBUBBBUUUUBUUBUUUUUUUUUBBUBUBUBUUUUUUUUUUUBUUUBBUUB
UBUUBUUUBUUUUUUUUUUBBUUBUUUBUUUBBUUUBUBUUUUBUUUUUBBUBBUUBUUBUBUUUBUBUUBBUUUUUUUUUUUBUUBUUBUUBBUBUUBUU
BUUUUBUBBUUBUBBBUUBUBUUUUUBUUBUBUUBUUUUBUUUUUBUUBUUBUUUBBBUUBUUUBBBUBBUBUUUBUBUBBUUUUBUBUUBUUUUUUUUUU
UUUBUUUUUUUUUUBUUBUBUUUBBBUBBUUBUUUUUUUUUUUUUBUUUUBBUBUUUBUUBUBUUUUUBUUUUUUUUUBUUBUBUBBUBUUBUUBUBBUUU
UBUUUBUUBUUUUUBUUUBBUUUUUUUUUUUUUUBBBUUUUUBUUUUUUBUBBBBUUUUBUUBUBBUBBBBBUBUBBUBUBUBUBBBBUBUUBUBUUUUUB
UUUUUBUUUUUUUUUBUBBBUUBUBUUUBUUUUUUUUUBUUBBUUUUUUUUUUUUBBBUUBUUBBBBUUBUBUUBUUUUBUUUBBUUBBUBUBUUUUUUUU
UBUUBUUUUUUUUUBUUBUUUUUUUBBUBUUUUBBBUUUUUUUUUBUUBBUBBUUBBBBUUUUBUUBBUUUUUUUUUUUUBUUBBUUUUUUUUBBUUBUUB
UUUUUUUUUUUUUUBBUBUBUUUUUBBBUUUUBBUUUBUUUUUBUBBUUBBUUUBUUBUUUUUUUBUBUUBUUBBUBUUUBUUUBUUUUUUUBBUBUBUUU
UUUUUUBBBBBUBUUUBUUUUUBUUUUUUUBUUUUBUUUUBUUBUBBUUUBUBUBBUBUUBUUUUBUUUUBBUUUUUBUBBBUBUUUUUBUUUUUUUUBUU
BBUBUBUUUBUBUUBUBUUBUUUUUUUUUUUBUUUUBBUUUUUUUBUUUBUUBUUUUBUUBUBUUUUUUUBUBUUBBUUBBUBBUUUBUUUUUUBBUBBUU
UUBUBUBBBUUUUBBUUUUUUUUUUUUUUUUBUUUUBUUBUBUBUBBBBBUUUUUBBUUUUUUBUUUUUUUUBUUUUUUBUUUUUUUUBUUUBUBBUUBBB
UBUBUUUUBBUUUBUUBUUBUUUBBUBUUUUUUUUUUUUBBBUUBUUBUUBUBUUUBUBUBUUUBUUUUUUUBUUBUUUBBUBBUBUUBBUBUUUBUBUUU
UUBUUBUUUUBUUUUUBUUUUBBUBBUUUUUUUUUUUUUUBUUUUUUUBBUUUUUUUUUUBUBUUUUBUBBUUUBUBUUUUUBUUUBBUBUBUBBUUUUUU
UUUUUUUUUUUUUUBBUUUUBBBBUUBUUBUUUUBBUUUBBBUUUUUBUUUBUBUUUBUUBBBUUBUBBUUBUBUUUUBUBUUUUUUUBUUBUBUUBUUBU
UBUBUBBUUUBUUUBUUUBUBUBUBBUBUBUBUBUUBUUUUUUUUUUUBUUUUBBBBBBUUBUBUUUUUBBUUUUUBBBUUUBUUUBUBUBBUUUUBUUUU
UBBUUUUUBUBUBUUBUBUUUUUBBUUBUUBUUUUUUBUUUUBBBUUUUUBUUUUUUUUUUUBUUBUBUUUUUUBUUUBUUUUBBBUUUUBBUUUUBBUBU
UUUUUUUUBUUBUBUUBUUUUUUUUUBUBUUUUBUUBUUBBBUUUUUUBUBUUUUUBUBUUUUBUUBBUUBUUBUUBUUBUUBBUBUUUUBUUUBUUBUUU
UUUBBBUUBUUBUBUUUBBUUBUBUUBUUBUUBBUBUUBUUUUBBUUUBUUUBUUUBUBUUBUUBUBBBUBUUUUUUUUUUUUBBUBUUUBBUUBBUUUBB
BUUUUBUUBUUBUUUUUUUUUBUUUBBUUUUBUUUUBUUBUUBUUUUBBUBBBUUBUUUBUBBUUUUUBUUBUUBUBUUUUBUUUUUUUBUUUBUUUBUUB
BUUUUUBUUUUUUUUUUUBUUUBBUUUBBBUUUUUUBUUUUBUBUUUBBUUBBUUUUBUBUUBUBBUUUUUUUUUUUUUUUUUUUBUUUUBBUUUUUUUUU
UBUBBUUUBUBBUUUUBBBUBBUUBUUUUBUUUBUUBBUUUUBUBUUUUUBBUBBUUUUUBUUUBUBBBUBUUBBUBUBUUUUBUUBBBBUBUUBUUUUUU
BUUUUUUUUUUUBUUUUUUUBUUUBUUUUUUUBUUUUUUBUUUUUUUUUUBBBBBUBUUUBBUUBUUUBBBUUUUBUUUUBBUUUUBBUUBUBUBUUUUUU
UUUUBBBUBUUUUUUUUUUUUBUUBUUUUUUUUBUBBUBUUUBUUUUUUUUUUUUBBUUUUUUUUUUBBBUUBUUBUUUUUUBUUBUUUUUUUUUBUUUUU
UBUBBUUUBBUUUUUUUUUBUUUUBBUUBUUUUUBUBBBUUUUBUUBUUUUBUUUUUUUBUBUUUUBUBBUUBUUUBUUUBUUUUUUUUUUUUUUUBBBBU
UBUUUBBUBUUUUBUBUUUBBBUUUUUBUUBUUUUUUUUUUUUBBBUUUBUUUUBUBUUUUBUUUUUUUUUBUUUUBUUUUBBUUUBUUUUBBUUUBUUUU
UUBUUBUBUUBUBBUUUBUUUUBUBUUUBBUUUUUUBUBBUUBBBBUUBUUUUBUUUBUBBBUBUUUUUUBBUUUUUBBUUBUUUBBUBUBBBUUBUBUUB
UUUBUUUUUUBUUUBBBBUBUBBBUUUUUUUBUUUUUUUBBUUUBBUUUUBUUUBBUUUBUUUBUBUUUUUUUUUUUUUUUBBUUBBBUUBUUUUUUUBUU
UUUUUBUUBBBBUUUBUBBUUBUUUUBUUUUUBBUUUBUUBUUBUUBUBBUUUUUBUUBBUUUBUUUUBUBUBUBUUUUUUUBUUBUBUBBBUUUBUUUBU
UUUBUBUUBUBUUUUUUBUBBUUUBUBUUUUUBBBBUUBUBBUBUUUUBUUUUUBUBUUUUUBUUBUBUBUUUUUUUUUUUUUUUUUUUBUUBUUUUUUUU
UUUBUUUUBBBBUUUBBUBUUBUUBUUUUUUUBBUUUBUUBBUBUUUUUUBUUUUUUUUUBBUUUUUUUUUUUUBUBBUBBUUUBBBUUUUUUBBUUBUUU
UBUUBUBUUUUBBUUUUUBUUUUBUBUUBUUBUUUUUBUBUUUUUBUUBUBBUUUUUUUUBBBUUUBUBBUUUUBUBUUUUBBUUUBBUUUUBUUUBBUUB
UUUBUUUUUUUUUUBBBUUUUUBUUUUBBUUUUUBUUUUBBBBBUBBUUBUBBUUUUUUUUBUUUUUUUUBUBUUUBUUUBUUBBBUUBUBBUBUUBUUUU
BBUBUBUUUBBBUUBBBBUBUUUUUUBUUBUBUBBBUBUUUUUUUUUUUUUUUUBUBUUUUUBUBUUUBUBUUBUUBUUBUUUUUBBUUBBUBUUBUUUUU
BUBUUUUBUUUUBBBUUBBUBBBUBUBUUUUUUUUBUUBUUUUBUUUUBUUUUUUUUUUUBBUUUUUBUUUUUUUUUUBUUUBBUUUUUBUBUUBUUBUUB
UUUUUUUBBBBUUBBBUUBUBBBUUUUUUUBBUUBUUUUUUUBUBUUUBUUBUUUUUBBUUUUUUUUUUBBUUUUUBBUUBUUUUUUUBUUUUBBUUUUUU
UBBUUBBUUUUUUBBUBUUUUUUBUUUUUUUUUUUUUUUUBBBUBUUUUUBUUBBUUUUBUBUBUUUUBBUBUBUUUBBUUUBBUUUBBUUUBBUUUBUUB
UUUUUUUUBBUBUUUUBUBUUUUUUUUUUUBBUUUUUBBBBBBUUBUUUUUUUBUBUUUUBUUUUBBBUUBBUUUUBUBUUBUBUBUUUUUUUBBBUUBBB
UUUBUBBBUBUUBUUUBUUBUBUBBUUUUUBUUBBUUUUUBUUUUUBBBUUUUUUUUUBUBUBBBBUUUUBBUUBUUUUUUUUBUUUUBUUUUUUUUUUBB
UBUBUUBUBUBUUUUBUUUBUUUUUBUBUUUBUBUUUBUBUBUBUUUUBBUUUBUUUBUUUUBUUUUBUUBUUUUUUBBUUBBUBUBBUBBBUUBUBUUUU
UBBBUUBUUBUBBUBUUUUUBBUBUBBUUUUBBUUUUUBBUUUUUBUBUUUBBBUBUUUBBUUUUUUUUBUUUUUUBUUUUUBUUUUBUUBBUBBBUUUUU
