UUUUBUBBUUUBUUUBBUUUUUBUUUUUBBUUUUBUUUUUBUUUUUUBUBUUUUUBUUUUUUBUUUUBBUUBUUBUUUUUUBBUUUUUUBBBUBUBUUUUB
UUBUUUUUUUUBBBUBUBBUUUUBUBUBUUUUUUUUUBUUUBUUBBUUBBUBUBBUBUUBBUUUUUUBUUUUBUBUUUBBBUUUUUBUUUUBUBUUUUUBU
BUUUUBUUUUUUUBUUUUBBUBUUUBBUBBUBUUUBUBUBUUBBUUUUBUUUUBUBUUUUUUUUUBUUUBBUUUUUBBUUUUUUUBUUBUUUUUBUUUBBU
BUUUUUUBUUBUUUUUBBUBBUUUBBUUUBBBUBBBUUUUUBUBUUUBUUUUBUUUUBUUUBUUBUUUUUUUUUBBUUUBUUUUUUBUUUUUBUBBUUUUU
UUBBUUUUUBBBUUUBUUUBUUBUUUBBUBUUUUBUUUUBBBUBUBUBBUUBUUUBBBUUUUUBUUUUUUBBUUUUUBUBBUUUUUUBBBUUBBUBUUUBU
BUUUUBUBUUBUUUUBBUUUUUUUUBUUUUBUBBBUBUUBBUUBBUUBBBUUBUUUBUBUUUUBUUBBUUBUUBUUUBUUUUUUUUUUBUBUUUUUBUUUU
UUUUBBBUUUBUBBUUUUUUUUUBUUUUBUBBUUUBUUUUUBUUUUBUBUUBBUUUUUUUBUUBBUBUUUUBUBUBBBUUUUUUUBUBUUBUUUUUBUUUU
UBUUBBUUUBBBUUUUUBUUUUUBBBUUUUUBUUUUBUUUUUUUUBUBUUUUBUUUUBBBUUUBBBBUBUUUUUUBUBBUUBBUBUBUUBUUUUUUBBBBU
UUBUUBUUUUUBUUUUUUBUBUUUUUBUBUUBUUUUUBUBBUUBUBBUUBUBBUUUBUUUUUBUUBUBBBBUUUUUBUUUUUBUBUBBBBUUBBBBUBUUU
UUUUUUUUUUUUUBUBUUUBBUUUUUBUUUUUUBUBBUUUUUUUUUBUUUUUUUUUUBUUBUBUBUUBUUUBBUUUUBUUUBBBBUUUUUBUUUUBBUUUU
UUUUBUBUUUBBUUUUUUUUUUUUUUBUBUBBUUUUUUUUBUBUBBUUUUUUUBUUBBUBUBUBUUBUUBUUBUBBUUUBUUUUUBUBBBUUUUBUBUUBU
UUBUUBUBUBUUUUUUUUUUBBBUUUUUUBUUUBUUUUUBUUUBUUBUUUUBBBBUUUBUUBUUBBUBBUUBUUUBUUUUUUUUUUUUBUUBBBUUBUUUU
BUUUUBBBUUUUUUUUUUUBBUBBBUUUBUUBUUUBUUUBUBUUUUUUUBUBBBBUUUUUBUBBUUUBBBBUBBBUUBUUUUBUUUBUUBUBUUUUUUUUU
UUBBUUUUBBUUUBUUBBUBUUBUUBBUUUUUBBUBUBUUBBUBUUBUUBUUBUBBBUBUUUUBUUUUUBBUUUUUUUUUUUUUBUUBBUUUUBUUBUUUU
UUBUBUUUUUBBUUUUBBBUBBUUUUUUUUUBUBUUUUBUUUUBUBUUUUUBUBUUBUBUUBUBUUUUBBBUBUBUBUUUUUUUUUUUUBUUUUUUUUUUB
UBUUBBUUUBBUBUUBUUBUUUBUUBUUUUUUBBUUUUUBUBUBBBUUBUUBUUUUBUUBBUUUUUBBUBBBBUUUUUBUUBUUUUUUUUUUBUUUUUUUU
UBUBBUUUUBUUUUUUUUBBBUBBUUBUUUBBUBUUUUUBBUBUUBUUUUUBUUUUBUUUUUBUUUUBBUUUUUUUUUUBUUUBUUBBUUUUUUUUBUUUU
UBUBBUUBUBBUUBUUBUUUBUUBUUBUUUBUBBUUUUBUUUUBUBBUUBBBUUUBUBUBUUUUUBBUUUBUBUBBUBUUUBUBUUUBUBUBBUUUUBBUB
UUUBUUUBUUBBUBUUUUUUUBUBUBBUUUUUUUUUBUUUUUUUUUUBUUBUUBBUUUUBUBUUUUUBUUUBUUUUUBUUUUUBUBUUBBUBUUBUUUUUB
BUUUBUUBUBUUUBUUUBUUUBUUUUBBBUUUUUUUUBUBUBUUUUUUUBUUUUBUBUUUUBUUUUUBUBUUBBUBBUUBUUUBUUUBUUUUBUBUUUUUU
BUBBBUUUBUUUUBUBUUUBUUUBUUUUBBUBUBUBUBUBUBUBUUUUUBUUUUUUUUBUUUUUBUUBBBBUUUBBUUUUBUBUUBUUUUUUUUUUUBUBU
UUBUUUBUUUUUBBUUUUUBUBUUUUBBBUUUUUUUBUUBBUBUUUBUBUBUUBUUUUUUUBUUBBUBBUUUUBUUUUUUUUUUUUUUUUUUBBUUBBUBB
UUUUUUBUBUUUBUBUUUUUUUBBUUUBUUBUBUUUUUBUUUUBBUBUBBBUBUUUUUUBUUUUUUUBUUUUBUUUBUBUUUUUUBUBBUUBUUBUBUUUU
BUUUUUUUUBBUUUUUUUUUBUBUBBBBUUUUUUBUBUUBBUUBBUUUUUUUUBUUBUUUBUUUBUUUUUBBUBBBUBUUUBUBBBUUUUUUUUBUUUUUU
UUUUUUUBUBBUUUUUBBUUBUBUBUUUUUUUUUUBUUBUUBUBBUUUBUUUBBUBUBBUUBUUUUUUBUUBBBBUBUUUUBUBUUBUBUUBUUUUUUUBU
BBUBUUUUUBBUBUUUUUBBUUUUBUBBBUBUUUUUUUUBUUUUUUUUUUUUUUUUBBUBBUUBUUUUUUUUBUUUUUUUUBUUUUUUUUUBUUUUUUUBU
UUUBUUUUBBBUUBUBUUUUBBBBUUUUUUUUUUUUUBBUUUUBBUUUUBUUUUUBBBBUUBUUUBUUBUBUUUUBUUBUBUUUUUUUUBBUUUUBUUBUU
UUUBBUBBUUUUUUUUUUBUBUUBBUUBBBUUUBUUUUBUUUUBBUUBBUBUUUUUUBUUUBBUBBUBUUUUUUBBBUBUUUBBBUUUBBBUBUBBUUUUU
UBUBUUUBBUUUUUUBUBBUUUUBUUUUUUUBUBUUBUUUUUUUUUUUUBUBUBUBBUBUBUBUBUBUUUBUUUUUBUUUUUUBUUBBBUUBUUUUBUUUU
BUUBUUBUBUUUUUBUUUUUUUUBBUUUBUUUUUUUBUUBUUBUUBUUUBBBUUUUUUUUBUUUBUUUUBBUBUUBUBUUUBUBBBUUUUUUBBUUUBBUB
BUUUBUUUUUBUUUBUUUUUUBBUBUBUUUUUBBUBUUUUUBUBUBBUBUUUUUUUUUUUBUBUUBUUBBUUBUUBUUUUBUUBUUBUBBUUUUUUUUUUB
UUBUUUUBUBUUUUUUUUUUUUUBUBUUUUUUBBUBUUUBUUUUBBUUUUBUBBUBUBUUUBBUUUUUUBBUUUUBUUUUBBUBUBUUBBUUUUBUBUBBB
UUUUBUUUUUUUUUUBUUUUUBUUBUBUUUUUUUUUBUUUUUBUBUBUBUUUUUUBUBUUUUBBUUBUBUUUUUUBUUUUUUUBBUUUUBUUUBBUUBBBU
UBUUUUUUUUBUUUUBBUBBUUUUUUUUUUUUUUUUUUUUBBBUUUUUBUBUUUUUUUUUUUUUUBUUUUUUUBUBUUUUBUUUUBBUUBUUBBBUBUBBU
UUUUUBUUUBUUBUUBUUBUBUUUUUUUUBUUUBBUUUUBUBBUUUUUBBUUUBUUUUUUBUUBUBUUUBBUUUUUUUUUBUUUBUBUBUBUUUUUBBUUU
BUUBUUUBUUUBUUUUUUUUUUUUUBUBUUUUUUUUUBBBUUUUUUUUUUUBUUUUUUUUUBUBUBUUUBUUUUUUUBBUUUUBUUBBUUUUUUBUUBUUU
UUUBUUUUBBUUUUUUUUBUUBBUUBUBUBUUUUUUUUUUUUUBUUUUBBBBUUUBUBBUUUUUUBUBUUBUUUUUBBBUBBUUUUBUUUUBBUBUBBUBU
UUBUBUUBUBUUUUBBUBUUUUUUUBUUUUBUBUBUUUBUUUBUUUUUBBUUBBUBUUBUUUUBUUUBUUUUUUUUUBUUUBUBUBUUUBUUUUBUBUBUB
UUBBUBBBUUUUUUUUUUUUUUBBBBBBBUBBUBBBUBBBUUBUUBUUUUUUUUUBUUBUBUUBUUUUUUBUUBUUUBUBUUBBUUUUUUUUBUUUUUBUU
UUUUUUBBUUBUUUUUBUBBUUBUUBBUUUBUUBUBUUUBUUUUUUUBUBUUUUUUUUBUUUUUUUUBBBUUBBBUUUBUUBUUBUUUBBUBUUBBBUUBU
UUUBUUUUUBBUUUUUBUBUBUUUUBUUUUUBUUUUUUUUUUUUBUUBBBUUUUBBUUBBUBBUBUUUUUUBUUUBUUUBUUBBUUUBUUUUBUBBUUUUU
UUBUUUBUUUUUUUUUBBUUBBUUUUUUUUBUUUUUUUBBUBUUUBUUUUBUBBUUBBBUBUUUBBUUUUUBBUUUUUUBUBUUUUBUUUBUBBBUBBUUU
UBUUBUUUUUBUUBUBUUUUUUUUUUBBUUUUBBUUUUBUBUUUUUUBBUUUUBUUBBUUUUUUBUUUUUBBUBBBUBUUBUBUBBUBUBUUUUBUUUUUU
UUUUUUUUUUUBUUUBUUUUBBUBBUUUUBUBUBUUBUUUBBUUUUBUUUUUBUUUUUUBUUBUBBUUUUBUUUBBUBBUUBUBUUUUUUUUUBBUBBUBU
UUBBBBUUUUUUBBBUUBBBUUBUUUUUBUUUUUBUUUUBUUUUUUUUUUUUUBUUUBUUBUBUUUUBBUUUUBUUBBUUUUUBUUUBBBBBBBUUUUUUB
BUUUBUUUBUBUUUUUUBUUUUUUBBBUUBBBUUBUUUUBUUBBBUUUUUUUUUUUUBUUUBUBUBUBBUUBUBUUBUUUUBUUUBUBUUUUBUUUBUUBU
UBUUUUBBUUUUUUUUBUBUUUUUUBUUUUUBUBUUUUUUBUUUBUUUBUUUUUUBUUUUUUUUUBUBBUBBUUUUUBUUUUUUUBUUUBUUBUUBUUUUU
UUBUUUUUUUBUBUBBUUBBUUUUBBUBUBUUUBUUBUUBUUUUUBBUBUUBUUUUUBUUUBUBBUBBUUBUUBUUUUUUUUUUUUUUUUBUUUUUUUUUU
UUBBUUUBBUUBUUUBUUUUUUBUUBBUBBUBUUBBUUBBUUUBBBUUUBUUUUBUBUUBUUBUUBBBUBBUBBUBBBUBUUBBUBBBBUUUUUUUUBUUB
UUUUUUUBBUUUBUBUUUUBBUBBUUUBBUUUUBUUBUUUUUBUUUUUBBUBBUBBUUBBBBBUUUUUUUUUUUBBUBUUUUBBBUUUBUUBBUUUUBUBU
BBUUUUUUBBUBUUUUBBBBUUUUUBBUUUUBBBUUUUUUUUBUBBUUUUBUUUBUUBUUUUBBUBUUBUBUBUBUUUBUUUBUBUBBUUUUUUUUUBUBB
UUUBUUUUUUBUBBUUUUUUUBUBUUUUUUUBUBUUUUBUUUUUUUUUUUBUUBBUBUUUUUUBUBBBUBUUUUBBUUUBUBUBBBUBUBUUUUBUUBUUU
UUBUUUUUBUUBBUBUUUBUUUBUBBBUBUUUBUUUUUUUUBUUUUUBBUUBUUUUUUUBBUUUBUUUUUUBBUBUBUUUUUUBUUUUUUBUBUBBBUUUU
UUUBUUUUUUUUUUBUBUUBBBUBBBUBUUBBBUBUUUBBUUUUBUUBUUUBBUUUUUUBBUUUUUUUUUBUBUUBBUUUUUBUBUUBUBUBBUBUBUUBU
BUUBUUBUUUUUUUUUUUBBUUBBUBUUUBUBUBUBBUBUUBBUUUBUUUUUUBUUUUUUUUUUUUUBUUUUBUUUUUBBBUUBUUUBUBBBBUBUBUBUB
BUBUBBBBBBUUBUUBUUBBUUUBUUBUUUUUUUBBUUUBUUUUUBUUUUUBUUUUBBBUBUUUUUUBBBBUUUUUUUUUBUBUUUUBUUBUUBUUBUUUU
UBUBUUBUUUUUUUUUUUUUUUUUBUUBUUBUUUBUBUBUBUBBUUUBUUUBUUUBBUUUUBBBUUUUUUUUUBUUUUUUUUBUBBUUUUBBBBUBUBUUB
BBUBUBUBUBUUUUUUUUBBBBBBUBUBBUUBUUUBUUUUBUUUUUBBUUUUBUUBBUBBUBUUUUUUUBUBUUUBUBUUBUUUUBUUUBUUUUUUUBUUB
BUUUUUBUUUUBUUBUUBUUUUUUBUBUUUUUUBBUUUUUUUUUBUUUUUBUUUUUUUBUBBUBUBUBUUUUBUBUBUBUUBBUUUUBUBBBBUUUBBUUU
BUBUUBUBBUUBBUUBBBBBUBUUBBUBUUUUBUUUUUBBUUBUUBUUUUUBBUUUUUUUUBBUBBUBUUUUUUUUBUBUUBUUUUBUUUUUUUBUUUUUB
UUUUBUBUBBUUUBBUUBUUUBBUUUUUUUUUUUUUUUUUUBBUBUUBBBUUBUUBUUBUBBUUUUBUUUUUBUUUBUUUUUBUUUUUUBUUUUUBBUUUU
UUUBUUUUUBUUUUUBUUUUUUUUUBUUUUUBUUBUUBBUUUUUBUUUUBUUUUBUUUUUUUUUBUUUBUBUUBUUUUUBUUUUUBUUBBUUUUUUUBBUU
BBUBUUUUUUUBUBBBUUUUBUUUUUUUUUBBUUUUUBUBUUUUBUUUUUUUUUBUUBUBBUUUUUUUBUUBBBUUUBUBUUUUUUBUUUBBUUBBUUUUU
BUBUUBUUBUUUUUUUUUUUBUBUBUUBUUUUUUUUBUUUBUUBUBUBBUBUUUUUUUUUUUUUUUUUUUBBUUUUUUUBUBUUUUBUBBUBUBUUUUUUU
UBUUUBUBUUBUUUBUUUUBUBUUUUUUBBUBUUBUUBUUUUBBUUUBUUUUUBUUBBBUBBBBUUUUUBUBUBUUBUBUBUBUBBBUUUBUUBUUUUUUU
UUUBUBUBUUUBBUBUUBUUBBBUUBBUUUUUBUUBBUBUUUUBUUUBUUUUUUUUUBUBUUUBUUBUBUUUUUUBUUBUUUUBUUBUBBBUUBUUBUBUB
UUBUUBUBUUUUUBBUUUBBBUUUUUUBUBUUUUBBBUUBBUUBUBUBUUUBUUBUUUUBUUUUBUUUBUUUBUUBBUUUUUUUUUUUUUBUUUBBUUUUB
UUUUUUUBUBBUUBUUUUUUUBUUUUUBUUUBUUBUUUUUUBUUUUBUBUUUUBUUBUUUUUUUUUUUBUUUUUBUBUUUUBUBUUUUBUBUUBUUUBBUU
UUUBUBBBUUUBBUUBUUBBUUBBBUUUBUBBBBUBUUBBUBUUUUUBBUUUBUUBUUBUUUBBBUUUUUBUUUUUUUBBUUUBBBBUUBUUBUUUBUUUB
UBUUBUUBBUBUUUUBUUUUBUUBUUUUBBBBUUBUBUUUUUUUUUUBUBUUUBUUUUUUBUBBUBBUBBBUUUUUBUUBUUUBUUUUUUUBUUUBUUUUU
UUUUBUBBBUBBUUUUUUBBUUUUUUUUUBBBUUBBUUUBBBBUUUUUUBBUUBUBBUUBUBBUBBUBBUUUUBUUBUUUUBUBUUBUUUUBBUBBUUBUU
UBUUUUUUUUBBUBUUUBUUUUUUUUBUUUBUUUUUBUBBUBUUBBBBUUUUUUUUUUUBUUBUBUUUBUUBUUBUBUUUBUBBUUUUUBUUUUUUUUBUU
UUBBUBUUBBUUUUUUUUUUUUUUUUUUUBUUUUBUUUBUUUUUUUBBUBBUUUUUUUUUUUUUUBUBBBUUUUUBBUUUUBUUUBUUBUBBUUBUUUUUU
UUBUUUUUBUBUUBUBUUUUBUUUBBUBUUUBUUBUBBBUBUBUUUUUUBUUUUBBBUUBUUUBUUUUUUBBUUUUBUUBBUUUUUBUBUUUUUBBBBUUU
BUUUUUBUBUUUBUUBUUUUUBBUUUUUUUUUUUUBUBUBBUBBUUUBUUUUUUUBUUUBUUBUBUBBUUBUUUUBUBUUBUUUBUUUBUUUUBBBUUUUU
BUUUUBUUUUUUUBUUUUUUUUBBBBUUUUUUUUUBUUUBUUUBBUBUBUUBUUUUUUUUUUBBUBBUUBBBUUUUBUUUBBUUBUUBBUUBUUBUUUUBB
UUUUUUUBUBBUUUUUUUBUUBBUBBUUUUBUUUUUBUUUUUUBUUBUUUUUUBBBUBUUUUBUUBUUUUUUUUUUUUUUUUBBUUUBUUUUBUBBUBUUB
BBBUUUUUUBUUUBUUUBUUUUUUBUUUUUUBBUUUBBBUUBBUBUBUUBUUUUUBUUUUBBUUBBUBBUUBUUUUUUUBBUUUBUBUBBBBUBUBUUUUU
BUBUUUUUUUBUUUUBBUUUBUUBUUUUUUBBBBUUUBUBBBUUUUUUUBBBBUUUUBUUUUUBBUUUUUUUUUUUUUUUUBBBUBUUUBUUUUUUUUUUU
UUUBUUUUBUUUBUUUUUUUUUBBUUUBBUUBUUUUUBUUUBUUUUBUBBUBBUUUUBUUUBBUUBUUBUBBUUBUUUBUUUUBUUUUUUUUUUBUBUUBB
UBBUBUUUUUBUBUUBBUBUUUBBUUUUUUUUUBUUUBBUUUUUBUBUUUBUUUBUUUUUUUUUUUBUUUUUUBUUBBUUUBUUUUUUUUBBUBBUUUBUU
UBBBUUBUUBBUBUBBUUUBUUUUBUBUUUBBUUBUUUUBUUBUUUUUUUUBUBBBBBUUBUUUUBUUUUUUUBBUUUBUUUBBUUBUBUUBUUBUUBUUU
BUUUUBUBUUUBBBUUUUUBUUUUUUUUUUBUUBUBBUUUBBBUBUUUUBBUUUBBBUBUUUBUUUUUUBUUUUUUUBUBUUUUUUUUUBUBUUUUUUBUB
UUUBUUUUBBBUBUUBBUUUUUUUUBUUUUUUUUUBUUUUBUUBUBUBUUUBUBUUUUBUBBUBUUBUBUUBUUBBUBBBBUUUUUUBUBUBBUBBBBUUB
UUUUUUBBBUUBUUUBUUUBUUBBUUUUUBUBUUBUUUUUUBUUUUUUUBBUBUBUUUBBUUUUUUUBUUUUBUBUBBUBUUBUBUUBUUUUUUUBUUUUU
BUBUUBUUUBBUBBBUBBUUBBUUUUUBUUUUUUUBBUBBUUUBUBUUUUBBBBUBUUBUUUBBBBBUBUUUUUUUUUUBUUUUUBUBUUUBUBBBBUUUB
UBUUUUBUBUUBUUUBUUUUBBUUBUUBUUUUBUBUBBUUUBUUBBUUUUUUBBUBUBUUUUUBBUUUUUUBUBUBBUUBUUBUUUUUUUBUUUUUBUUBB
UUBUBUUBBUUBBUBUUBBUUBUBUUBUUUBUBUBUUBUUBUUUBBUBUUUBUBUBUUUUUUUBUUUUUUUUUUUUUUBUUUUBUBUBUUBUUUUUUUUBB
UUUUUUUUBUUBUUUUUUUUBUUUBUBBUBUUUUBBUUUUUUUUUUUUUUUUUUUUBBUBUUUUUUUUUUBBBBUBUBBUBUBUUUUBUUBUBUUBBUUUU
UUUUUBUUUUUBUBBBUUUUUBBBBUUUUBBBUUUUUBUUUBBUUUBUUUUBBUUUUUUUUUBUBUBUBUBBBUUBUUUUBBUBUUUUUUUUBUBUBBUUB
BUBBUUBUUUUUUBUUUBUUBUUUUUUBBUBUUBUBUUUUBUUBUUBBUUBUUUBBUUUUUUBUUUUBUUUUBBBBUUBUBUBUUUBBBUUUUUUUBUUBU
UUUUUBUUUUUUUUUUUUUBUUUBUUUBUBUUUUBBBUBBBBUUUUUBBUUUUUUUBBBUUUBUUBBUUUUBUBBBBBUBUUBBUUUUUUUUBUUUUUUBU
UUUUUUBUUBUUUUUUBUUUUUUUUUUBUUBUUBBBBUUBBBUBUUUUBBBUUBUBUBUBBUBUUUBBBBBBUBBUBUUBUUBUBBUUUUUBUUUUUUBBU
UUBUUUBBUBUUUUUUBUUUUUUBUUUUUUUUUBBUBBUBUUBBBUBUBUBBUUUUBUBUUUBUUBUUBBUBUUUUBUUUUUUUUUBUUBUUUUUBUBUUB
UUBUBUUUUBUUBUUUUUUBUUBUUBBUUUUUBUUUUBUBBUUUUUUUUUUUBBUBBUUUUUBUUUUUUUBUBUBBBUBUUBBUUUUUBBUUUUUBBBUUU
BBUUUUUBUBUUUUUUUUUUBBUUUUUUUBBBUUBUUBUUUBUUBBBBUUUBUUUBUUUUUUBUUUUUBUUBBUBUBBBUUBBUUUUUUUUUUUUUBUUUU
UBBBUUBUBBUUUUUUBBUUUUUUBUUUUUUBUUUUBBUUUBUBUUUUUUBUUUUUUUUUUUUUBUUUBUBUUUUBUUUUBBBBBBBBUUUBUUUUBUUBU
BBUBBUUUUUUUBUUUUUBUUUBBUUBUUBUBUUUUBBUUUUBBUBUUUUBUUBBUUUUBUBUBUUBBUBUUUBBBBUUUBBUUUUUUUBUBUUBUUUUUU
UBBBBUUBUUBBBBBUBUUBBBUUBBUUBUUUUBUUUUUUUUUUUBUUUBUUUBUUUBUUBUUUUUUUBBUBUUUUBUBUUBUUUUUUBUUUUUBUBUUBU
BBUUUUUUBBBUUUUBUUUUUUUBBUUUUBBBBUUUUUUUBUUUBUUBBBUUUUUUBUUUUUUUUUUUUUUBUUUUUBUBUUUUUUUUUUUUUUUBUBUUU
UUUUUUUUUUUBUUUUUBBUUUUUBBUUUUUBBUUBUUUBBBUUUUUBUUBUUUBUBUUUUUUUUUUBBUUUUUBUUUUBUUUUUUUUUUUBBBUBUUUUU
