UUUUBUUUUUBUUBUBBUUBBUUUUUUUUUUUUUUUUUBBUUUUUUBBBBBUUUUUUUUUUUUUBUUUUBUUUUUBUBBUUBBBBUBUBUUUUUUBUBUUU
BUUUUUBUUBBUUBUBBUBUBBUUUUUBBBBUUUUUBBBUUUUUBUUBUUUBUUUUBBUUUUUUUUUBUUUUUUUBUUUUUBUUUBUUBBBBBUUUUUUUU
UUUUUUUUUUUUBUUUUBUUBUUUUBUBUBUUUBUUUUUUUBBUUUUUUBUUBUUUUUUBUUUBUUUUUUUBUUUUUBBBUUUUBUBUUBUUBUBUUUUBB
UUBUUBUUBBUBUUUUUUUUUUUBUUUUUUUUBUUUUUUUUUUBUUUUBUUUUUUUUBBBUBBUUBUUBUUUBUBBBBUUUBBUUBBUUUUUUUUBUUUBB
BUBBUBUUUUBUUUBBBUUUUUUUUUUUUUUUUUUBUBUBUUUUUUUUUBUUUUUUUUBUBBUUBUUUUBBUBUUUUBUBUBUUUUBBUUBUBUUUBUBUU
UUUBUUUUBUBUUUUUUUBBBUBUUBUBUBUUUUUUUBUUUUBBBUUBUUUUUBUUUBBUUUUUUUBUUBBUUBUBUUUUUUBUUBUUUBBBUBBBUUBUU
UUUBUUUUUUUBUBBBUUBUUUUBUUUUUBUUUUUBUUUBUUUUBUUBUBBUUUUBUUUUUBUUBUBUBUUUBUUBBBUBBUBBUUUUBBBUUUBUUBBBU
UBBUUUUBUUBUUBBUUUUBUUUUUUUBBUUBBBUUUUUUUUBBUUUUBUBUBBBBUUBUUUUBUUUBUUUUUUBUUUBBBBBUUBUUUUBUUUUBBUBUU
UUUUUUUBBUUBBUUUBBUUUUBBUBUUBBBBBUUBUUBUUUUUUUUUUUBBBUBBUUBUUBUUUUUUBUUUUUBUBBUBBUUUUBUUUBUUUUBUBUUBB
UUBBUBUUUBUBBUUUUUBUUUBUUUUBUUBUUUUUUUBUUBUUBUBBBUBBUUUUUUBBUUUBBBBUUBUUBUUUBUUUUUBBUUBBUUBUUUBBBBUUU
BUUUUUBBUUBUUBUUUUUBUUUUBUBUBUBBBUUUBUBUUUUBUUBUUUUUUUUUUUBUUUUUBUUUUBUUBUUUUUUBUUUUBUBUUUUUUUBUUUUBB
UUBUUUBUUUBBUUUUUBUUUUUUUUUUUBUUBBUBUUUBUUUUUBUUUUUUUUUUUUUBUBUUUUBUUUBUUUUUUBUUBUUUUUUUUUUUUUBUUBUUU
UBUUUUUUBUUUUUUUUBUUUUUUUUUUUUUUUUUUUUUUUUUUUUUUUUUUUUUUUUUBUBBUUUUUBBUBUUUUUUUUBUBUUUUUUUUUBBUUUUBUU
UUUBUUUUUUUUUUUBBUUUUBBBUUBUBUUUBUUUUBUBBBUUBBUUBBBUUUUUUUBUBBUUBUUUBUBUUBUUUUUBBUUUBUBUBBUUUBUUUUBUU
UUUBBBUUBBUBBUBBBBUUBUBBUUUUUUUUUUUUUUUUUBUBUUUBUUUUUBUUUUUUBBUUBUUBUUUBBBUUUBUUBUUUBBUUUBUUUUUUUUBUU
UUBUBUUUUUUUUBUUBBUUUUUBUUUBUUUBBUBBUUUBUUUUUBUBUUUUUUUBUUUBBUBUUBUUBBUBBUUBUUBUUBUUUUBUUUUBUUUBBBUBU
BBBBUBBUUBUUBUBUUBUUBUUUUUBUBUBUBBUUBUUUUUBBBUBUUUBUUUUUUUBBBBUUUUUUUUUUBBBUBUBUUBBBUUUUUUUBBUUUUBUBU
BBUUUUUUUUUUUUUBUUUUUUUUUBBUBBUUUBUUBUBUUUUUUUUBBBUBUBBUUBUUUUUUUUUBBUUUUUUUBBUUUUBBUBUUUBUUUUUUUUBUU
UUUUUUUUUUBUUUUUUUBUUUUUUBBUUUUUUUBUBUUBUBUUUUUUBUBUUUUBUBUBUUUBUUUUUUUUUBUUBUUUUUUUUBUBUUUUBBUBUUBUU
UBUUBUUUUBUBBUUUBBUUUUUUUUUUUBBUUBUUUUBUUBUUUUUBUBUUBUUUBUUBBUUUUUBUBUBBUUBUUBUUUUUBBUUUUUUUUUBUBUBUU
UUUUUUUUUBUBUUUBUBBUBUBBUBUBUUUUUUUUUUUUUUBUBBUUUUUUUUUBBBUBBBBUBUBUUUBUBUUUBBUBUBUUBBBUBBUUUUUBBUUUU
BUBUBUUUBUUBBUUBUUUUUBUUBBUUUBUUUUUUUBBUBUUUUBBBUBUUUBUBUUUUUBBUUUBUUUUUBUUBUUUBUUUUUUBUBUUUUUUUUUBUU
UUUBUUUUUUUBBUUUBUUBUUBUUUUUUUUBBBUBUUUUUUUUUBUBUUUBBUUBUBUUUBBBUBUUUUBUBUBUUUUBUBUUUBBUUUBUUUUUUUUBU
BUBUBUUUBBUUUUUUUUUUBUBBBUUUUUUUUUUBUBUUBBUUUBUBUBUUUUUBBBUUBBUBUUBBUBUBBUBUBBUBUUUUBBUBUBUBUUUUUBUUU
UUUUBUUUUUUUBBUBUUUBUUUUUUUUBBBUUUBUUBUUBBUBUBUUBUBBBUUUBUUUBBUUBUBUUUUUBBUUBUUUUUUBUUBUBUUBUUBUBUBUU
UUBBUUUBUUUBUUUUUBUBUUBUBBUBUBUBUUBUUUUUUUBBUUUUUUUUUBUBUBUUUUBUUUUUBUUUUBUBUUBUUUBBBBUBUUUUUUBBUUBUU
UBUUUUUUBBBUBBUBUBUUUUUUUUUUUUBUUUUUBBUBBUUUUUUUUUUUUUUUUUUBBUBUUBUUUUUBUUUUBBBUUUBUUUUUUUUUUUUUUUUUU
UUBUUUUBUUUUUBBUBBUUUUBUUBUUUUBUUBUUUUUUUUUUUUUBUUUBUBUBUUUUUUUBUBUUBUBUUUUUBBBUUUUUUUBUUUUUUBBUUUUBB
UBBUUBUUUUBUUUUBUUBUBUUUUUUBBBUUUBUUUUBUUBUUUUBBUUBBUUBBUUUBUUUBUUUBBUBUUUUUBBBUUUUBUBUBUBUBUBUUUUUBU
UUUUUUUUBUUBUBUBUBUUUUUUUUUUBUUBUBUUUUBBUUUBUBUUUBBBUBUUBBUUUUUBUUBUUUUUUUUUUBBUBUUBBUUUUBUUBUUUUUBUU
UBUUUUUUUBBUBBUUBUUUBUUUBUBUBUUUUBBUUBUBBUUUUUUBUUBUUUBUUUUBBUUUBUUUUBUBBBBBUUUUUUBUUUUBUBUUUBUUUUUUU
UUUUUUUUBUBUBUBUBUBUUUUUUUBUUUUUUUUBUBUUUUBUUUUUUUUUBBUBUUUBUBUBUUBUBBUUUUBUUUUUUUUUUUUUUBUUUBUUUBUUU
UUUUUUUUBBUBUBUBUUUUBUBUUBUUUUBUUUBUUUBUUUUBUBUUBUUUUBUUUUUUUUUUUBUUBUBUUBBBUBBUUBBBBBUUUBUUUUUUUBUUU
UBBUBUUBUBBBUBUUUBUBUUBUUUUUUBUUUUUBBBUBUUUUUUUUUUUUBBBBUBUBUBUUBUUUUBBBUUBUUUBBBBBUUBUUUUUUUUUBBBBUB
UUUUUUUBBUUUUBUUBUUUBUBUUUUUUUUUUUUUUUBBUBBUUUUUUUUUUUBUUUBUBUUBBUBUUBUUUUUBUBBUUUUBUBBUUUBUUUBBUUUUU
UUUUUUBBUUBUUUUUUUUBUUUUUBUUUUUUUUBUUUUBUBUUBUUUBBUUBUUUUUUUUUUBBUBBUBUUBUUBBBBBUBBBUUUUBBUUBBUUUUUUU
BUBUUUUBBUUUUUBUUBUUUUBBUUBUUUUUUUUUUUUBBUUUUBBUBUUUUUBBUUBBUUUUBBUBUBUUBUUBUUUBBUUUUUUBBBUUUUUBUBBUB
UUUUUUUUBUBUUUUBUUUBUUUBUUUBUBBUUUBUBBBUUUBUUUUUUUUBUBBBBUUUUUUUUUUUBUBUBUUUUUUUUUUUBUUBUBUUUBUUUUUUU
UBUBBUUUUBBUUUUUUUBUUUBBBUUBBUUUUBUUBUUBUUUBUUUUUUUBUUBBUBBUBUUUUUUBUUUUUUBUBUUUBUUUUUUUBBUUUUBUUUBUU
UUUBUBUBBUBUBUUUUUUUBBUBUUBBUUUUBBUUUUUBUUUUUUBUUBUUUUUUUUUUUUUUUUUBUUBUBBUBUBUUUBBUUBBUUUUBUUUUBUUBU
UUBUBBBUBUUBUUUUUBUUUBBUBUUUUUUUUUUUUBUUUUUUBUUUUUUBBBUUUBUUUBUUUUBBUUUBBBUUUUUBUUUUUUUUUUUBUUUUUUUUU
BUUUUUUUUUBUUUUUUBUBBUUBUUUBBUBUBUUUUUUUUUUUUUBUUUBUUUUBUBUUUBBUUUBBBUUBUUUBUUBUBUBBBBUBUUBUUUUUBUUBB
UUUBUUUBUBBBUUBBUUUUUBUUUUBUBBUUUUUUBUBBBBUUBUUBUUUUUUUUUUUUUUUBUUBUUUUUUUUUBUUUBUUUUUUUUUUUUUUUUUBBU
UUUBBUBUUUUBBUUBUUBUBBUUBBUUUBBUUUBUUBUUBUUUUUBUUUBUUBUUUUUBBBUUUUBUBUBUUBBUUBUBBUUUUBUBUBUUUBUUUUUBU
UUUBUUBBUUUBUUBUBUBBBUBUBUUUUUBUUUUUUUUUUBUUUUUUUBUUUUUBBBBBUUUUBUUUUUBUBUUUUUUUUUUUUUUUBUUUBUBUUUUUU
UBBBUUUUUBUBUUBUUUBUUBUUUUUBUUUUBBUUBUUBUUUUUUUUBBUBUUBBUUUUUUUUUUUUBUBUUUBUUUBUBUUUUUBUUBUBUBUBUUUBU
UBUBBUBUUUUUBUBUUUUUBBUBUUUUUUUUBUUBBUBUUUUUUBUUBUUUUUUUUBUBUBUUUBUBUUUUUUUBUUBUUBUUUUBUUUBBUUUUBUUBU
UBUUBBUBUBUUUUBUUBUUUUUBUUBUUBUUBUBBUUBUBBUUUBUBUUUBUUUUBBUUUBBUUUUUBUBUUBBUUUBBUBUUBBBUUUBUUBUUUUUUU
BBUUUUUUUUBUBUBUBBBBUBUBUUBBUUUUUUUUUBBUUUUUUUBUBUUUUBBUUBBUUUUUUUUUUUBBUUUUUUUUBBUUBUBUBBUBUUBUBUBBU
UUUUBUBUUUUUBBUBBUUUBUUUUUUBUUBBUUUUUBUUUBUUUBUBUBUBUUBUBUUUBUBUUUUUUUUUUUBUBUUBUUUUUBUUBUUBUUBUUUUUU
UUUBUUBBUBBUUBBUUUUUUUUUBBUUUBUUUBBUUBUUBBBUUUBUUUUBBUUUUUUUBUUUUBUUUUUBBUUUUBBUBBUUUBUUUUUUUUUUUUUUU
UUBUUUUUBBUBBUUUUBUBUBBUUBUBBUUBUUBBUUUUBBBUUUBBUUUBBUUUUUUUUBUBUUUUUUUUUUUBUUUUUUUBUBUUUBBUUUUUUBUUB
UUUUBUBUUUUUUUUUUBUUUUBBBUUUUBUUUUUUBBUBUBUUUBUUUBBUBUUUUBUBUBUBUUBUBBBBUUUUUUBUUUUUUUUUUBUBUBUBUUUUU
BUUUBUBUBUUUBUUUUUBUUBBUUUUUUBUUUUUBUUBUBUUUUUUUUBUBUUUUBBBBUUUUUUUBUUUUBUBBBBBBUUUBUUUUUUBUUUUUBUUUU
BUBUUBUUUBUBUBUUBUUUUUUBUUUUUUUBBUUUUBUUUUUUUBUUUUUUBUUBBBBBUBUBUUUBUBUUUUUUUBUBUUBUUUUUUBUUUUBUUUUBU
BUUBBUUUUUUBUUUBBBBUUUBUBBUUBUUUUBBBBUUBUUUUUUUUUUUUBBBUUBUUUUBUUUUBBBUUUUUUUUUBUBUUBBBUUBBUBBBBUUUUU
UBUUBUUUBBUUUUUUBUBUUUBBBUBUBUUUUUUUBUUUUBBUUUUUUUUUBUUUUUUUUUUUBBBUBUUUUBUBUUUUBUUBUBBUUUUUBUBBUUUBU
BUBBUBUUUBBUUUBUBUUBBBBBUUUBUUBUUUUUUBUBUUUBUBUUUUUBBUBBUBUUUBUBUUBUUUBUUUUBUUUUBBBBUUBUUBBUBUUUUBUUU
UUBUUUBBUUUUBUBUUUUUUBBBUUBBUUUBBUBBBUBUUBUBUUUUUUUUUUUBUUBUUUUBUUBBUBBUBBUBUBBUBUUUUBBUUUUUBUBBUBUUB
UUBUUUUBBUUUUUBUBUUUUUBUBUUUBUUUBBBUUUUUUUBBUUUUUBBUUUBUBBUBUUUUUBUUBUUUUUUBBUBUUUUUBUBUUBUUUUBBUUUUU
UBUBUUUUBUUUUUBUUUUUBUUBUBBUBBBBUBBUBUUUBBUUUUUBUUBUBUUUUUUUUUUBUUUUBUUUUBUUUUBUBUUUBUUUUUUBUUUUUUBUU
UBBBBUBUUUUUUUUUUUUBBUUUUUUBUBUUUUBUUBUBBUUUUUUUUUUUUUUBUUUBUBBBUBBBBUBUUUUUUUUBUUUUBUUUUUUUUUUUUBUBU
UBBUUUUBUUUBUBUUBUUUUUBBUBUBUUUBUBUUBUUUBBUBBBUUBUBBUUUUUBUUBUUBBUUBUUUBBUUUBBUUUBBUUBUBBBBUUUUUUUUUU
UUBBUUBBUBUUUUUUUUUUUUUBUBUUUUUUUUBBBUUUBUBBUUBBUBUUUUUUUUBUUBUBBUUUUUUUUUUUBUUUUUBUUUUBUBBUBUUUUBUUB
BBUUBUUBBUUUUBUUUBUUUUUUUBUUUBUUUUBUUUUUUUUBBUBUUBUUBUBBBUUUUBUUUUBUUUBBBBUBBUUUBUUBUUUUBBUUUUUUBUBUU
UUUBUBBBUUBUBBUBUUUUUBUBUUUUUUUBUUBUUBUUBUUUUUUBBUUBBUUUUBBBUBUUBUBUBBUUUUUBUBUUBBUUUUUBUUBBUBUUUBUUU
UUUUBBUUUBUBUBUUUUUUUUUUUBBUBUUUUUBUBUUUBBUBUUUUUUUUUBUUUUBUBUBBUUBUUBUUUUUUBUUUUBBUUUUBUBBBUUBBBUUBU
UBBUUUUUUUUUBBUUBUUUBBBBBUUUUUBUUBUBBUBBUBUUUUUUBUBUBUUBUBUBUBBBBBUUBUUBUBBUUUBUUUBUUUUUBBUBBBUUUBBUB
UUBUUUUBUUBUUUUUUUUUBUUBBUUBUUBUBUUUUUUBBUUUUUBUUUUUUUUUUUUUUUBUUUBBUBUUBUBUUUUBBBUUUBUUUUUUUUUBBUUUU
BUUUBUUUUBBUBUUUBUUBUBUBBBUUUUUUUBUUUBUBUUBUUBUBUUBBUUUBUUUUUUUUUUUUUUUUUUBUBBBBUBUUUBUUUBUUUUBUBUUUU
UBUBUBBBUBUUUUUUUUUUBUUBUUUBBUUUUBUUBUUBBUUBUUUUUBUUUUBUBUUBUUUUBBUBUUUBUUUUUUUUBUUBUBUBUUUBUUUUUBBUU
BUUUBUUBUUUBBUBUBUUUBUBUUUBUBUBUUUUUUUUUBBUUUUBBUUUUUBBUUUUUUUUUUBBBUUUUUUUUBUUUUBUUBUUUUUBBUUUUBUUUU
UUUUUUUBBUUUUBUUBUUUBUUBUUUBUUUBUBUUUUUUUBUUUUUBBBUBUUUUBBUBBUUBUUUUUUUBUUUUBBBUBUBUUUUUUUUBUUBBBUUUU
BBUUUUUBUUBUUUBUBUUUUUUUUBUBUUUUBUUBBUUUUUUBUUUUBUUUBUUUBUBBUUUUUUUUBUUBUUUUBBUUUUBUUUUUUUUUUBBUUUUBU
UUUUUUBBUUUUBUBUUBUUBBBUBUBBBBBBUUBUUBUBBBUUBUUUUBUUUUUUUUUUBUUBUBUUBUBUUUUUBUUUUBUUBUUUUUUUUBUUBUUUU
UUUUUUUBUUBUBUBUUUBBUUUUBUBUUUUUBBUBUUBBUUBUUBUBUUUUUBUUUUUUUUBBUUUUUUUUBUBUUUUBUUBUBUBUUBUBBBBBBUUUU
UUUUUUBUBUUBBUUBUBBUUBUUUUUUBUUUUUUUUUBUUBUUUUUUUUUBBUUUUUBUUUUBUUUUUBBBUUUBBUBUBUBBUUUUUUBBUUUUUUUUB
UUUUUUBUUBBUUBUUUUUUUBBBUUUUUBUUUBBBUUUUUBUUBUUBBUUUUUUUUUBUBUUUUUUUUUUBUBUUUUBUBBBUUBUUUBBBUUUUUBUUB
UUUBUBUBUBBBUBBUBUUUUUUUBUUUUUUUBUBUBUUBUUBBBBUUUUBUUUUUBBBBUUBUUBUUUUUBBBBUBUUBUUUUUUUUUUBUBBUBUUBUB
UUUBUBBBUUBUBUBUUUUBUUUUUBUUUUUBBBUUBUUBUUUUUUBUUUUUUUUUUUUUUUUUUBUBBUUUUUBBUBUUUUUBUUBBUUBUBUUBUBUUU
UBUUBUUBUUUUUUBUUBUUUUUBBBUUUBBBBUUUUUBUUUBUUBUUUBBBUBUBBUUUBUUBUUUBUUBBUUUUBBUUUBBUUBUUUBUUUUUUUUUUB
UUUBBBUUUUBUUUUBBBUBUUUUUUUUUUBUBBBBUBBUUBUUUUBUUBBUBBUBBUUUBBUUUBUUBUUUUUBUUBUUBBUUUUUUBUBUBUUBBUUBB
UBBUUUBUBUBUBUUBUUBUUUUUBUBBBUUUUUUUUUUBUUBUUUUUUUBUBUBBBUUUUUUUUUUUUUBUBBUUUUUBUUUBUUUUUUUUUUUUBBUUB
BUUUUUUUUBBUUUUBUUUUUUBBBUUUUBUUUUBUUUUUUUUBUUUBUUUUBUUUUBUBUBBBUBUUBUBUBUUUUUUUBUBUUUBUUUUUBBUBUUUUU
UUUUUUUUUBBUUUUBUUBBUUBUUUBUBBUUUBUUUUUUUBBUUBUUUUBUBUBUUUUUUUUUUUUBUUUUUBUBUUUUBUUUUUUBBUUUUBUUUUUUU
BUUUBUUUUBUBBUUBBBBUUUBUUUUBUUBUUBBUUBUUBUUUUUUBBBUUBUBUUUUUUBBBBUUUUBUUUUUUUUBBUUUUUUUUBUUUUUUUUBUUB
UUUBUBUUBUBBUUUUBUUBBUUBBUUUUUUBUUUUUUBUBUUUUBUUBUUBUBUUUUUBUUUUUUBUUUUUUUUUUUUUUUUUUUBUBUUUUBUBBUUBU
UBUBUBUUBUUBBBUUUBUUBUUUUUUBUUBBUUUUUUUUBBUUUUUUUUUUUBBUUUUUUBUUUBUUUUUUUUBBBBBBUUUUUUUUUUUUUBUUUBUUB
UBUUUUUUUUUUBUUBUUUUUUUUUUBBUUBUUBUUUUUUBUUBBUUUBBBUUBUUBUUUUUUUUUUUBUUUUBUUUBUUUBUUUUUBUUUUBUBUBUUBU
UUUBUUBUUBUBUUUUBBUUBUUUUUUUBBBBUBUBUUUUUBUUBBBBBUUBBUUBUBUBBUUBBUUBUUBUUBUUBBUUUBUBUUUBBUUBBBUUBUUUB
UUBBBUUUUUUUBUUUUUBUUBUUUUBUUUBBUBUUBUUUBUUUUUUUBBUUUUUBUUUUUUUUUUBUUUUBUUBUUBUUBUUUUUUUUUUUBUBUBUUUB
UBBUBUUBUUUUUBUUBBBUBBUUBUUUUUUUBUBBBUUUBBUUUUUBUUBUBUBUUUBBUBUUUUUUBUUUUUBUBBBUBBBBUUBUBUUUUUUUBBBUU
UBBUBUBUUUUBBUUUBBUUUUUUUBUUBBUUBBBUUUUUUUUUBUUUUUUBUUBUBUBUUBUBUUBBUBBUUUUBUUUUUUUUUUUBUBUUUBUUUUUUU
UUUBUUUUUUBBUUUUBBUUUUUUUUBBUUUUUUUUBBUUUUUBBBUUUBUBUUBUBUUUUUUUUUUBBBBUUBUUUBBUUBBUBUBUUUUBBUUUUUUUU
UUUBBUUBUUUBUUBUBBUUBUUUBBUBBUUUUBUBUUUBBUBUUUUUBUUUBUBUBUBUUBBUBUUBUBUBUUBUBUUUBUBBBUUBUUBUBUUUUUUBU
BUBUUBBUUUUUUBBUUBUUUUBUUUUBUUBBUUBUUBUUUUBUUBBBBUUBUBUBUUBUBUUUUBBUUBUBUBUUUUUUUUUUUUUUUUUBUUUUBBUUU
UBUBBUUBUBUUUUUUBUBUUBUUUBUBBUBBUUUUUUBUUUUUUUUUUUUUUBBBUUBBUBUBUBUUUUUBUUUUBBBUUUUBUUUUUUUUBUBUUUBBU
BUUUUUUUBUUUUUUUUBUUUUBUUUBUUUUUUBUBUUUBUBBBBUUUUBUUBUBBUUUUUBBUUUBBUUUUUBBUUUUUUBUBUUUBUUBUUUUUUBUUU
UUUBUBBUBUUUUUBUUUUUBUUUUBBUBBUUUUUUUUUUUUBBUUUUUUBUUBUUUBUUUUUUBUUBBUUUBBUUUUBBBUUUBUUBUBUUUUBUUUUBU
BUBBBUUBUUUUUUUUUUBBBUUUBUBBUBUUBUBUUUBUBUUUBUBUUUUUUUBUBBUUBUUUUUUUUUBUUBBUUBUBBUUUBUBUUUUUUUUBBBUUU
UBUBBUBBUUUBBBBBUUUUUBBUUBUUUUUUUUBUUUUBBBUUUUUUUUUBUUUBUUUBUUBUUUUBUUUBBBUUBUUUUUUUUUBBUUBUUBBUUUUUU
