UUUUBBUUUUUUUUUUUBUUUBUBBBBBBUUUBBBBUUBUUUUBBUBBUUUBBUUUUBUBUUBUBUUBUBUBUUUUUUBUUBBBUBBUUUUUUBBBUUUUU
UUUUUUUBUBUUUUUUUBBUBBBUUUUUUUUUBUUUUUUUUBBUUUUUUUUUUUUBBUBUBUUBUBUUBUBBUUUBUUBUUUUBUUUUBUBUUUBBUUUUU
BUBUUUUUBUUUBUUUUUBBUUUBBBUUUUUUUUUUUUBUUUUUUBUBUUBBUUUUBUUUUUBUBUBUBUUBBUBBBUBUUBUUUUBUBBUUUUUUUUUUU
BUBBUUUUBBBUUBUUBUUBUBUBBBBUUUUUUBBUBUUBBBUUBUUUUUUUUUUUUBUBBUUUBUUUUBUBUBUBUUUUUUUUUUBUUUUUUUUBUUUUU
UUUBUUUUUUUUUBUBUUBUUUUUUUBUUUUBBUBUUBUUBUUUUUUUUUUBUUUBBUUBUBUBUBUUBBBUUUUBBBUUBUUUUUUUUUUUUUUBUBUUB
UUUBBBUUBUBBUUBBUBBBUBUBUUBUUBBUUUBUBUUBUUUUUUBUUUUUUUUBUBUUUUUUUUBUUUBUUBUUUUBUUUUUBUBUBUBUUUUUUUBUB
UUUUUBUUUBUBUBUUUUUUUUBUUUUUUUBUBUUUBUUBUUUBUUUBBBUUUUUUUBUBUUUUUUUBUBUUUUBUUUUUUUBUUUBUUBUUBBUBUUBUU
UUUBUBUUBUUBBUUBUBUUBUBUUBUUBUUUUUUUBUUBUUUUUUUUUUUUBUBUUUUUUUUUUUBUUUBUUBBBUUBUUUUBBUBUUUBUUBBBUBUUU
UBUUUUUUUUUUUUUUUUBUUUBBBBUUUUUBUUUBUBUBUBBBUBBUBUUBUUUUUUUBUUBBUUUUUBUUUBUUBUUUUUUUBUUUUBBUBUUUUBUUU
UUUUUUBBUUUUUUUBUUUUUUUBUUUUUUBUUUUUBUBUUUUUUUBBUUBBUUUUBUUUUBUUUUUUUUBUUUBBUUUUUUUUBUUUUBBUUUUBUUUUU
UBUBBUUUUUBUUUUBUUUBUUUUUUUUBUUUUUBBUBUUUUBBUUUUUUUUBUUUBBBBUBUUUBBUUBBUUUUUUUUUUUUUUUUUUBUUUBBBUBUBU
UUUUUUUUUUUUUUUUUBUBBUBUBUUBUUUUBUBUBUBUUBBBBUUUUUBUUUUUBUUUUUUUBUUUUUBUUBUUUBUUUUUBUUUUBUBUBUUBUUUUU
UUUBUUUUBBUUBUUUUUUUUUUUBUBUUUBUUUUUUUUUBBUUUBUUUUBUBUUUUUUUUBUUUUBUUUBUUUUUUUUUUUUUUBBUUUUUUUUUBBBUU
UUUBBUUUUBUUBUBUBBBUUBBUUUUUUUUBUUUUUUBUBUBUUUUUUBBUBBBUUUUUUBUUUUUUUUUBBUUBUBUUBUUBUUUUUUUUUUBBUUUUU
UBUUBUBUUBUUBBUUBUBBUUUUUUUBUUUUUUBBUUBUUUUUUUUBBBUBUUBUUUUUBBUUBBBUBUBUUBUUUUUUUUUUBUBUBUUUUUUUUBBUB
UUUUBUBBUBBUUUBUBUUBUUUBUUUUUBBBUUBUBUBBUUBUUBUUBBUBUBUUUUUBUBUBUUUUUBUUUUBUBUUBBUUUUUBUUUBUUUUBUBUUB
BBUBBUBBUBUUUUUUBUUUBUUBBUBUUBBUUUUUUUBUUUBBBUUUUUUBUUUUBBUUUBUUUBUBBUUUUUUBUUUUBUUUUBUBUUBUBUUUUUBUB
BBBUUUUUUBBUUUUBBUUUBUUUUBUUBUBUBUBUBUBUBBUUUUBUUUUUUUBBUUUUBBBUUUUUUUUUUUBUUBBUBUUBUUUUUBUUUUBBBUBUB
BUUUBUUUUUBBUUUUUUBUUUBUUBUBUBBBUUUBUUUUBUBUUBUBBBUBUUBUBUUUBBUUUUUUUUUUBBUBUUBUBUUUUUUUBUUUUBUUUUUUU
UUUUBUBUUUBUUUUUUUBUBUUUBBUBUUUUUUUBUUBBBUBBUUUUBUBUUUBUBBUBUUUBUUUUUBBUUUUUBUUUUUUBUUUUBUUBBUUUUBUBU
BUBBUBUBUBUUUUUUUBBUUUUBUBUUUBBUUBUUBUBUBUUBBBUBUBUUUBUBUUUBUUBUUBBUBUBUUUUUUUBBUBBUUBUUBUUUUUUUUUBUU
UUUUBUUBUUBUUUUBUBUUUUBUUBUUUUBUBUUBUUUUUUUBBUUBUBBBUUUUBBBUUUUUUUUUUBBUUUUBUUBBUUBUUBUBBUUUUUUBUBUUU
BUUUUUUBUUBBUUUUUUUUUUUUBUUUUUUUUBUUUUBBUBBUUUUBBBBUUUUUUBBBBUUUBBUBUUUBUUUUUBUUBBUUUUUBUUUUUUBUBUUUB
UUUUUUUBUUUBUUUBUUUUBBUUUUUUUUUBBUUBUBUBBUUUUUUUUUBUUUUUUUUBBUUUUBUUUUUUBUBUBUUUUUUUUBBUUUUUBUUBUUUUU
BUBUUUBUBUUUUUUBUBUUUBUUUUUUUUBUUUUUUBUBUUUUUUUUBUUUUUUBUUUUBUUUUUUUBUBBUUUUUUUUBUBBUUBBUUUUBBUBBUUBU
BUUUUUBBUUUUUBUUUUUUUUBUUBUUUBBUUUUUUUUUUBBUUBUUUUUBBUBUUBUUUUUUBUUUUBBUUUUBUUBUBUUBUUBUUBBUUUBUUUUUU
BBUUUUUUUUUUUUUUBBBUUUUUUBBUUUBUBBUUUBUUUUBUUUUBUBUUBUBUUUUUUBUUUUBBUUBUBUBBBBUUUBBBUUBUUUUBUUUUUBUBU
UBBUBUUUUBBBBUUUUUUUUBUUUBUBUUBUBUBUUBUUUUUUUBBUBUBBUBUUUUBUUUUUUUUUUUBUBBUBUBUUUUUBUUUUUUBUUUBBUBBUB
BBBUUUBBBUUUUUUUBUUUUUUUUBUUUUUBUUUBBUUBUUBUUUUUBUUUBUUUUUBUUBBUUUUUUUBBUBUBBBBBUUBBUUUUBUUBUUUUUUUUU
UBBUUBBBBBUBUUUBUUUBUUUBUUBBUUBBUUUUUUUUUUUBUUUUBUUBUUBBUUUUBUUUUBBUUUBUUUUUUBUUUUUUBBUUUUUUUUUUUUBUU
BUUUUUUUBUUUUUUBUBBBBBUBUUBBBUBUBUUBUUUUUUBUUBBUUUBBUUBUUUBBBBBBUUUUBUUUUUUUBUBBUUBBBUBBUUUUBBUUBUUBB
BBUUBBUUUUUUUBBUUUBBBUUBUUUUUUUBUUBUUUUBBUUUUUBUUUUUUUUUBUUUUBUUUUBUUUUUUUUUUBUBUUBUUUUUUUUBUUBUUBUBU
UUBBBUBUUUUBUBUUUBUUUUUUUUUBBBBUUUUUUUBUBBBBUUUUBUUUUBUUUBUUUUUBUUBBUUUUBBBUUUUBUUBUBUUUUUUBUUBBUBUUB
UBUBUUUUUUBUBUUUUUUUUUUUUBUBUBUUBUBUUUUUUUUUUUUUBUUUBUUUUBUUUBBUUUUUUUUBUUUBUUBUUBBUUUUUUUUUUBBUUUBUU
UUUBBUBUBUBBUUBBBUBBUUBBBUUUUUBUUUUBUUUUUBBUUUUUUUUUUUUUUUUUUUBUUUBUUUBUBUBBBUUUUUUBUUUUUUUBUUBBBUUUU
UUUBBBBUBUUUUBUBBBUUUUUBUBUUUBUUUUUUBUBUUUUUUUUUBUBBUUUUUUUUUUBBUBUBUUUUUUUBBUUUUBUUUUUUUUUBUUUUBUBUU
BUUUBUUBUUUBUUBUUUUUUBBUUUUUUUUUUUUBUUUUUBBUUUUUUUUBUBUUUUUUUUUUUUUUUUUUUUUBUUUUUUUUUUUUUBBBUBBUBBUUU
UUUUBUUUUUUUUBBBBUUUUBBBUUUUUUBUBBBUUUUUUBUBUUBUUUUUBUUBBBUBUBUUBUUUBUUUBUBBBBBBBUBBUUUUBUBUBUBUUUBUU
BBUUBUUUUUBBUUBUBUUUUUUBUUUUUUBBBUBUUUUUUUUUBUUBUUUUBBUBUUUUBUUBUUUUBUBUBUUUUUUUUUBUUBUUUUUBUUUUUUUUB
UUBUUUUUBUBUUBUBBUBUBUUUBUUUBBBBUUUBUUUUUUBUUUBUUUUUBUBUBBUUUBUUUUBBUUUUBUUUUUUUBBBUUBUUBBUUBUBBUBBUU
UUUBUUBUUUUUUUUUUBUUUUUBBUBUUUUUUUBUUUUBBBUBBUBUUBBUUUBBBBBUUUUUUUUBBUUUUUUUUUBUUUUUUUUUBUBUUUBBUUUUU
UBUUUUBUBUUUBUUUUUUUUUBUUUUBUBUUUUUBBUBUUBUUUUUUUBBBUBUUBUUBUUBBUUUUUUUUBBBBBUUBUUUUBUBUUUUUBUBBBUUUB
UUUBUBBUUUUBUUUUUUUBUBBUUUUUUUUBBBUBUBUUBUUUUUBBBUBUBUBUUBUBBUUUUUUUUBUBBUUBUUBUUUUUUUUUUBUUUBUUUBUUU
UBUUBBUBUUBUUUBUUBUUUUBUBUUUUUUUUBUUBBUUUUBBBUUBUUUUUBBBUUUUUUUUUUUBBBUUUUUUBUUBUUBUUUUUUBBUBUUBBUBUU
UUBUUUUBUUBBBBUBUUUBUUBUUUUUUUUUUUBBUUUUUBBBUUBUUUBUUUBUUUBUBUUUUUUUUBUBUUUUUUBUBBUBUUBBBUUUBUUUBBUUU
UUUBBUUBBUBUUUBBBUUBUBBBUUUUUBUUUUUUUBUBBUUBUUUBBUUUUUUUUUUUUBUUUBUBUUUUUUUBBBUUBBBUUBUBUBUUBBUBBBBUU
BUUUUBBUUUUUBUUUBBUUUUBBUUUUUUBBBUUUBUUBBUUUUBUUBUUUUUUUUUUUUBBBBUUUBBUBUUUUUUBUUUUBBBUUUUUUUUUBUBUUB
UBUBBBUBUUBUUUUUUBBBUUUUBUUBUUBUUBUUUUUBUUBUBBBUUUUBUBUBUBUUUUUUUBUBBBUBUUBUUUBUUBUUUUBUUUUUUUUBBUUUU
BUBUUUBBBUUUBUUUUUUUUUUUUBUUBBUBBUUUUBUUBUUUUUUUUBUUUUBBBUBUUUUBUUUBBUUUBBUUBUUBUBUUBUUUUUUUUUUUUUUUU
UBUUBUUUUBBUUBBUBUUBBBUUUBUUUBUUUBUUUUUBUBBUUBUUUUUUBUUUBUUUUUBUBBUBUBUUUUUBUUUBUUUUUUUUBUUUUBUUUUUUU
BBUBUUUBUUUUUUBUUUUUUUUUBUBUUUUUBUUUUUUUUBUUUBUBUUBUUUBUUUUUUUUUUUBUBUUUUUUUBUUUUUBUUUUBUUUUUUUBBUUUU
BBUBUBUUUBBBUUUBUBUUUBUUUUUUUBBUUUUUUUBBBUUUUUUUUBBUBUUBBUBUUBUUBBUBUUBUUUUBUUUUUBUUBUUUBUUUUBUUUUBUU
UUBBUBUUBBUBUUBUUUUBUUUUBUBBUBBUBUUUUBUBUUUBUUUUBUUUUUBUBUUBBUBUUBBUUUUUUUBUUUUUUBUUUBUUBUUUUUUUUUUUB
UUUUUUUUUUUBUBBUBUUUUUBBUUUBBUUBBUBBBUUUUUUUUUUUUBUBUUUBUUBUBUBUUUBUBUUBBUUBBUUUUUUBUBUUUUUUUUBBBUUBU
UBUUUUUUUUBUUUUUUUUUUBUBBUUUUUUBBUUUUUBUBUUBUUUBUUUUUUUUBBUUBUBUUUBUUUUBUBUUUUUBUUBUUUUBUUUUBBBUUBUUB
UUUUUUBUUUBBBBBUBUUUBUBUBBBUBUUBUUUUBBUUUUBUUBBUUBBUUUUUUBUUBBBUBUUUBUUUUUUBUUUUUUBUUUUUBUUUUBBUUUBBU
UUBUUUBUUUUUUUBUUBUUUUUUUBUUUBUUBUUBUUBBUBUBUBBUUUUUUUUBBUUUUBBUBBBBUBUBBUUUUBUUUUUUUUBUBBUBUUUBUBUUU
UBBBUBBBBBBBUUUUUUBUUUUUUUBUBUBUUBBUUUUUUUUUBUUBUUUBUUUUUUUUUUUUUUBUUUUUUBUUBUUUBUBUUUUUBUUUBBUUUUUUU
UUUUUUUUBUBUUBUBBUUUUUBUUBBUUUUUUUUUUUUUUUBBUBUUUUUUUUUBUBUBUUUUBBUUUBUBBUUBUUBBUUBBBBBUUBUBBBUBUBUUB
UUUUUUBUBUUUBUUBBBUUUBUUUUBUUUUUUUUUBUUBUBBUUUBUUUBBUBUUUUBUUUUBBBBBUUUUBUUUUBBUUUUUUBUUBUBUUUUUUBUUB
UUUUUUUBBBBBUUBUUUUUBUBUUUUUBBUUBUUBBUUUUUUBBBUUUUUBUUUUUUUUUBUUUBUBBUBUUBBUUUUUBUBBBBUUUUUUUBBBUUBUU
BUUUUUUUUUUUBUUUUUUBUUBBUUBUUBUBBUBBUUUUUUUUBUUBUBBUBBUBUBUUUUUUBUUUBBUUUBUUUBBUUUBUUUBUUUUUBBUUUUUUU
UUUUUUBUUUBUBUBUUUUBBUUUUUUUBUUUBUBBBUUUBUUUUUUBUUUBUBUUUUUUBUUUUUUUUBUBUBUBUBUUBBBUUUUUBBUBBUBBUUBUU
UBUUUUUBUUUUUUUBUUUUBBUUBUUUBUUUBUBUBBUUUUUUUBBUUUUBUUBUUUUUUBUBUUUBUBUUUUUUBUBBUBUBUUUBBUUUUUUUUBBUU
BUUUUUUUUUUBUUUBUUUBUUUUUUUUBUUBUBBBUUUUUUUUUBUBUUUUUBUBUBUBUUUUUUUUUUUUUBBUUBUBUUUUBUUUBUUUBBUBUBBUB
UUUBUUBBBUBUBUBBUUUBBUUUUUBUBBBUBUBBUUUUUBBUUUUUUUUBUBUUUUUUUUUBUBUUUUUUBUBBUUUUUUUUUBUUUUBUUUUUBUUUU
UUBBUBUBUUUUUUBUUUUBBUBUBUUUUUUUUUBUUUUBUBUUUUUUBUUUUUUUUUUBUUBBBUBBUUUBBBUUUUUBBUUUBBBBUUUBUBUUUBUUU
UUUBBUUBUBBUBBBUBUUUUUUUUUBBUBBUUUUBUUUUUBUUUBUUBBUUUUBUUUUBUUBUUUBUUBUUUUUUUBUUBUBBUUUUBUBUUUBUUUUUU
UBBUUUUBBBBBBUBBBUUUUBBUUUUUUUUUUUUUUBBUUUUUBBUBUUBUBBUUUBBUUBUUUUUUUBBBUUUUUUUUUUUUUBBUUUBUUUUUBBUBU
UUUUUUUBUUUBBBBUUUUUUBUBUUUBBUUUUBUBUUUUUUBUUUUUUUUUBUBUBBBBBBUUBUBBUUUBUUUUUUBUUUUUUBUUBUUBUUUUBUBUU
BBUBUBUUBUBUUBUUUUUBBBBUBUUUUBUUUBUUBUBBBBUUUUUBBBUBUBUUUBUBUUUUBUUUUUUUBUBBUBUUUUUUBBUUBUBBBBUBBUUBB
UUUUUBBUUUBUUBUUUBUUBBUUBUUUUBBBUUUBUUUUUUUUUUBUUBUUBUUBBUBBBUUBBUUUUBUUUBUUBBUUUUUUBUUUUUBUUUUBUBUUU
UUUUBBUUUUUUUBUUUBBUBUBUBBUBUUBUUUUBBBUUUUUBUBUBUUUUUBUUUUUBUBBBUUUUUUUUUUUUBBUUBUBUUUUUBUUUUBBUUUBUU
BUBUUBBUUUUUUUUUUUUUBUBBUUUUUUUBUBUUUUBUUUBUUUBBUBUUUUUUUBUUUUUUUBBBUBUBUUUBUUUBUUBUUBUUUUBBUBBUUBUUU
UBBUUBUUUUBBBUBUUBUBUUBUUUUBBBBUBUBBUUUBBBUUUUBUBUUUUBUUUUUUUUBBUUBBUUBUBUUUUBUUUUUUBUUUUUBBBUUUUUUUU
BUUUUBUUUUUBUUUUUBUUUBUUBUUUUUBUBUUUUUUBUBUUUUUUBUUUUUUUBUUUUUUBUUUUUUUBUUUUUBBUUUBBUUUUBUBBBUBUUUBUU
BUUUUUUUUUUUBBBUBUBUUUUUUUUUBUUUUUBUUUBUUUUUUUBUBUUUUUUUUUBUUBUUUUBUUUUBUBUUUBUBUUUBUBUBBBBUBUBUBUUBB
UUUBUUBUBBUUBBUBUUUUUBUBUUBBUUBUUBUUUUUUBUUUUUUUBUBUUUUUBUUBBUBUUUUUBBUUBUBUUUUBBBUUUBUUUBBUUBBUBUBUU
UUBBUUUUUBUBBUUUUUBUBBUUUBUUUUUUUUUUUUBUBBUUBUUUUUUBUUBUUUUUUBUBUUUUUUUBUUUUBBUUBUUBUBBBUUUUUBBUUUUBU
UUUUUUUUUBUBUBUUUUUUUUUUUUUBUUUUBUUUBUBUUBBUBUUUUBUBUUUUUUBBUUUUBBUUUUUUBBBBUBBUBBUBUBUUUUBBUBBBBUUBU
UBUUUUUUUBUBUUBBBUUBBUUUUBBBUUUUUBUUUUUBUUBUUBBUBUBUUUUUUUUBUUUUUBUBUUUBUUUBBUBBUUUBBBBBUBUUUUUUUUUUB
UUUUBUUUUUUUUUUBUUBUUUUUUUUUUUBUUUBUUBUUUUUUUUBUUBUUBUUUUUUUBUUUUBUUUUUUBUBUBBBBUBUUUUUUUBUUUUUUUBBBU
UUBBUUUBUBUUUBUUBUUUUUUBUBUUUBUUBBUUBUUUBUUBUBBUUUUBBUBBBBUUBUUUUBUUUUBBUUUUUUBBUUUUUUUUUUUUBUBBUUUUU
UBUUUUUBBBUUUBUUUUUUBUUUUUBUUUUUBBUUBUUBUBUUUUUUBBUUBBBUBBBBUUUUUUUUUUUUBUUUUBUUUUUUUBUBBBBUUBBUBUUUU
UUUUUUBUUUUBUUBUUUUUUUBUUUBUBBUUUUBUUUUUUUUUUBBUUUUBUUUUUUBUUUUUUUBBBUUUUUBUUUUBUBBUUBBUUUUUUUBUUUBBU
BUBUUUUUUBBUBUUBBBUUUUBUUBBUBUUBUBUUUUBUBUUBUUUBUUUBUBUUUUUBUBUBUBBUUBBBUUBUUUUBBUUBUUUUBBUUUBUUBBUBU
UBUBBUUUUUUBUBUBUUUUUUBUBBBBUBUUUBUBUUBUBBUUBBUBBUBUUUUUUUUBUBUBUBBUUUBBUUUBBUUUUUBBUBBBBUUUBUUUUBBUB
UBUUUUUBUBUUBUUUUUUBBUUBUUUUUUBUUUUUUBUBUUBUUUUUUUUUUUUBBUUBBBUUBUUBBUUUBUBUUUUUUUUUBBBUUBUUUUUUBUUUB
UUBBUUBUUUBBBBBUUUBUBUUUUUBBUUUUUUUBUUUUUUBUUUUUUUUBBBUUUBUBUUUUUUBBUBUUUUUUUUUUUUBUUUBUUUBUUUBBUBUUU
UUUBBUUBUBUBBUUBUUUUUUUUUUUBBUUUUUUUUUUUUUBUUUUBBUUUBUUUBBUUUUBBBUUBUUUUUBUBUBUUBUUUUBBBUUUBUUUUUUUUU
UUUUBUUUUUUUUBUBUBUBUUUUUUUUUUUBBUUUBBUUBUBBBUUUUBBBUBUUBUUUUBUUUBUUBBBBUUUBBUUUBBBUBUUUBUUUUBUUUUUUB
UBUUBUUBUBUBUUBBUBUUBUUUUBUBUUUUUUUBUUUBBUUUUUUBUUUUUUUBUUUBUUBUUUUUUUBUUBBBUBUBUUUUUUUUBUUUBBUBUUUUU
UBUUBUBUUBUBBBBUUUUUUUUUBBUUBUUUUUUUUUUUUUUBUUUUUUUUBBUUBUUBBUUUUUBUUUUBBUUUUUUUUBBUUUUUUUUUUUBUUUBUU
UUBUUBBUUBUBBBUBUBUUBBUBUBBUUBUUUBUUUUBUUUUUUUBUBUBUUUBUBUUUUBBUUBUBBBUBUBUUUUBUUBBBUUUBUBBBBUUUUBUUB
BBUUUUBUUBUBUBBUUUBUUUBUUUBUUUBUBUUBBBUBBUUUUBBUUBUUUUUUUUBUBUBUUUUUBBUUBUBUBUUUUUUBUBUUUUUBBUUBUUUUB
UUUUUBBBBUBBBBUBUBUUUUBUUUBUUUUUBBUUUBUUUUBBUUUUUUUUUBUUBBUUUUUBUBUUUBBBUBBUUBUBUUBBBBUUUBBUUBUUUUUUU
UUBUUBUBUUBBUUUUBUUBUBBUBUUUUUUBBUBUUUUUUUBUUBBUUUUUUBUUUUUUUUUUUUUUUBUUUBBBBUBUUUBBUBBUUUUUUUUUUUUUU
BBBUUUUBBUUUUUUBUBUUUUUBUUUUUBBBBUUUUUUUUBBUBUUBBUUBBBBUUBUUUUUUBUUBUUUUUUUUUBUUUUBUUUUUBBUBUUUUUUUUU
BBUUUBUBUUUUUUUUUUBUUUBBUUUBBUUBUUUBUBUBUUUUUUUUUBUUUUUBBUBBUUBUUUUUUUBUUUUBUBUUUBUUUBUUBUBUUUUUBUUBU
BBUUUUUUUBUBUUUUUUUUUUUUUUUBBBUUUUBBUUUUUBUUBUBUUUBUUUBUUUUBUUUBUBUBUUBBBUUUUUUUBUUUBUUUBUBUUUUUUUBUU
UUBUUUBUUUBBBUUBUUUBBUUUUUBUUUBBUUUBBUUUUBUUBUBUBBBUBBBUUUUUUUUBUUUUUBUUUUUUUBBUUUUBBUBUBBUUUUUUBUBBU
