UUUUBUBUUUUBUUUUUUUUBUBUUUUUBBUUBUBBUUUUBBBUUUUUUBUBBUBUUUUUUUUUUBUUUBUBBUUUUBUUUBBBBUUUUUUUUUBBUUUUU
BUBUUUBBBBUUUUBUBUUUUBBUUBUUUBUUUBUUUUBUUUUUUBUUUBUUBUUUUUUBUBUBUBUBBBUUUUBUBUUUUUUUUUBBUBUUBBUUBUUUU
UUBUUBUBUBBUUUUUUUUUUBUUUUUBUBUUUBUUUUUUUUBUBBUUBBBUUUUBUUUUUUBUUBUUUBUUUUUUUUBUUBUBUUUBUUUUUUBBUUUBB
UUUUUUUUUUUBBUUUUUUUBUUUUUUBUUUBUBUBUUUUUUUBBUUUUUBBUBBUBUUUUUUUBUBUBUUBBUBBBUBUUBUUUUUUUBUUBUUUUUBBB
BUUUUBUUUUBUUUUBUUUUUBBBUUBUBUUUBUUBBUUBBUUUBUUUBUBUUUUBUUBUUBUUUBUBUUUBUBBUUUUBUUUBUBUBUUUBBUUBUUBUB
BUBUUBUBUUBUBUBUUUUUBBUBUBBBUBUBUBUUUUUUBUUUUBBUUUUUBUUUBBBUUUUUBUUUUUUUUUUUBUUUBUBBUUBBUUUUUBUUUBUUB
BBUUUUUUUBUUUUUUUBUUBBBBBUUUUUUBBUUUUBUUBUUUUUBUUBUUBUUBUUUBBUUUUUUBBUUUBUUUUUUUUUUUUUBBBUUUUUUUBBBUU
BUUUUUUUUUBUBUUBBUUUUUBBUUUUBBUUBUBUUUUUBUUBBUBBUUUBBBBUUUUBUUUUUUUUUUUUBUBUBUUUBUUUUBUUUUBUBUUUBUUBU
UUUUBBUUUUUUUUUUBBUUUUUUUBUBUUUUBUBUBUBUUBUBUUBUUBBUUUUBUUBUBUUUUBBBUUUUUUBBUUUBUUUBUUBUUBBBUUUUUUBUB
UUBUUBUBUUUUUUUUUUUUUUUBUBBUUBUUUUBUUUUUUBUUBBUUUUUBBBUUBUBBUUUUUUUUBUUBBUUBUUBUBUUUUUUBBBUBBBUUUBBUU
UBUUBUBBBBUUUUUBUUUUBUBUUBBUUBUBUBUBBUUUUUUUBUUUUUUUUUUUBBUUBUUUUBBUBUUUUUUUUUUUBBUBUBUUUUBUUBUBUUUUB
BUUUBUBUUBUBUBUBBUBBUUUUBUUUBUBBBUBUBUUUUUUUUBUUUUUBUBUBUUBBUUUBUUBUBBUUBUBBBUBUUBUBUUUUUUUBUUUBUUUUB
UUUUUUUUUUBUUUBUUBUBBUBUBUBUUUUUUUUUBUUBUUBUUUBBUUBUUUBUUUBUBUBUUBUBUUUBBUUUUUUBUUBUUUBUBUUBUUUUUUUUU
BUUBUUBUBUUUUBUUUBUUUUUBUUUBBUUUUUUUBUUUUUUUBBUUUUUUUUBUUBUUUUBUBUUBUBUUUUUUUUBBUUUUBUUUUBUUBUUUBBBBU
UUBUBUBUBUUUBUBUUUBBUUUBBUUUBUUUUBUUUUBBBBBUUUBBUUBUBUUUUUUBUUBUBUUUUUBUBUUUBBUUBUUUUBBUUUUUUBUUBUUBU
UBUUUUUUBBBBUBUUBBUBUBUBUUUUUBUUUBBUUUUUUUBBBUUUUUUUBUUUBUUUUUUBUUUUUUBUUUUBUUUBUUUBUBUUBUUUUUUUUBUUU
BUUUUUUUUUUUBUUUUUBUBUUUUUBBUUBBBUBBBBUBBBBBBBUBUUUBUUUUUUUBBUUBUBUUBUUUBUUBUUUUUUUUUUBUUBUUUUUUUUUUB
UBUUUUUUUUUUUUUUUBUBBUUUUBUUBUUUBUUUUUUUUBBUUBUUUBUUUUUBUUUUUUUUBBBUUUUUBUUUUBUBUBBBBUUUBUUUUUUUUUUUU
UUUBUUBBUUUUBUBUUUBUBUUBUUUUBBBUUBUBUUUUBBBUUUBUUUBUUBBUUBUUUUBBUBUUBUUUBBUUBUUUBUUUUUUUBUBBUUBUUUUUU
UBBBUUUUBUUUUUUUUUUUUUBUUUBUUUBUBBUUUUUUBUUBUBBUUUUUUUUBBUUBBUBUUUBUUUUBBUUUBUBUUBBUUUUBUBUUBUBUUUUUB
BUUBUUUUUUUUUUUBUUUBUUUUUUBBUUUUUBUUUUUBUUUUBBBUUBUUUBUUBUBBUUUUUUUUBUUBBUUUUUUUUUUUUBUUUUUUUUUUBUBUU
BBUUBBUUUUUUBUUUUUUUUUBUBUUUBBUUBUBUBUBUUUUBUUUUUBUUUBUUUUUUBUBUBUUUUUUUUUBUUUUUUBBUUUBBUBUUUBBUUBUUU
BUUBUUUUBUBBUUBUUBUUUBUUBBBUBBUBUUUUUUUUUUBUBUUBBUBUUUUUUUUUUUUUUUUUUBUUUUUUBUUUUUUUUUUUUBUUUUBBUUUUU
UBUBUBUBBUUBUUUUUUUBBUUBUUBUUUBBBBUBBUUUUUUUBBUUUBBUUBBUUUUUUBBUUBUBUUBUUUUUBUBUBUUBUBUBUBBUUUBBUUBBU
UUUUBUUUUUUBUUUUBBBBUBBUUUUBBBUBUBUUUUUBUUUUUUUBBUUUBBUUUBUUBBBBBBUBBUUUUBUBBBBUUUBUUUUBUBUUUUUBUUUUB
BUUBUUUUBBBUUUBUBUBUUUUUUUBUUBUBUUUUBUUUUUBBUUUUUBUUUUUUBUUUUUUBUUBUUUUUUUUUBBUUUUUUUBBUUBUBUBUUUUUUB
BBUUBBUUBBBUUUUUUBBUBUUUUBUUBBUBUUUBUBBUUBUUUBUUUUBUBUUUUUBUUUUUUBBUBUUUUUUUUUUUUUUUBUUBBUBUBBUUBBUUU
BBUBBBBUBUUUUUUBBUUUUUBUUUBUUUUUBBUBUUBBUBUUUBBBUUUUUUBUUUUUUUUUUUUUUUUUUUBUUUBBUUBUUBBUUBBUUUBUUBBUB
UUUUBUUUBBUUUBUBUUUUBUBBBBUUUBUUUBUBBUUBUUUBBBUUBUBBUUUUUUUUUUBBBBUUBUBBUBBBBBBUUUUUUBBUUBBUBUUUBUBUU
UUUBUBUUUUUUUUUUUUUUUUUUUUUUUUUUUUUBBUBUUUUUUUBUUBBBBBUBBBUUUBUBUUUBUBUUUUUUUUBBUUUUUBUBUUUUUUBUUUUUU
UUBUUUBUBBBBUUBUUBUUUBUUBUUUUUUUUBUUUBUUBUUBBBUUUBUUUBUUUUUUUBUUUBUBUUBUBUUUUUUUBUUUUBUUBBUUBUUBBUUBB
BUBBUBUUBUUUBUUUUUUUUUBUUUUBUBBBUBUBUBUUUBUUUBBUUUUUBUUUUUUUUBUBUUUUUUUUUBUUBUUUUUUBBBUUUUBBUUUBUUBBU
UBUBUBUBUUBUBBBUUBBBBUUBUUUUBUBUUUUUBBUUUUUUBUUBUUUUUUBBUBUBBUBUUUUBUBUUUBUBBUBUUBBBUBBBUBBUUBUUUUUUU
UUBUUUBUUBBUBUUUUUUUBUUUUUBUUBBUUUUUUUBUUUBUUBBUUUBBUBUUBUUUUUUUBUBUUBUUUUBUBUUUUBBUUBUUUUUUUUBUBUUUU
BUUBUUUUUBUBBBUBBBUUBUUUUUUUBUUUBBUUBUUUBUBBBUUBUBBUBUUUUBBUUUUUUUUUBBUUBUUUBUBBBBUUBUUBBUUUUUBBUBUUB
UUUBBBUBBUUBUBUBBBUUUBUUUUUUBUUUUUBBBBBUUUUBUUUUUBUUUUBUBBUUUUUBBUUUBUBBBUBUBBBBUUUUUBBUUBUUUUUUUUBBB
UUBUUUUUUBBBUUUUBBUBUUUUUBUBUUBBUUUUBBUBUUUUBUBUUUUBUUUUUUUUUUBBUUUUUUUUUUUBBUUBUUBUBUUUUUUUBUBUUUUUB
UBUUBUUUBBBUBBBUUUUUBUUBBUBUUUUUUUUBUUUUUUUUUBBUBUUBBUBUUBUBUUUUUUUUUUBBBUUBUBUUBUUUUUUBBUUUBUUUUUBUU
UUBUUUBUUUUUUBUBUUBUUUBUBUUUUUUBBBUBUUBBBUUBBBUUUBUUUUBUUBBBBUBUUUBUBUBUUUBUUBUUBUUUBBUBUBUUUUUUUUBBU
UUUUUBUUUUBBUUUBUBUUUUUUUBUUBUBBUUUBBBUUUUBUBBUUUUUUBBUBBBBUBBUUUUUUBBUBBUUUUUUUBBBUUUUBUUUBUUUUUBUUB
BBUUUBUUBUBUUBUUBBUUUUBUUBUBUBUUUUBUUUUBBBUUUBUBUUUBUUUUUUBBBUUUUUBBUBBUBUUUBUUUUUUUUUUUUBBUUUBBUUUUB
UUBUUBUUUBBUBUBUBUUBUUUUUUUUBBUBUBUBUUUUUUBUUBUUBBUUUUBUBBUUBUUUUBBBUUUUUBBUBUUUBBBUUBUBUBUUUUUUUBUBU
UBBBBUUBUUUUUBBUBUUUUBUUUUUBBUUUUBUUUBUUUUUBBUUUBUUUUUBUUUBUUBUBBUUUUUBBUBBUUUUUUUBBBBBBUUBUUBUUUBBUU
UUUUBBBBBUBUBUUUUUUBBUUUBBBUUUUBUBUBUUBUUBBBUUBUBUUUUUUUUUUUUBBBUUUUUUUUUUBUUUUBBUUUUUUUUUUUBUBUBBUUU
UUUUUUUUUBUUUUUBBUUUUBBUUUBBBBUBBUBUBBUUUUUUUUUBBUBBUUUUUBUUUUUBUUUBBBBUUUUUUUUUUUBBBUUUBBUBUUUUUUUUU
UUUBUUUUUUBUUUUUBUUUBUUUUUUUBBUUBUUUUUBBUUUUBUBBUUUUUUBUBBBUUUUUBUUUUUUUUBBBUUUUUUUUUBUUBBUUUBBUBUUUU
BBUBUUUUUBBUUUUUBUUBBUUUUBUUUUUUBUUUUUUBUUBUBBBUBBUUBBBBBUUUUUUBUUUUUUUBUUUUUUBUUBUBUBBUUUUBUBUBUUUBU
UUBUUBBUBUUUBBUBUUBBBUBUBUBUUUBUUUBBUUUBUBUUBUUUBUUUUBBBUBUUUBUUUBBUUBUUBUBBUBBUUUUUUUUBBUUUUUUUBUBUU
UUUUUBUBBUBBUUUBUBUUUUUUUBUUBUUUBBUUUUUBUBUUBUUBBUBUUUUUUUUUUUUUUUUUBBUUUUBUBBUUUBUUUUBUBBUUUUBBUUUUB
BUUBUUUUUUBBUUBUUUUBUUUUUUUUUBUUUUUBUBUUBBBUUUUBUUUUBBUUUUUUUUUUBBUUUUUUBUUUUUUUUBBUBBUUBUBBBUBUUUUUU
UUUBUUBUUUUBUBUUUUBUUUUUUUBUUUBUUUBUUBUBUBUUUBUUUUBUUUUUUUUUUUUBBUBBUBUUBUUUUUUUUUBUBUBUUUBUUUUBUUUUB
BUUBUUUUUUUBUBUBUUBBBUBBUUBUUUUBUBBUUUUUUUUUUBUUUUBUUUUUUBBUUBUUBUBUBUUUUBUUUBBUBUBBBBBUUBUUUBUUUUUUB
BUUBUUBBUUUUUUUBUUBUUUBBBUUBUUUUUBUUBBBUUUUBUUUUUBUUUBBBUUUUBUUUBUBUBUUUBUUBBUUUBUUBUUUUUUUUBUUUUBBBU
UUBUUUBUBUBBBBUUUUUUUUUUUUBUBUUUUUBUUUUBUBUUUUUUUBBUUBBUUBUUUBBUUUBUUBBUBUBUUUUUUUBUUBBUBUUBUUUUBUUUU
UBUUUUUUUUBBUUUUUUUBUUUBUBUBUBUUBUUUUBBUUUUUBUUUUUUUUUBUUUUUBUBBUUUUUUUBBUBUUUUBUBBUUUBBBUUUBBUUUUBUB
UBBUUBUBUUUBUBUUUUUUUUBBUBUUBUBBUBUUUBUBBUBUBUBUUUUUUUUBBUUUUUBBUUUUBUUUUUBUUUUUUUUUUUUUUBBUUUUUBUUBU
UUUUUBUUUUBUUBUUUUUUUUUBUUUBUBUUBUUUBUUUBUUUBUUUUBUUUUUUBUBUUBUBBUUBBUUUBUUUUUUUUBUBUUUUUUBUUUBUUUUBU
UBUUUUUUUBUUUBUUUUUUUUUBBBBUBUUUUUUBBBUUUBUUBUBUUUUUUBUBUUBUUBUBUUUBUUUUUUUUUBUUUUUUUUUBUUUBUBUUUUUUB
UUUUBUUUBUUUBUUBUUUUUUBUUBUUBUUUUBUBUUUUUBUBUUUUUUUBUUUUUBUBUUUBUUBUUUUUUUUUUUUUUUUBUUBUUUBUUBUBUUUBU
UUUBUBUUUUBBUBUUUUBUUUUUBUUUUUBUBBUUBUUUUUUBBUBBBUUUUUUBUUUBUUUBUBUUUUUUBUUBUBBBUUUBBUUUUUUBUUUUUUUUB
UUUUUUUUUUBBUUBUBUUUUUUBBUUBUBUUBBUUUUUBUUUUUBUUUBUUUBBUUBUBUUUUUBUBUBUUUUBBBBUUUUUUUUUUUUUUUUUBBBUBU
BUBUUUUUUUUUBUUUUBBUBBUBUUUUBBUUUUUBBUUUUBUBUUUUUUUUUUUUUBUUBUUBUUBUUUUUBUBUUUUUUBBUUUUUUUBBUBUUBUUUB
UBUUUBUBBUUUBUUUBUUUUUBUUUUUUUUUBUUUUUUBUUBUBUUUUUUUUUUUUUUUUUUUBBUBBBUUBBUBUBBUBUUBBUUBBUBUUUUUBUBUU
UUBUBUUUUUUBUBUUBUUUUUBUBBUUBBUUUBBUUBUUUBUBUUUBUUBBBUBUUBUUUBUUUUBUUUUUUBBUUUUUUUUUUUUUBUBBBUUUUUUUU
UUUUUBBUUUUBUUBBUUUUBBUUBUUUUUBUUBBBBUBBBUUBBUBUUBUUUUUUBUUUUUUBUBBUUUUBBUUUUBUUUBUUBUUUUBUBBUBBUBUUU
UUUUUUUUBUBBUUUUBUUBUBBBBUBBBUUUUUUBUUUUUUUUUBBBUUUUUBBBUUUUUUUUBUUUUUUUUBBUUUUUUUBUUUUBBUUBUBUBUUUBU
UUBUUBUBUBUUBBUUUBUUBUBUUUBBUBUUUUUBBBUUUUUUUBUBUUUUBUBUUBUBUUUUBUUBUUUUBBUUBUUBUUUBBUBBUBUBBUUBBUUUB
UBUBBBBUBBUUUBUUUBUBUBUBUUBUUUUUUUBUBUBUUUUUUUUUUUBUUUUUUUBUUUUBBUBUUBBUUUUUBUBUUUUUBUUUUUUUUBBUBBUUB
UBUUBBUUUBUUBBBUUBBUBUUUUBUUUBBBUUUUUUUBBUUUUBUUUBUUUUBUUUBUUBUUBUUBBUUBUUUUBUUUUBBUUUBUUUBUUBUUUBUBU
UUUUBUBUUUUUUUUUUUUUBUBUUUBUBUUUBUUBBUUUUUBUUUUBUBUUUBUUUBUUBUBUUBBUUUBBUUUUUUBBBUUUUUBBBUUUBUBBUUUUU
UUUUUUUBBBBUBBUUUBUUBUUUUBUUBUBBUUUBUUBUBUUBUBUBBUUBBUBBBBBUUUUUUBUUUUUUUUUBBUBUUUBUBBUBUBBBUUUUUBBBB
UUUUUUUBUUUBBUUBBUUBUUUUUBBUUBUUUUUUUUBUBBUUUUUUUBUBUBUUUBBUUUUUUUUUBUBBUUUBBUBUBUUBUUUBUBBBUUUUBBUUU
BUUUBUBUBUUUBBUUBBUBUUUUBUUUUUBUUUUUUUUUUUUUUUUBUUUUUUUUUUBUBUUBUBUBUUUBUUUBUBBBUUUUUBUUUUUUUUBUUUUUU
UBUUUUBBBUUUUBUUUUUUUBUUUUBBUBBUUUBUUUUBBUUUBBUBUUBUUUUUUUUBUUUBUUBUUUUUBBBUUBBUUUUBUUUUUUBUBUBUUBUUB
UUUUBBBUUUUUUUUUBUUUUUUUUBBUUBBUBUUUBUUUUUUUBUBUUUUBBBUBBBUBUBBUUUUUBUUUBUUUBBUBUUUBUBBUUUUUUUUUUUBBU
BUUUUUUUUBUUBUBUUUUUUBBBBUUBBUUBBUBUUUUBUUUUUUUBBBUBUUUBBUBBUUBUUUUUUUBUUUBUBBBBUUUUUUBUBUUUBUUBUUUBU
UUUBUUUUUBBUBUUBUBUUBUBUBBBUBBUUUUUBBUUBBBUBUBUUUBBBUUUBBBUUBUUBBBUBUUUBUUUUUUUUUUBUUBUUUUBUBUBUUBUBU
UUUUUUUUBUBBBUUUUUUUBUUBUUUUUUUUUUUUUBUBBBUBUBUBUUUBUBBBBUUUUUUBUBUUUUBUUUUUUUUBBUUUUUBUUBBUUUUUUUUUU
UUUUUUUUBUBUUUBUBUUUUUBUBUUUBUUUBBUUUBUUUUBUBUUUUUUBUUUUUUUUUUBUUBUUUBUUUUUUUUUUUUBUUBUBUUUUUUUUBUUUB
BUBUUBUUUUUUUUUUUUBUBUUBUUUUUUBBBBUUUUUUUUBUUUUUBBUUUBUBUUBUUBBUBUUUBUBBUBBUUBBUBUUUUUUBUUBUBUUUUBUBU
UUBBBBUBBUUUBUUUUBUUUUBBUUUUBUUUUBBUUBBUBBUUUUUUBUUBUBUBUUUUBUUBUUUUUUBUUUUBUBUUBUUBUUBBBUBUBBUUUBUUU
BUUBUBUUUBUUUUUUBUUBUBUBUBBUUUBUBUUUBUUBUUUUUUBBBUUBUUBBUBBUUBUBUBUUUBUUBUUUUUUUBUUUBUUUUUUUUUUUBBUUU
UBUBUUUUUBBUBUUUBUUUBBUUBUUUBBUUUUUUUBUUUBUBUBBUBUUUUBUUUUUBUUBUUBUBUBUUUBUBBBUBUUUUUUUUUUBBUUUBUBUBU
BUUBUBUUUUBBUBBUUUBUUUUUUBUBBUUBBUUBUUUUUBUUUBUUUBBBUBUBUUUBUBUBUBUBBUBUBBBUUUBUUBBUUUUUUUUUBUBUBUBUU
BUBBBBUBUUBBUBUUUBBUUUUUBBUUUUUUUBUBUBBUUUBUUUUUUBUUUBBBUUUUUBUUUUUBBBBBUUUUUUUUUUUUUUBUUBUUBBBUUUUUU
UUUUBBUBBUUUUUUBUUUUBUUBUUUUUUUBBUUUUUUUUUUUUBUUUUUBUUBBUBBUBBBUUUUUUUUUBUUBUBUBUUUBBUBBBUBUBUBBUBUBU
UUBUBUUUUBUUUUUBUUUUBBBUBBUBBBUBUUUBUUUUUBBBUUUUUBUUUUUBUUUUUBUUBUUUUUBBUUUUBBBUUUBUUUUUUUUUUUUUUUBUU
UUUUUBUUBUUUUUUBBUBBUUUBUUUBUBUBUBUUUUBUUUBUUUBBUUUUUBUUUUUBBUUUBUUBBUBUBUBUUUBBUBUUUUUUUUBUUUUBBBUUU
UUUUUUUBBUBUUBUUBUUUBUBBUUBUBUBUUBBBUUBBUUUUBUUBBBUUUBUUBBUUUBUBBBBUBBUUUUUBUUBUBBBUUUBUUBUUUUBBUUUUU
UBUUUUUUUUBUUBBUBUBUBUUBUBUUUUUBBUBUUUUBUUUUBUBUUUUUBUBUBUUUBUUUBUUUUUUUUBUBUUUUBUUBUUUUUUUUBUUBUBUBU
BBBUUBUBUUBUUBBBUUUBBUUUBBUUUUBUUUUUUBBUUUUBUUUUUUUUUUBBUBUBUUBUUUUUBUUUUUUUUBUBUUUBUUBBUUBUUUUUUUUBU
UUUUBUBUUUBUUUBBUUBBUUUUBUUBUUUBUUUBUBBBUBBBBUUUBUUUUUUUUUUBUBBBBBUBUBBUUUBUUBBBBBUUUBUBUUBBUUBUUBUUU
BBBUUBUUUUUBUUUUUUBUUBUUUUBUBUBBUBUUBBUBBUUBUBBUUUUBBBUUUUUUUUUBUUBUUUUUUUBUBBUUUBUBUUBBUBUUUUBUUUUBU
BUUBUUUUUUBUUUUUUBUUUUUUUBBUUUUUBBBUBUUBUUBUBBBUUUUUUUUBUBUBBBBBBBBUUBUUUUUBUUUUBUUUUUUUUBUUBUUUUUBUU
BUBUUUUUUUBUUUUBUUUBBBUUUUBUUUBUBUUUUUUBBUUUBUUBUUUBUBUUUUUBUUUUBUBUBUUBUUUUUUUBUUUUUUUBUUUUBUBBUUBUB
BUBBUUUUUUUUUBUBUUUBBBUUUUUBBUUUUBBBUBUUBUBBBUBUBUBUUBUUBUUUUBBUBBUUUUUUUUUUUBUUUUBUUBBBUUBBUBUBBUBBB
UUBUUUUUBUUBUUBUBUUBUBBUUUUUUBUUBUBUUUUUUUUBUBUUUUBUBUUUUBBUUBUUUUUUUUUBUUUUUUUBUUUUUUUUUUUBUUUUUBUUU
BUBUUUBUUUUUUUUUUUUBBUBBUUBUUUUUUUUUBUUUUBUBUUUUBBBBUUBUUBBUBBBUUUBUBUUUBUUBUUUUUUBBUUBUUUUBBBUBBUBUU
BUUUUBUBUUUUUUBUUUUUBBBBUBUUUBUUUUUUUUUUUUUUUUBUUBUUUUUBBUUUBUUUBBUBUUUUUUUBBUUUBBUUBUBUBUUUBUBUUUUUU
UUUUUUUUUUBUUUBUUUUBUUUBBUBBUUBUUUBBBUUUUUUBUUBUUUUUUUUBBUUUBUUBUBUUUUUBUUUUUUBUUBBUUBUUBBBUUBUUUUUUU
BUUBBUUBBUBUUBUBUUUBUUUUUBUUUUUUUUBBUUUUUUUBUUBUUUBUBUUUBUUUUBUUUBUUUUBUBUUUUUUUBUUUUUUBUUBUUUUUBBUUU
