UUUBUUUUBUUUBUUBUBUBUBBBBUUUUUUUUUBUUUUBUUUUUBUBUUUUUUUUUUUUUUBUUBUUBUUUBUBBBBBBUBBUBUUBUBUUUUUBUUUBU
UUUUUUUBBUUUUBUBUUBUUUUUUBUUUBUUUUBBBUUUUUUUUUUUUUUUUUUUUUBUUBUUUUUBUUBBBUUUBUUUBBBUUBUBBBUUUUUUUBBBU
UBUUBBUUUUUUUBBUUUBBUUBUBUUUUUUUUUUUBUUUBBBBUBBUUUUUUUUUBUUUUUBBUUUBUBUBBUUUUUUUUUUBBBUUUUUUUUUUBUUUB
UBBUUUUBUUBUBUUUBUUBBUBUBUBUUBUBBUUBBUBUUUBUBBBBUBUUUUUUUUBUBUBUUBBUUUUBUUUBUUUBUBUBUBUUBBBUUUUUBUUUU
UUUUUUBUUBUUUUUUUUBBUUUUUUBUBBBUUBBUBUUUUUUBUUBBUUUUUUUBUUUBUUUUBBBUUUUUUUUUUBBBUUBUUBBUBUUUBBUUUUUUU
UBUUBUBUBUBUBUUUUUBUBBUUUUUUBUUUUUUUUUUUBUBBUUBUUUUBUBUBUUUUBBUBUUUBBBUBBBUUUUBBUUUBBUUUUUUUUUBUBUUUB
UUUUUBBUBBBBBUUUUUUUUUUUBBBUUUBUUBBUUUUUUBUUUUBUUUUUUUUUBUBBUUUBUBUUUUBUUUBUBUUUUUBUUUUUUUUUUUUBBUUBU
BUUBUUBUBUUUUUUUBUUUBUUUUUUBUUBBBUUUUUBUBBUUUUUUUUBUUUBUUUUBBBUUBUBUUUBUBUUUUUUUUUUBUUUBUBUUUUUBUUUUU
BUUUBUUBUUUUUUUBUUBUUBUBUBBUUBBBBUUUBUUUUUUUUUUBBUUUBUBBBBUBUUUUUUUUUBUUUUBUBBUBUBUUUUBUUUUUBBBBUUUUU
UUUUUUBUUBUUBBUBUUUUUUBUBBUUUUUUUUUBUBUUUUUUBBUUBBUUBBUUUUUUUBUUUBUUUBBBUUUUUUUUBBUBBUUUBBUBUUUBBBUUU
BBUUUBUUUBUUUBBUUUUUBUUBUBUBUUBUBBUBBUBUUBBUUUUBBUUBUUUBUUBBUBUBBBUBBUUUBUUUUUBUUUUUUUUUUBBUUUBBUUBUU
UUBBUUUBUUUBUUUUUUUUBUUBBUBUUUUUUBBUUBUUBBBBUBUUUBUUBUUUBUBUUUUUBUUUUUUUUBUUUUUBUUBUUUUUBUBUUUUUUUUUU
UBUUUBUUUBBUUBUUUUBBUUUBUUUUUBUUUUBUUUBUUBUUBUUUUBBUUBUUBUBUUUUUUUUUUBUUUBUUUUUBBUUUUUUUUUBBBUUUBUBUU
UBUUUBUUBUUBBUUBBBBUUUUUUBUUUUBBUUUUUUBUUUUBUBBUUUBBUBUUUUBUUBUBUUUUUUUUBBBUUUBUUUUUUBUUUUUBUUUUBUUUU
UUUUUUUUUUUBBUUUUUBBBUUUUUUUUUUUBBUUBUUUBUUUUUBUBBBBUUUUUUUUBUBUUBUUUUUUUUUBUUBUBBBUUUUUBUBUUUBUBBBUU
UBUUUUUBUBBBBBUBUUUUBUUBUBUUUUUUBBUUUUUUUUBUBUBBBUBUBUBUUBUUBUUUUUBUUUBUUUUBUUBUBUBBBUUUUUUBUUUUBUUBU
BUBBBUUBUBUUUUUUBUBUUUUUUUUUUUUBUBUUUBUBUUUUUUBUBUUBUUBBUUUBUUBUBUUUUUUBUUBBUUUUUUUBBBUUUUUUUUUUUBUUU
UUBUUUUBBUUUUUBUUUBBUUUUBUBUUBUUUUUUUUUBUUBBUUUUBUUUUUUBUUBBBBUUUBUUUUUUBUUUUUUUBUBUUUBUBBUUUUUUBUUUU
UUUUBUUUUUUBUUUUUBUUUUUUUUUUUUUUUUUBBUBUBUBBUBUBUUUUUUBBUBUBUUUUUUUUUUUUBUUUUBBUUBUBBUBUBUUUUUBUUUUUU
UUUBUUBBUUBBUUUBBUUBUUUUUUUUUUUUUUUUUUUBBUBUBUBUUUUBUBUBUUUUUBBUUUUUUBBUUBBUUUUBUUBUBUUUBUUUUBUBUBUBU
BUUUUBUUUUUUUUUUBBUUUUBUUUUBUUUUUBUBUBUUBBUBUUUUBBBUUUBUUUUUUBUUBUUBBUBUUUBUBUUUUUUUUUBUUBUBUBUBBUUBU
UUUUBUBUUUUUUUUUUUUUBBUUBBUUUUUUBBUBUUUUBUUBBBBBUUBUUUUUUUBUUUBUUBUBBUUBBUUUUUUUUUBBBBBBUUBUUUUUBBUBU
BUBUUUUUUUUBUUBUUUUUUUUBUUBBUBUUUBUUUUUUBUUUUUUUBBUUUUUUUUUBUBUBBUUUUUUBUUUUUUBUUUBBUUUUUBUUBUUUUUUUU
UBBUUUUUUUUUUUUUUUUUUUBUBUBUBBUUUUUUUUUUUBUUBBUUUBUUUUUBUUUUBUUUUUUUUUUUUBUUUUUUUUUUUUUBBBBUUUUUBUUUU
BUBBUUUUBUUUBUBBUUUUBUUBUUUBUBUUUUUUUBUUUUUUUBUUBBUUUBUUBUUUUUUUUUUBBUBUUUUUUUUUUBUBUUUBBUUUUUUUUUUUB
UUUUBUUUUBBUUUUUUBUBUUUBUUUBBUUBUBUBBUUUUUUUUUUBUUBUUBUBUUUUUUUBBBUUUUBUUUUUUBUUUUUUBUBUUUUUUBBUBUBUU
BBUBUBUUUUUUUBBBUUUBBUBUUBBUUUBBUBUBUUUUUBBBUUUUBUUUUBUUUBUUUUUUUBUUUUBBUUBUBUUUUUUUUBUUUBBUUUBBBBUUU
UBBUUBUUBUBUBBUUUUUUUUUBBBBBUUBUUBUUBBBBBUBUUUUUUBBUUUBUUUUUBUBBUUUUBUUBUBUBBUUUBUUUUUBUUUBUUBUBBUBUB
BUUUUUUBBUUUUUBUUUUUBUUBUUUUUUUUUUBUUUUBBBUUUBUUUBUBUBUUBUUUBUUUUUUUBUUUBUBUUUBUBUUBBUBUBUUBBBUUBUBUU
UUBBBBUUBUBUUBUBUUUBBUUUUUBBBBUBUUUBBUBUBUBUBUUUUBBBUBUUBBUUUUBUBUBUUUUBBUUUUUUBBBUUUUUUUUUUUBUUUUBUB
BBUUUUBBUUBUUUBUUBUUBUUBUUBBUUBUUUUBUUUUUUUBUBBUBBUBUUUBUBUUUBUBUUUBUUUUUUUUUUUUUBUBUUUUUUUUUUBUUUUBU
UUBUUUBBUUUUUBBUUUUBUBUUUUBBBUUUUBUBBUUBUUBUUBBUUUUBUUUBUUUBBUUBUUUUBUUBUBUUBUUUUBUUBBBBBUBBUUUUUUUUB
UUUUBUUUUBBUUUBUUUUUUUBUUUUUUUUBUUUBBBUUBBBUUUUBUUUUBBUUUUUUUUUUUUUBUUUBUUUUUUUUBBUUUUBUUBUUUUUBUBUUB
UUBUUUBBBBBUBBBBUUBUUUUUBUUUUUUUUUUBUUUUUUUUBUUUUUBUUUBUBUBUBUUUUBBBBUUBUUUUBUUUUBUBUBUBBBUUBUUUBUBUB
UUBUUUUUUUUUUUUBUUUBUUUUUBBUBUUUUBBBUUUUBUBUUBBBUBBBUBUUUUUUBUUBBUBBUUUBBBUBBUUUBUUUBUBUBBUBBUUUUBBUB
BUBBBUUUUUUUBBUUUBUUUUBBUUUUUUUBBBUUUUUUBUUBBUUUUUUBBUBBUUUUUUUBBUUBBBBUUUUUUBBBUBUUUBBUUUBUUUUUBBUBB
UUBUUBUBUUUUBBBUUUUUUUUUUUUUUUUUUBBUBBUUBUUUBUBBUUUBBBUUUUUUBUBUUUUUUUUUUUUBUUBBBBBUUUUUUUUUBUBBUBUUU
UUUUBBUUUUUUBUBBBUUUUBUBUUBUBUUBUBBBUUUUBUUBUBBUUUBUUUBUUBUUUBUUUUBUUBBUBUUUUUBUUUUUBUUBUUUUUUUBUBUBU
BUUUUBUUUUUUBUUUUBUBUUUUUUUUBUUUBUUUBUUUBBUUUUUBUUBUUBUBBBUUBBUUUUBUBBBUUUUBUBUUUBUUUBUUUUUUUUBBUUUUU
UBUBUUBUUBUUBUBUUUUUUBBUUBUUUUUUBUUUBUBUUBBBBUUUBBUUUUBUUBBBUBUBUUBUUUUUUUUUUUUBBUUUUUUUUUUUUUUUUUUBU
UBBUUUBUUBUBUBUBUUBUBUUUBBBUBUUBUUUBBUUBUBBUBUUBUBUUUUBUUBUUBUUUUUUUBBUBBUUUUBBBBUUUUUUBUUUUUBUBBBUUB
UUUBUBUUBUBUUUUUUUBBUBUUUUUUUUUUUUUUUUBUBUUUUBUUUBBUUUUUUUUUUUUUUUBUUUBBUUBBUUUUBUUBUUUUBUUBUUBUBUBUU
UUUBUBUBBUBBBUUBUUUBBBUUUBUBUUUUBBBUUBBUUUUBBBUUBBUBUUBBUUUBUUUUBUUBUUUUBBBUUUUUUUUUUBUUUUBBBUBUBUUBB
UBBBUUBBBUUUBUUUUUBUUUBUBBBUUUUUBUUUUUBUUUUBBBUUUUBUUUUUUUUUUUUBUBUBUUBBUUUUBBUUBUUBUUUUUBUUUBUUBUBUB
UUBBUUUBUUBUBUUUUBUBUUBUUUUBUUUUUBUUUBUUBUBUUUUUUBUUBUUBUUUUUUUBUBBUUUUUUBUUUUUBUUBUUUBUUUUUUUBBUBUBU
BUUUUUUUUBUBBUUBUUUUUUUUUBUBUUUUUBBBUBUBUBUUBBUBBBUUBUBUUUUUUUUUUUBUUUUBUBUUUUUUUUUBBBUUBUUUUUUBBUUBU
BUBBUUUUUUUBBBUUUUBUUUUUUUBUUBBUUBUUBBUUUUBUBUBUBUUUUUUUBBUUBBBUBUBUBUUBUUUUUUUBUBUBBUUUUBUUUUUBBUUUU
UUBBBUUUUBUBUUBUUBBUUUUUUUUUUUUUBUUBUBUUUBUBUBBUUUUUBBUUBUUUUUUBUUBBUUUBBBBUUUBUUUUUBUUUUBUBUUUUBBUBU
BBUBUUUBUUUUBUUUUUUUUUBUUBUUUUUUUUBBBBBBUUUUUBUUBBUBUUUUUUUUUUBBUUUUUUUUBUBUUUBUUUBUUUBUBUBUBUUBBUUUU
UUUBUUUBUUUUUUUUUBUUUUUUUUUBUUUBUBUBUUUUUBUUUUUUUUUBUUUUBUBUBUUUBUUBUUUUBUUBBUUUBUUUUUUBUBUUBUBUUUUBU
UUUUBBUUUUUUUUUBUBUUBBUBBUBUUUBBUBBUUUBUBUUUUBUBUUUUUUUBBBBUUUBUUUUUUUUBBUBUUBUBUUUUUUUBUUUUUUUUUBUUU
UUUUUBBUUUUUUBBBUUUUUUUUUBUUBBUUUUUUUUUUUUUUBUUUUUUUUUUUBBUUUBUUUUUUBBBUUUUUUUUUUUBUBUBBBUUUBUBBUUUUU
UUUBUUBBUUBBBUUUUBUUUUUUUUUUUUUBUUUBBUBUBBUUUUUUUBUUBBBBUBBBUUUBBBBBUUBBBUBUUUBUUBUUBUUBBUUBUBUBBUUBU
UUBUUUUUBUUBUUUUBUBUUUBUBBUBBUUUUUUUUUUBUBUBUBBBUBUUUBUBUUBUBUUUUUBUUBUUBBBBUUBUUUBUBBUBBBUUUUBUUUUUU
UUUUBBBBUBUBBUBUUUUBBUUBUBUBBBBBUUBBUBBUUUUBBUUUUBUBUUUUUBUUBBUUBBUUUBBUBUBUUUUUUUUUBBUBUBUUUUUBUBUUB
UBUUUUBUUBUUUBUUBBBUBUBUUBBUUBUUBUUUBUBUUUUUUBUBUUUUUUUUUUUUUUBUUBUUBUBBUUBBUUUBBUUBUUUBUBBUUUBUUUUUU
BBUUUUUBBUUUUUUUBUUUUUUBUUUUUBUUUUBUBUUBUUBUUUBBBBUBUBUBBBUUBBUUUBBBBUUUUBUUUBBUUBUUBUBUBBBUUUUBUUUUB
UUBUUBUUBUBUUUUBUBBBBBUUUUBBUUBUUUUUBUBBUUUUUUUUUUUBUBUUBUBUUBUUUBUBUUUUUBUBBUBUUBUBUUUBUBUBUUBUBBBBB
UUUUUUUUUUUUUBBBUBUUUUUBBUUUUBBUUUUUUUUBUBUBBBUUUUUUUUUBUUUUUUBUBUBUUUUUUUUBBBUBUUUUUBBUBUUBUBBBUUUUU
UUUUBUUUUUUUBUUUUUUUBUBUBUBUUBUUUUUBUUUUUBUBBUUBUUUUUBUBUUUUUUUUUUUUUBUUUUUUBBBBUUBUUUUBUUUUBBUUUUBUU
UUBUUUUBUUUBBUUUUUBUUUUUUUBUUBBUUUUBBUBUBBUBUUUBBUUUUBBUUUBUBBUUUUBBBUUUBUUBUUUUUUBBBUUUBUUBUUUBUUBUU
UBUUUUUBBUUBBUBBUUUBUBBUUUBUUUBUUUBUUUUUUUBUBUUUBUUBBBUUBUUBUUUUUBUBBUUUBUBBUBBUUUBBUUUUUUUBUUUUUBUUU
UBBUUUUUUUUBBBUBUUBUBBBUUBBUBUUBBBUUUUUUUUUBBBBBUUUBBUUBUUUUUBUUUUUUBUBUUUUUUUUUBBUUUUUUUUUBUBUBUUUBU
BBBBUUUBUUUUBUUUUBUBBUUUUBUUUBBUUUBBUUUUUUUUBBBUUUUUUUBUUUBUUUBBBUUUBUUUUUUUUBUUUUBBUUBBBBUUUUUUUUBUU
BBUBBUUBUBBUUUBUUUUUBUUUBBUUUUUUUUUBUUUUUUUBUBUUUBUUBUBBBBBBUBUUUUUBUUUUUBUBBBUUUBUUUUBUBUBUUBUUUUBUB
BUUBUUUUUUUBBUUUUUUUUUBBBBUBUUUUUUUBBUUBBBBUUBBBUBUUUUUBUBUBUUUUBBUBUBBUUUUBBUBBUBBUUUUBBUUUUUUUUUBUB
UUUUBBUUUBUUUUBUUBUUUUUBUUBUBUUUUUUUUUBUUBUUBBUBUBBUUUBBBUUBBUUUUUUBBUUUBUBUUUUUUBUUBUUUUUUUUBUUBUUUU
BBBUUBBUUUUUUUBUUBUUUUUBUUUBUBBBBUUBUUUUBUUUUBBBUUUUBUUUUUUUUBUBUUUUUUUUUBUUUUBUUUUUUUBUUUBBUUUUUBUUU
BUUBUBUUBUUUBUBBBUUUUUUUUBBUBUUBBUUUBUUUBUUBBUUUUBUBUUUUUBUUUUUBBBUUUUUUUUBUUBUUUUUBUBUUBUBUUUBBUUBUB
BUUUUUUUUBUUUUBUUBBBUUUBUUUUBBUUBUUUBUBBUBUUUBBUUBBUUUUBBUUBUUUUUBUBUUBUUBUBUUBUUUUUBUUUUUBUUBUBUUUUB
BUUUBBUUBBUUUUBUUUUBBBBBBUUUUBUUUUBBUUUBUUUUUUBUBUBBUBBUUUUBUUUUUUUBBUUBBUUUUUUUUBBUUBUUUBUUUBUUUUBUU
BBUUBUBUUUUBBUBBUUUBUUUBBBUUUUUBBUUBUBBUUUUUUUBUUBUUUUUBUBUBBBBBUBUUUUBBBBUUUUBBUUUUUBUUUUUUUUUUBBUUU
BUBUUBUUBBUUBUBUUBBUBUUUUBUBBUUUBBUBBBUUUUUUBUUUUBUUUUUUBUUUUUUUUUUUBUUUUUUBBUUBUUBUUUUUBBBUUUUUUBUBB
UUBBBUUBUUBUUUUUUUUUUUUUUUBBUUBBUUUUUBUUUBUUBBUUBUBUUUBUUUBUUUBUUUUUBUUUUBBBBUUUBUUUBUUUUUUBUUBUBUUUU
UBUBBUUUUUBUUUUUUBUUBUUUUUUUUBUUBUUUBUUBUUBBBBUBUUBUBUUBUBUUUUBUUBUUUUUBBUUUUUBUUUUUBBUUUUUBBUUUUBBUU
UUUBUBUUBUUUUUUUUUUUUBUBUUUUBUUUUUUUBUBUUBUUUUBBUUBUBUUUBUUBUUUUUBUUUUBUBBUUUBUUUBBUUBBUBUUUUBUUUUBUB
UBBBBUBBUUBUUBBUUBUUUUUUUUUUUUUBUBUUBUUUBBUUUBBUUUBBBUBUUUUUUBBUUUBUUUBUUUUUBUUUUUUUUBUUUUBUUUUUBUUUU
UBBUUUUUUUUBUBUUUUUBUBUUBBUUUUUBUUBUUBUUUUUBUUBUUUUUUBBUUBUBBBUUBUBUUUUBUUUBBUUUUUUBUUUBBUUUUUUUUUBUB
BUUUUBUBBUUBUBBUUUUUUUBBUUBBUUUBUUBUBUUUUUUUUUUUUBUBUUUUBBUUUUUBBUBBBBUBUUUUUUBBUUBBUUBUUBBBUUUUBUBUU
UUUBUBUUUUBUUUBBUUUBUUUUUUUBUBBUUBUUUUUBUUBBUBUUUBBUUUUUUBBUUBBUUUBBBBUUUUUBUUUUUUBBUBUUUBUUBUBBUUUBU
UUUUBUBUUBBUBBBUUBUBUUUBUBUUUBBBUBUBBBBBBUUUUUUUUUUUUUBUUUBBUBUBBUBBUUBBUUUBBUUBUBBUUBUUBUUUUUBUUUBBB
UBBUUUUBUUUUBUUUUBBUUUBUUUUBBUUUBUBUBUUBBUUUBBUBBUBBUBUUUBUUUUUUBUUUBBBBUUUUUBBBUUUUUUUUUUUUBBBBUUBUB
UUUBUBUUUUUUUBUUUUUUBUUUUUBBUUUUUUBUUUBUUBUUBBUUUBUUUUUBUUUUUUUUUUUUUUUUUUUBUUUBUUBBUUBUBUUUUUUUUUBBU
UBUUUUUUUBBBUBUUUUUBUBUUUUBUBUUUUUUUUUBUUBUUUBBUUUUUUUBBUBUBBUUUUUUUUBUUUUUBUUUUUBBBUBUBBBUUUUUBUUUBU
UBUUBUBUUUUUUBUBBUUUUBBBUUUBUBUUBUUBUUBUUUBBUUUUUUUUBBUBBUUUUUUUUUUUUUBBUBBBUBBUBUUUUUUBBUUUUUUUUUUUU
UBUBBUUUUUBUUUBUUUUUUUUBBUBBUUUUUBUBUUBUUUUUBUUUUUUBUUBBUUBUUBBUBUUUUBUUBBUUUUUUUBUBUBBBUBUBUUUUUUUUU
UBUUUUUUUUUUBUUBUUUUUUUUBUBBBBBBBUUBUBUUUUUUUUBBBBUUUUBBUUUBUBUBUUBBUUUUBUUBBUUUUUUBBUBBUUUUBUUUBBUBU
UBUBUUUUUUBUUUBUBBUUBBUBUUUUUBBUUUUBBBUUUBUBUBUBUBUUUUUUBUUBUBBUUUUBBBUBUBBUBUUUBUUUUUUBUBBUUUUUUUUBU
BUUUUUUBBUBBUUUBUUUBBUUUBUUUUBBUUBUBUUBBUUUUUUUUBBUUUUBBUBBBBUUBUUUUBBBBUUUUBUBUUUUBBBUUUBUBUBUUUUBUU
BUUUBUUUUUUBUUUUBBBUUUUBUUUUBUUBUUUUBUUBUUBUBUUUUBBUUUBUBUUUBUUUBBBUUUUBUUUUUBBUBBUBBUUUUUUUUBBBUUUUU
UBUBUBUUBUBUUUUUUBUUUUUUUUUBBBBBUUUUUUUUUBUUUUUUUUUUUUBUUUUUUUBBBUUBUUUBBUUUUUUUUUUBUBUUUUUUBBUUUBUUU
UBUUUUBUUUUUBUUUBUBUUUUBBUBUUUUBBBUBUUUBUBUUUUUUUUUUUUUBBUBUUUBUBUUUBUBUUUUUBUUUUBBBBUBUBBBBUUUBUUUUU
BUUUUUUBBUUBBUUUBBUUBBUBBUUUUUUBUUUUUUUBBBUBUUUUUUBUUUBUUUUBUBBBUUBUUUUUUBUBUBUUBBUUUBUBUUBUUUUUUUUUB
UUUBUUBUUUUUBBUUUBUUBUUUBBUUBBUUUUUUUBBBUUUUUUUUUUUUBUBUUUUUUUBUUBUUUBBUUBBBBBUUBUBUBBUUUUBUUUUUUUUUB
UUUUUUBUUUUBBUUUBUBUBBUUBBUUUUBUUUUUBUUUBUBUUBUUUBBBUUBBBUUUBUUUUUBUUBUBBUUBBBBUUUBBUUUUUUUUUUBUUUUBU
BBUBUUUUUUUUUUUBUBUUUUBUBBUUBUUUUBBUUUUUUUBUBBBUUUUUUUUUUBUBUUUUUUUUUBUUUUUUUUUUBBUUUUUUUUUUUUBUUBBBU
BBBUUBBUUUUBUUUUBUUBBUUUUBBUUUUBUBUBBUBUBUBBBUUUUUBUUUUUUBUUUUUUUUBUUBUBUUBUUUBUUUBUUBUUUUUUBUUUUUUUB
UBUUUBUBUBBUUBUBBUUBUUBUUUUUUBUUUBBBBUBUBUUUBUUBBUBUUUUUUUUBUUUUUUUUUUBBUBUUBUBUBUUUUUBUBUUUUBUUUBUUU
UUBUUUBBUUUUUUBUBUBUUBUUUBUBUUUBBUUUUUBUUUUUBBUBBUUUBBBBUBUBUBUUUUUUUUBBUUUUUBUBUUUUBUUUUUUBUUUUUUBUU
UBUUUUBBBBBUUUUUUUUUUUUBBUBUUUBUUBUUBBUUUUBBBUUUUUUUUUUUBUUUUUUUUUBUBUUUUBUUUUUUUBBUUBUUUBBBBUBBUBUUU
BUUBUUBUUUUUUUUUUUUUUUUUBBUUUUUUUUUUUUUBBUBUUBUBBUUUUBUBUBBBBBBUUBBUUUBBBUUUUUUUBUBUUUUBBUBUUUUBUUUUU
