UUUUUUBUUUBBBBBUBUUUUBUBUUUBUUBBUBBUUUUBUUUUBUUBUBBUUUUUUUUUUUBUBUUUUUBBBUUUBUUUUBBBUUUUUUUBUUBUUUUUB
UUUUUBUBUBBUUUUUBUBUUUUBUUUBUBUBBUUUUBUUBUUUUUUBUUUUBUBUUUUUUBUBBBUUUUBBUUBUUUUBBUBUUUUUBUBUBUUUUUUUU
UUBUUBBBBBUBUUBUUUBUUUBBBUUBUUUUBUUUUBUUUBBBUUUUUBBUBUUBUUBBUUUUUBBBUBUUUBUBUUUBBUBUUUUUUUBUUUUUBUUUU
UUUUBUUUUUUUBUUUUBBBUBUBUUUUUUUUBUUUUUUUUBBUUUUBUUUBUUBBUUUBUUUUBUUUBBUBUUUUBUUUUUBBUBUUBBUUUUUBUUUUU
UBBBUUUUBUUUUUUBUUUUUUBBUBBUUUBBUBBUUUUUUUUUBUUUUUBUUUUUBUBUBUUUBUBUBBBUBUBUUUUBUBUUBBUUUBBUUBUUUBBUU
UUBBUUBUUUBUUUBUUUUBBUUUUBBBUUUUUUBUUUUUUUUUUBBUBUBUUBUUBUUBUUUUUUUUUBBUUUUUUUUBUBBUUUUUUUUUBBUBUUBBU
BUUUUBUUBUBBUUUUUBUUUUBUUUUBUUUBUUUUUUBUUUUUUUUBBUUUUBUBUBUBBUUBUBBUUBUUUUBUUUUUBBUUBUBUBUBUUUUUUUUBB
BBUUUUUUBBUUBUUBUBUBBUUUBUBUUUUUUUUBUUUUBUUUUUBUBUBUUBBBUUUBUUBBUUUUUUBBBBUUUUUBUUBUUBBUBBUUUUBBUBUBB
BUBUBBUUUUUUUBUBUUUUUUUUUBUUBBUUUUUUUUBUBUUUBBBBUBUUUUUUBBUUUUUUUBUBUBUUUUUUUUUUUBBBUBBUUUUBBBUBUUBUU
UUUUUBUBUBUBBUUUUBUUUUBUUUUUBUUUBUUUBUBUUUUBBUUUUUUUUBBUBUUUBUUUBBUUUBBUBUUUUBUUBBUBUUBBUBBBUUUUUUUUU
BUBUUUUUUUUBUUBUBBUUBBUUBUUBBUUUUUUUBBBUUBUBBUUUUUBBBUUBBUUBUBBBBBBUUUUBUUUBBUUUBBBUUUBUUBUUUBBBUUUUU
UUBUUBUUBUUUUBUUBUBUUUUUUBUUUBUUUUBUUUBBBBUBBBBUUUUUUBUBUUUUBBBUUUBUBUUUUUUUUUBBUBUUUUUUUUBBUUUUBUUBU
UUUUUUUUUUUUUUUBUUBUUUUUUUUUUUUUUUUUUUBUUUBUBUUUUBBUUUUUBUUUUUBBUUBUUUUUUUUUUUUUUUBUBUUUUUUUUUBUUUUUU
UUUUUBUUBUUUBUUBBBUUUUUBBUUUUBUBUBUUUBUUUBUBBBBBBUBUBUBUBUBBBUBUUUUUUUUUUUBUBBUUBBUBUUUBUUUUUUUUUUBUB
UUUBBBBUUBBBUBBUUBUUUBUBUUBUUBBUBUUUBUUUBUUUUUUBUUUBUUUBBBUUUBBUBBUBUUUBUUUBUUUBUUUUBUUUUUUUUUUBUBUUU
BBUUUBUUBUUBUUUUUBBUUUBUBUUUUUUBUUUUUUBUBBUUUBBBBBUUUUBUUUBUUUUBUUUUUBBUUUUUUBBUUUBBUUUUUUUUUUUBUUBUU
UUUBUUUBUUUUUUUBUBUUBUUBUUBUUUBBUUUUUUBBUBBUUUBBBBUUBUUUUBUUBUUUUUUUUUUUUUBUUBUBUUUBUUUBBUUBBUBUUUBUU
UUBBUBUBBUUUUBUBBUUBUUUBUUUUUBUUUUUUUUBUUBUUBBUUUUUBUUUUUUUBBUUUUBUUUBUUUUUUUUUUUUUUUUUBUUBBUUUUUUUUB
BUBUUBUUUUBUUUUUBUUUUBBUUUUUUUUUUUUUUUUBBUUUUUUUUBUUBUUUBUBBUUUUUBUUUUUUBUUBUUUUUUUUUUUUBBUUBUUUUUUBU
BUUUUBUUUUBUUUUUUUUUUUUUUUUUUUUUUUUUUBUUBBBUUUUUUUUUUUUUBBBBUBBUBUUUUBBUUBUUBUUUUUBUUUBUUBUUBUUUUBUBB
UUUUUUBUUUBUUUUUUUBUUUBUBUUBUUUUUBBUBUUUUUBBUUUBBUUUBBUUBUUUUUUUBUUUUUUUBUUUUUBUUUBUUUUUBUUUBUUUUBUUB
UUUUBUUUUBBBUUBUUBUUUUUBUUUUUUUUUUUUUBUBBUUBUUUBBBUUBBUUUUBUBUUBUBBUUBBUBUUUBBUBBBBUBUUBBUBBBBUUUUUUU
UUUUUBUBBBUUUBUUUUUUUUUUUUUBUUBUUUUUUBBUUUUUUUUUUUUUUUUBUUUUUBBUUUUUBBUBUUUBUUBUBUUBUBUUBUUBBBBUBUUBU
UUUUBUBBUUUUUBBBBBUBUBBUBUUUUUBBUUUUUUUUBUUUUUBUUUUUUBUBBBUUBBBUBBUBUUUUUBUUUBUBUUBUBUUUUUUBUBUUUBUBU
UUBBUUUUUUBUUUUUUUUUBBBUUUUBBUUUBUUUBBUUUUUBUUUBBUBBUUUUUUUUUUUUUUBUUBUUUUUUBUUUBUBUBBBUUUBUUUUUUUUUU
UUUUUUUBUUUUUBUBBUUUBUUUBUUUUBUUBUUUUUUUUUUUUUUBBUBBUUBUUBBUBUUBUUUUUBUUUBUUUUUBUUUUUBBBUUUUUUBBUUUUB
UBBUBBUUUUBUUBBUUUUUUUUUUUBBBBUUUBUUUBUUUBUUUUUUUUUBUBUUUUUUUUUUUUBUBBUBUUUBBBUUBUUUBUUUUBUUUUUBUUUUU
UUUUBUUUUUBUBUBUUUUUUUUUUUUUUUUUUUUUBUUUBUUUBUUUBUUUUUBUUBUBUBUUUBUBBBUUUBUBUUUBUUUBUUUUBBUUUUBBUUBUU
UBBUUBBUUBUBBUUUBBBUBBUUBBUUUBBUUBUUBUUUUUUUUBUUUUUUBUBUUUBUUUBBBUUBUUUUBBBUBBUUUBUUBUUUBBUBBUUUUUUUU
UUUUUBBUUUUUBBBUBUUUBUUUUBUUUBBUUUUUUUUUUUUUUUUUBBUUUBUUBUUBUUUUUUUBUUUUUUUBUBUUUUBUUUUUUBBBBUBBUUUUU
UUUUUUUUBUBUUBUBUUUUUUBUUUUUUUBUUUUUBUBBUUUUBUBUBBBUUUUUBUBBUUUUBUUUBUUUUBUUUUUBUUUUBUUUUUUUUUUUUUBUU
UUUBBUUUBBUBUBUBBBBBUBUUUUBUBBBBUBBBUUUUUUUBUUUUUBUUBUUBUBUBBUUUUUBUBUUUBUUUUUUUUUBBUUUUUBUBUUUUUUUBU
BUUUBUBUUUBUUUUUBUUBUUBBUUUUUUUUUUBBUBBUUUBBUUBUUUUBUBUUUUBUUUUUBUUUUBUUUBUBUBBUUUUBBUBUBUUBBUBUUUUBB
BUUUBUBBBUBUUBUBUBBUUBUUBBBUBUUUUUBUUUBUBUUUBUUUBUBUBUBBUBUBBUBUUBBBUBUUUBUUUBBUUUUUUUUUBUBBUBUUBBUUB
UUBUBUUUBBUUUUUBBUBUUUUBBUUUUUUUBUUUBBUUUUUBUUBBUUUBUUUBBBUBUBUBUUBBUUUUUUBUUUUBUUUUUBUUBBBUBUUUUUUUB
BUUUBBBUUUUUUUUBUUUUUUBBUUUBBUUUUBUUUBBUUUBBUUUUUUUUBUBUUUUBBBBUBUBBUBUBUUUUUUUUUUUUUBBUUBUUUUUUUBBUU
UUUUUUUUUUUBUUBUBUBUUUUUUUUUUBUUBBUBBUBUBBUUBUUUBBUUBUUUUBBBUBBUUUBUUUBUBBBUBBUUUUUBBBUBUBUUUBUBUBUUU
BBBUUUUUUUUBUUUUUUUUUBUUBUBUUBUUUUBUBUUBBUBUUUUBBBBUBBUUBUUUBUUUUBUUUUBUUUUBUUBUBBUUUBUUUUUUUBUUUBUUB
UUBUUBUUUBUUBUUUUUUUBUUUUUUUUUUBUBUBUUUUBUBUUBBUUUUUUUUUUUUBUUUUUUBUBUBBBUUBUBUUUUBBUUUBUBBUBUBUUUUUU
BUUUBUBBBUUUUUBUUUBUUUUBUUUUUUUUBUUBUUBUUUUUUUUUUBUUUUUBBBUBUBUBBBBUUUBBUBBUUUUUBUBUUUBBUBUBBUUBUBBUU
BBBBBUUBUUUBBUUUUUUUUBBUUBUUUUBBUBUBUUUUUUUBBUUUUBUUUUUUBUBBUUUUUUUUUBUUBUUUUUUBUUUUUBUBUUUUUUBUUUBBU
UBUBUUUUUUUUBUUUBUUUUUUUUUUUUBUUUUUBUUBUUUUUUBUUUUUUUUUBUUUUBUBBBUUUUUUBBUUBUUUBUUUUBBBUUUBUUUUUUBUBU
BUBUUBUUUUBUUBUBUUUUBUBUBBBUUBUUUBUUUUUUUBUUBUUUUUUBBUUUUBUBBUUUUBUUUBUUUUUUBUUUBBBUUUBBUUUBBUUUUUBUU
BBBUUUUUUUUUBUBUBUUUUUUUUUUBBUBUUUUBUUUUUUUBBUUUUUUUUBUUUUBUBBBUUUUBUBBBBUUUBBUBBBUBUUBUUUBBBBBUUUUUB
UUUUUUUUUUUBUUUUUUUBBUBUUUUUBUUUUBUUBBUUBUBUUUUUUUUUBBUUUUBUBUUUUUBUBUUUBBUUUUUUBBBUUUBUUBUUUUUUUBBUU
UBUUUUUUUUUUUUBUUUUUBUUUBUUUUUUUUUUUUUUUBUUUBUUUUBBUUBBBBBUUBBUUUUBBUUUUUUUBUBUUBBUUUUUBBBBBUBUUUBUBU
UUUUUUUUBUUUUBBUBUUUUUUBUUUBUUUUBBUBUUBBUBUUUUBUUUUUBBBUUUBUUBUUUUUUUUUUBUUBUUBUBUUBUUUUUBUUBUUUUBBUB
UUUUUUBUUUBUUUUBUUUBUUBBBUUUUUBBUUUBUBUUUBUUBBUBUUBUUUUUUUUUUUUBBBUBUBBBBBUUUUBUUBBUUUBUUBUUUUBUUUUUB
UUUBUBBBUUUUUUUUUBUBUUUUUBUUBUBUUBUUUBUBUBUBUUBBUBUUUUUUUBBBUUBUBUBUBBUBBUBBBUBUUUUUUUUUUUUBBBUBUUUUB
UUUUBUBBUUUUUBUUBBUUUUBUUUUUUUUBUUUUBUBUBUUUUUBUUBUUUBUBUBUBBBUUUUUUUUUUUUUBUBUBUUUUUUUBUUUBBUUBUUBUU
UUBUUUUUUUBBUUBUUUBBUUUBBUUBUUUUBUUUUUUUBUUBUUUUBBUUUBUUUBBUUUUUUBBUBUUUUBUUUBUUUBBUBUUBBBUUUUUUUUBUU
UUBUUUUUUUUUBUUUUUUBBBUUUBBUBUUUUUUUBUUUUUUBUUUUUUUBUBUBUUBBUBUUUUUUUUUBUUUBBUUUBUUBBUUUUBUBBUUUUUUUU
BUUUBUBUUUUBUBUUUUUBUUBUUUBUBUUBBUUBUBUUUUBBUUUUUUUBUBBUUBUUUUBUUBUUUUUUUUBUUUUBUUUUUUUUUUBUBBBUUUUBB
BUBUUUBUUUUUUBUUBUBUUUUUUUUUBUBBUBUBUBUUBUUBUUUUUUUUUUBUUBUUUBUUUUUBBBUUUBBBBUUUUBUBBUUBUBUUBUUBBUUUU
UUBUUUUUBUBUBUUUBUUUBBUUUBUUBBBUBUUBUUUUUUUUBUUUUUUBBUBBBUBUUUUUBBUUUUUUBBUBBBBBBUUUUUUBBUUUBBBBUUUUU
UUUUBUUBUUBUUBBUUUUUUUUUUBUBUBBUBBUBUUBBBUUBUBBBUUBUBUUUUUUUBUUBUUBBBBUUUBUBUUUUUUUUUUBUUUUBUUUUUUUUU
BUUUUUUUUUBUBUUUBUUUUUUUUBBBUBBUUUUUUUUUUUUUUUUUUBUUUUBUUUUUUUBUUBBBUUUUUBBUUUUUUUUBUBUBUUBBUBUUUBBUB
UUBUBUUBBBUBUUBUBUBUUBBBUUUUBBUUUBUBUBUUUUUBUBBBUUBUUBUUUUUBUUUUUBBUUUUBBUUUBBBUUUUUBUBUUUUBUBUUUBUUU
UUBUUUBBUUUUBBUUBUBBUBUUUUUBUBUUUUBUUUUBBBBBUUBUUUUUUUUUUBUUUBUUUBUBUUUUUBUUUUBUUUUUBUBBUBUUUUUUBUUUU
BBBBUUUBUUUUBBBBUUUUBUUBUUUBUUUUUUUUUUUBUUUUBUUUUBUUUUUUUUUBBUUBUUUUUBUUUUUUUBUUBUUUBUUUBUBUUBBUBUBUB
BUUUUUUUUUUBUUUUUUUUUUBBUBBBUUBUUBBBBUUUUUUUUUUUBUUBUUUBBUUBBUUUUUBUUBBBUUUUUUBBUUUBBUBUBUBUUUUBUBUUU
BUUBUUBUUBBBBBUUUUUUBUBBBBBUBBUUBUUUBBUBUUUBBBUUUUUUUBUBBUUUUUUUBUBUBUUBUUBBUBBBUUBUUUUUUUUUUUUBBUBBU
UUUUUUUUUUUUUUUUUUUUUUUUUUUUUUBUUUUBUUBUUUBUUUBBBBUUUUUBUUBUUBUUBBBBUUUUBBUUUUUUUUBUUUUBUUUUUUBBUUUBU
UBUBBUUUBBUBBUBBUUUUUUUUUBUUUUBUBUBUBBBUUUBUUBUUUUBUUUUBBBBUBUUBUUUUBUBUUBUBBBUUUBUUUBUUUUBUUUBUUUUUU
UUUUUUUUBUUUUUUUUUBBUUBUBUUUBBUBUUUUUBBBUUUUUBUBBUUBUUUUBUUUBUUUUUUUUUUUBBUBUUUUUUUBUUUBUUUUUUUBUUUBU
UBUBUUBUBBUBUUUUUUUUUBUUUBBUUUBUUUUUUBUBUUUUUBUBUUUUUBUUUBUUUUBUUUUUBBBUUUUBUUUUBUUBUUBBUUUUBUBUBUUUB
BBUBUUUUUUUUUBUBUBUUUUUUUBUUBBUUUBUUUUBUUUUUUUBUUUUBBBBUUUUUUBUBUBUUUUUBBBUBBUBUUUUUUBUUUUBUUBUUUUUBU
UUUUBUUUUUBBBUBBBUUUBBBBBUUUUUBBUUBBBUUBUBUUBUUBUUUBUBBUUBUUUUUBUUBUUBBUUUUUUUUBBUUUUUBBBUUUBBUUUBBUB
UUUUBUBUUUUBUBBBUUUBUUUUUUBUUUUBBBUUUBUBUUBUUUUUUUBBUUUUUBUUUUBUBBUUBUBBUUUBUBBBUUUUUUBBBUBUBUUBUUBUU
BUUBBBBBUUUUUUUBUUUUUBBUUUUUBBBBBBUBUUUUBUBUUUUUUUUUBBUBUBUUBBUBUBBUBUUUUUBUUUUUUBBUBUUUUUUUBUBUBUUUU
UUUUUUUUUBUUUUUUUBUUUBUUUBUBUUUUUUBBBUBUBBBUBUUUUUUUBUUUUUUUBUUUUBUUUUUUBUBUUUUUUUUBUUUUBUUUUUBUUBUUU
BBUUBBUUBUUUUBUUUBUUBUBUUUBBBUBUUUBBUBUUUUUUBUUUUUUUUUBUUBBUUUUUUUBUUBUBBUBBBUBUUBBUBUBUUBUBUUUUUUUUB
BUUUUUUUBBUUBUUUUUBBUUUUUUUBBUUUUUUBBUUUUUUUBUBUBBUUBUBUBUBBUUUUUUBUBUUUBBUUUUUUBUUUUUUUBBBUUUUUUUUUU
UBUBBBBUUUUUUUUUUUBUUUBUBBUUUUUUUUUBUUBBUUBUBUUUUUUUUUUBBUBUBUUUUBBBUUBBUBUUUUUBUUUUBUBUBUUUUBUUUBBUU
UUUUUBUBBBBBBBBUUUBUUUUUUBUUBUUUUBUBUUBUUBUUUBBBBUBBUBUBBBBUUUBUUUBUUUUUBBUBUUUBUUBBBBUUUBUUBBUUUBBBU
UUBUUBUBBUUUBUUUUUUBUUBUUBBBBUUBUUBUBUUBUUUUUUUBUBBUUUUBBUBUUUBBUUUUBBBBUUUBUUUUUUBUUUUBUBUUBUUUUBUUU
UUBBBUUBUUUUUBBBUUUUUBUUUUUBUBUUUUBUUUUUUUUUUBBBUUUUBBUBUBUUBBUUUUUUBUUUBBUUUBUBUUBUBBUUUUBUUUUBUUUUB
UBUUUUBUUBBBUUUUBBBUUUBUUUUUBBUUUUUUBUUUBUBUUUBUUUBUUUUUUBUUBBUBUUUUBBBUBBUUBUUUUUUBUBUUUBUUUUUUBBUUU
UBUUUBUUUBUBUUBUUUUBUBUUUBBUBBUBBBBUBUUUUBUUUBUUBUUUUUUUBBBUBBBBUUBUUUBBBUUBUUBUUBUUUBUBUUUUUUUUUUUBU
UUUUUUBBUUBBBBUBUUUUUUUBUBUUUBUUUUUUUUUBBUUBBUUUUUUUUBUUBUUBBUUBBBUUUUBUUBUUUUUUUBBUUUUBUUUUUUBUUBBUU
UUUBBUUUBBBUUUBUBUUUBUUBUUUBUUBBBBBUBBBBUUBUBBBUUUUUUBUUUUUUBUBUUBUUUBUUBBUUUUBUUBUUUUBUBUUBUUUUUUUBU
BUBBUBBUUBUBBUBUBUBUUBUBUUUUBUUUUUUUBBUUUUBUBBBUUUUUUUUUUUUUBUUUBBBBUUUUBUBBUBUUUUBUUUUUUUUUUUUUUUBUU
UUUUUUUBUUBUUBBBUBUBBUUBBUUUUUUUBUUBUUUUUUBUBBUUBUUUBBUUUUBUBUUUUUUUUBUUUBUUBUUBUUUUUBBUUUUUBBBUUUUUB
UUBUUUUUUBUUUUBUBBUUUBUBUBUUUBUUUUUBUUUUUUUUUUUUUUUBUBBUUBUBUUBUUBBBUUBBUUBUUBUUUUUBBUUUUUUUUBBBBUBBU
UUUUUUUBBUBUBUUUBUBUBUBUUUUUUBUUUUUUUUBUUUUUUBUUBUBBUUBUUBUBUUBBUUBUUBUBUUUUUUUUUUUBUUUBUUUUBUBUBUUUU
UBBUUUUBBUUUUUUUUUUBBUUBUBUUUUUUBUBUUUUUBUUUUUUUUBBUBUUUUUUBUUUUUUUUUUUUBUBUUUUUUUUUUBUUBBBUBUUBUBUUU
UUUUUBUUBUUUBUUUUUUUUUUUUUUUBUBUUBUUUBUBUUUUUBUUUUUUUBUUBBUUUBUUUUUUBBBUUUUUUBUUUBUBUUUUBUUBUUUBUBUUU
UBUUBUBBUBUUUUUBUUBUUUBUBUUUUBUUUUBUUBUUBUUUBUBUUUUUUUBUUUUUUUBUUUBUUUUUUUUBBBBUBBUUUBUUBUBUUUBBBUUUU
UUUBUUUUUUUUUUUBBUUBUBUUUUBUUBUUUBBUUUUBUUBUUUUUUUUUUUBUUUUUUUUUBBUBUUUUUUBUUUUUBUUBUUBUUBBUBUBUBUBUU
BBBUUUBUUUBBUUUBUBBUUUUUUUUUUUUUUBUUUBUUUUUUBUUUUUBUBBBBBUUUUUUBUUUBUBUUUBUUUUBUUUUUUUBBUUUUUUBBBBBUB
BUUBUBUBBUUUBBUUUUUUUUUUBUUBUBBBBUBUBUUUUUBUBUUUUUBUUUUUBUUUBUBUUUUUUUUUUUUUUUUBBUUUUBUUUUUUUUUBUUUUU
UUUUBUUBBUUBBUBUBUBUUUBUUUUUUUUUUUUUUUUBUUUUUUUUUBUUUUBBBUUUUBBUUUUUUUUUBBUUUUUUBUBBBUUUUBUBUUUUUUBBU
UUUBUUBUUUBUUUUUBUBUUUBUUBBBUUUUUUBUUUUBBUUUUBUUUUUUUBUBBUUUBUBUUUUBUUUBBUUUUUUUUUUUUBUUUBBUBUUUUUBUU
BUUBUUUBUUBUUBBUUBUUUUUBBBUUUUUUUBBUUBUBUUUUUUBUBBUUUUBBBBUUUUUUUUUUBUUUUUBUUUUUUUUUUBBBUUUUUUUUUUUUB
UBUUUUBBUUBUUBUUUBBBUUBBUUUUUUUUBUBBBUBUUUUBBUUUUUBBBBBBUUBBBUUUUUUUUUBUUBUUUUUBBUBBBUUUUUUUUBUBBBUUU
UUUUUBUUUUUUUBBUUBUBBUUUUUUBUUUUUUUUBBUUUBUBUUUUUBBUBBUUUBBUUBUUUUUBUUUUUUUUUBUUBUUBBBBBUUUUUBUUBBUUB
BUUUUUUUUUUUUUBUBUUUBUBBBBUUUUUUUUBUBUBUUUUUUUBUUBUBUUUBUUBUUBBUUUBUUUBBUUBBUUUUUUUUUUUBBUUUUUBUUBUUB
BUUUUBUBUUUUBBBBBBUUBUUUUBBBUUBUUUBBUUBUUUUBUUUUBUBUUBUUUUUUUBUUUBUUUUUUUUBBUUBUUUBUUBBUUBUUUUUUUUBUU
BUUUUUBUBBUUUBUUBUBUBBBBUUUUUUUUUUBBUBUBUUUBUBUBUBBUBUUBBBUBBUUUUBUUUUBUUUUBBUUUUBUBBUUUBBUUUBUUBBUBU
UUBUUUUUUBUBUUUBUUBBBBUUUUBBBBUBUUUBUUUBBBUBBBUBBBUBUUBUBUUUUBUUUUBBBUUUBUUUBBUUUBUUUBUUBUUUUUUBUBUUU
UBBUUUUBUUBUUUUUBBUBUBBUBUBBBUUBUUUBUUBBBUBUBUUUUBUBUUUBBUUUBUUUUBUUBUUBUUUUUUBUBUUUBBUUUBUUUUUBUBBBU
