UUUUBBUUUUUUUUBUUUUUUBBUUUUUUUUUUUUBBUBUUBBUUUUBUBUUUUUBUBUUUUBBUUUUUBBUUUUUBBUUBUBUBBBUUUUBBUBUBUBBB
UUUUUUUUBBBUUBUUBUBUBUUUUUUUUUBUBBUUUUUUBUUUUUBUUBBUBUBUUUUBUUUUBUUUBUUUBUUUUUUUUBBUUUUUUBBUUUUUBUUBB
UBUUBBUBUBBUBBBUUUUBBUUUUUUUUUUBUUBUBUUBBBUUUBUUUUUUBUBUUBUUBUUUUUBBBBBUUUUUUUBUBUBUUUBUUUUBBBBUUUUBU
BUUUBUBBUUUUUBBUBUUUUUUBBBUUBUUUUBUBBBBUUBUUBUUUUBUUUBBBUUUUUUBBUUUBUUBUBBBUUUUUUBUUBBUUUUUBUBBUUUBUU
UBUUUUUUBUUUUUBBUUBUBUUBBUUUBUUUUUUUBUUUBBUUUBBUUBBBBUUUUUUBBUUUBUUUBUBUBUUUBBUUUUUUBBUUUBUBBUUUBUUUU
UBUUBBBUUUUBUUUUUBBUUBUUBUBUUBUBUUUBUUBUUUBBUBBUUUBUUUUBUUBBBBUBBUUUBUUBUBUBUUBBUUBBUBUUUUBUUBUUUUUBB
BUUUUUBUBBUBUUUUBUUBBUBBUBUUUUBUUBUBUUBBBBBUBBUUUBUUBUBBBBUUBUUUUUUBBUBUUUBUUUUUUUBUBBBUBUBUUBUUUUBUU
UUUBUBUBUBUUBUUUBUUUUUBBBUBBUBUUUBUUUBUBUUBUUUBBUBUUUUUBUUBUUBBBUUUUUUUUBUBUUUUBUUBUBUBUUUUUBUBBBUBUB
UUUUBUUUBBUBUUUUUBBUBUUUUUBUUUUBBBBUUUUBUUUUUUUBUUBUBUUUUUBBUUUBUUUUUUBBBUUUUUUUUBUBUBBBUBUUUUUBBUUBB
BBBBUUUUUUBUUUBUBUUUBUUUBBUUBBBUBUUBUUUUUUUUUUUUUBUUBUUBBUBUUUUBBBUBUUUBUBUUUUUUUUUUUUBUUUUUUUUUUBUUB
BBBUUBUUUUUUUUBUUBUUUUUBUBBUUUUUUUUBUUUUBBUUUUBUBUUUBUUUUBUUUBUUUBUUUUUUBUUUUUUUUUBBUUUUUUUUUUUBUBBBU
UBUUUUUUBBBUUUUUUUUUUUUUUUUBBUBUUBUBUUUUUBBBUBUUBBBUUUBBUUBUBBUUBUBUUBUUUBUBUBBBUUBUBUUUUBUUBUUUUUUUU
BUUBUBUUBUBBUUBUUUUBBUBUBUBUUUBUUUUBBBBUUUUUUUBUUBUBBUBBUUBUUUBBUUUBBUUUUBUBUUBUUUUUUUUUUBUUBBBBBBUUU
BUBBUUUUUUUUUBUUBUUUUBUUBUUBUUUUBBUUUUBUUUUUBUUUUUUUUUUUUUUBUBBUBBBUBBUUUUUUUUUUBUUUUBUBUUUBUUBUUUBUU
UUBUUBBBUUUUUUUBUUBUBBUUUBBUUBUUUUUUBBUBUUUBUUBUBUUBUUBBBBUBUUUUBBUUUUBBUUBUUUBUUBBUBUUUUUBBUUBUBUUUB
UUUBUUBUBUUBUBUUUBUUUUUUUBUUUBUUBUBUUUUUUUBUUUBBUUBBUUUUBBUBUUBUUUUBUBUUUUUUUBUBUUUUUBUUUUUUUUUUBUBUU
BUUUBBBUUUBUUUUUUBUUUUBUUUUUUUBBUUUUUUUUUUUUBUUBUUBBBUBUBUUUUUBUBUUUBUUUUUBUUBUBBUUUUUUUUUBUUUUBUUUUU
BUUUBUUUUUUBUUUUBUBBUUUUUUUBBUUUUBUUBBUUBBUUUBUUBUBBBUUUBUUBBUUUBUUBUUUUUUUBUUUBUUUBUUUUUUBUUUUBBUUBU
UBBBUUUUUBBUUUUBUUBUUBUUUUUUUUUUUBUUUUUUUBUBUBBUBUUUUUUUUBBBUUUUUBUUUUUBUBBUUUBUUUBUBUUUUUUBUBUUUUBBB
UUUUBUBUUBUUUUBUBUUUBUUBBUUUUUUBUUUUBUUBBUBBUUUUUUUBUUUUUUUBUUUUUUUUUUUBUUUUUUUUUBUBUBUUUUUUBUBUUUUBU
UUUUBUUUUBUUBUUBUBUBUUUBUUBUBUUUUUUUBUUUUUUUUUUUUUUUUUUUUUBUUBUUUBBBUUUBBUUUUUUBUUBBUUUUUUUUUUBBUBBUU
UUUUUBUUUUUUUUBUUUUUUUBBUUUUUBBUUUBUUUBUUUUUUUBBUUBBBBUUBBUBUUUUUUUBUUBUUBUUUUUUUBUBUUUBUUUUUBBUUBUUU
BBBUUUBBUBUUUBUUUUUBUUBUUUUUBUBBUUUUUBUUUUUUUUUUUUUUUUUBUUBUUUUUBUUUUUBUUUUUBUUUBUUBUUBBUUBUUBUUUUUUU
BUUUUBUUBUBUUBBUUUUUUBBUUUBUBUUUBUUUUBUUBUUBUUUUUUUUBBUUBUBBUUUUBBUBUBBUBUUUUUBUUBUBUUUBUUBUUBUUBBBUU
BUUUUBUUUUUUBUUUBUUUUUBUUBUUBUBUUBBUUBUUUUUUUUUUUBBUBUUUUUUUUBBBUUUUUUUBUBUUUUUBBBUUUBUUUUUUBUBUBUBUU
UUUUUBUBBUUUUUBBUBBUUUUBUBUUUUUUUUBUUUUUUUUBUUUUUBUUUBUUUUUUUUUBUUBUBBBBUUUBUBUBUUUUBUBUUUBUBBUUUUUUB
BUUBBBUUUUUUBUUBUUBBUUBUBUUBUUUUBUBUUUUUUUUBUBUUUUUBUUUUUBBUBUUBBUUUBUUUUBUUUUUUUBUUBUUUUBUUUUBUUBUUB
UBBBBBUUUBBBBUUBUUBUUUUUBUUUUUUUBBBBBBUBUUBBUBBBUBUUBUBUUUUBUUUBUBUUUBBUBUUUBUUUUUUUUUUUUUUBUUUBBBUUU
UBUUBUUBUUUUBBUUUBUBBUUBUBUUUUBUBBUUUUUUUBBUUBUUBUBUUUUBUUUBUUUUBUBBBUUUBUUUUUUUBUUBUBUBUUUUUUUUBBBUU
UBBUUBUUBBUBUUUUUBBBUBBUUBUUUBUUUUBBUBUUUUBUUUUUBBUUUUUBUBUBUBBBUUUBUBUUUUUUUUUUBBBUUUUBUBUBUUUBBBUBU
UBUBUUUUBUUUUUBBUUUBUUUBBBUUUUUUBUUUUUBUUBBUUUBBUBUUUUUUUUBUUBBBBUBBUUBBUBBUBUUUUUUUUBUUBUUUUBBUUBUUU
UBBBUUBBUBUUUUUUUUUBUUUBUUUUBUBBUUBUUBUUBUUUUUUUBUUBUUBUBBUUUBBBUUBBUUUBBUUUBUBBUUUBUUUUUBUUUBUUUBUUU
UUUBBUUUUUUUBUUBBUBUBUUUUUUUUUUUUUUBBUUUUBUUBUUUUUUBUUBUUBUUBUUUUBUUUUUUBBBUBUUBUUUUBUUUBBUUBBUBBUBUU
UUUUBUUUUBUUUUUBBBUUUUUBBUUUUUUUUUUUUBUUUBUBUUUUBUUBUBUUUUUUUUUBUBUBUBUBUUBUUUUBBUUUUUUBUUUUUUUUBUUUU
BBUUBBUUUUUUUUUBBBUUBUBBBUUUBUBBUBUUUUUUUUUBUBUBUUUUBUUUUUBBUBUUUBUUUUUBBUUUUUUBUUBUBUBBBUUBBUUUUUUBU
UBBUUUUBUUUBUUBUUUBUBBBUUBUBUBBBUUUBBUUUUUUUBUUBUUBUUUUUUUBUUBUBBUUBBUUUUBBUUUUUUUUBBBBBUUUBBUUBUUUBU
UUUUBUBUUUUUUUBUUBBUUUBBUUUUUBBUUBUUUUUUUUBUUUUUUUBUUBBUUUUUUUUUUUUUUUUBUUUUUUBUBBUBUBBUUUUUUUUUBUBBB
BUUUUUBUUUBUUUUUUBBUUUUUUUBUUUUUUUBUUBUUUBBUUBBUBBUBUUUBBUUUUUUUBBBUUUUBUBUUUUUBUUBUBBUUBUUBUUBUUUBUU
UBUUUBBUBUBUUUBUUUUBUBUBUUUUBUUUUUUBUBUBUUUUUUUUUUBUUUUBUUUBBUUUBUUUBUBBUBUUUUUUUBUUUUBBBUUUUBBBUUUUU
UUUUUUBBUUUBBUBUBUBUBBBUUUBBBBBUUBUUBUBBBUBUBBUUBBUUUBUBUUBBUBUUBBBUBBUUUBUBBUUBBUUUUUUUUBUUUUUBBUUUB
UUBBUUUUUUUUBUUUUUUUUUUUUUUUUUBUUUUUUUUBUUBBUBUBUUUUBBUUUUBUUUBUBUUUBUUBUUBUUUBUBBUBUUUUUUUBUUUBBUBBU
BUUBUUBBUUBBUBUUBUBUUUUUUUBUUUUUUUUBBBUUUBUUBUBBBUUUUBBBBBBUUUUBUBBUBUUUUUUBUUUBBUBUUBUUUUUBBUUUBUBUU
UUUBUUUUUBUBUUUUUUUBBUUUUUUUBUBUUUUUUBBUUUUBUUUUUUBUUUBUUBUUUUUUBBUUUUBUUUBUUUBUBBUUUBUUUBBUBBUBBUUUB
UUBBUUUBUBUUBUBUBBBUBBUUUUUBUBBUBUBUUBUUUBUUUUUUBUUUUUBBUUUUUUBUUBUBBUBBBUUUBBUUUUBUBUBUUUUUUUBBUUUUB
UUBUBBUBUUBUUUUUBUUBUUUUUBBBBBBBBUBUUBBUUBUBUUUUBUUBUUUUBUUUUBUUUBBUUUUUUBUBUUUUUUUUBUBBUUUBUUUUBUUBB
UBUUUBBUUBBUBUUUUUUUUUUUUUBUBBUBUBBUUUBUUUUUBUUBUBUUUBUUUUUUBUUUUUBUBUUUBUBBUBUBUUUBUUUBUUUBBUUUUUUBU
BBUUUBUUUBUUUUBBUUUBUBUUUUUUUBBBBBUUUUBUUBUUUBUBUUUUUUUUBBUUBUUBUUBBBUUUUBUUUUUUUBBBUUUBUUBUUUUUUUUUU
UBUBBUUUUUUUUUBUUUUUUBBUBBBUUBBUUBUUUUUUBUUBUBBUUBUUUUUUUUBUUUBBUUBBUUUUBUUUBUUUUUBUUUUUUBBUBBUUUBUBB
BUUUUUBUUUUUBUUUBUUUUUUUUUUUBBBUUUUUUUBBUUUUBUUUUUUBUUUBUBUUUUBUUUBBUUBUUBBBUUUUUBUUUUUBBUBBBBUUBUUBB
BBUUUUUUBUUBUUUBUUUBUBUUUBUUUBBUBUBUUUBUBUUUUUUUUBUUUUUUUBUBUUUBUUUUBBBBUBUBUUBUBUUBBUUUUUBUUUBBUUUUU
UUBUBUUUBUUUUBBBUUUUBUUBUUBBUUBUBUUBBUUUUUUBBUBUUUUUBUUBUBUUUUUUUUUUUUUUUBUUBUBUUUUUUUUUUUBUUUUUUBUBU
BUUBUUUUUBUUUUUUUUUUUBUUUUBUUUUBUBBBUUBUBUUUUUUUUUBBBUBBBUUUUUUUBBUUUUBBUUUBUBUUUUUUUUUUBBUUUBUBUUUBU
UUUUUUBBUUUUUUBBBUUUUBBUUUBBUBBBUBBUBUUUUUBUBBUBUUUBUBUUUUUUUUUBUUBUUBUUBBBUBUUUBUBUUBBBUBUBBUUUUUUBU
UUUUUUUUUBUUBUUUUUBBBBUUUUUUUUBBBBUUUUUUUUBUUBBBUUUUUBUBUUUUBUBUUUBUBBBBUUUUUUBUUUUUUUUUBUUBUUBUUUUUU
UUUUBBUBUBUUUUUUUUUUBUUUBUUUUUUUUBUBUUUBUBUUBUUUUUUUUUUUUUUUUBUBBUUUUUBBUUBUUUBUUUUUBBUUBUUUUBUUBUUUB
UBUUBUUUUBUUBUBUUUUUBUUUBBBUUUUUUUUUUUBUUUBUUUBBUUUUUBBUUUUBUUBUUUUBUUBUBUUUUUBUUUUUUUBUBUBBUBBUBUUUB
UUBUBUUBUBUUUUUBBBUUUBBUUBBUBUUUUUBUBUBUBBUUUUBUUUUUUUUUUBBBUBUUBBUUUUUBUBUBUUUBBUUBBUUUUUUUUUUUBUUUU
UBUUBBUUUBUUUBUBUUUUUUUUBBUUUUUBUUUUUUUUUUBBUUUUUUUUUUBBUBUUUBUUUUBUUUUUUBBUUUUBUUUUUUUUUBBUUUUUUBUUU
BUUUBUUUBUUUBBBBBUBUBBUUUUBBUUUBUBUBUBUUUUBUUUBBUUUUUUBBBUUUBUUUUUBBUUBBUBUUBUUUUUUUBUBUUBUBUUBBUBUBU
BUUBUUBBUUBUUBUUUUBUUBUUUBUUUUBUUUUBUUUUUUUBUBUBUBUUBBUBBUUBBUUUBBUUUBBUUUUUUUBUUUUUUUUUBUUBUUUUUBUUU
UUUUUUUBUUUBBBBUBUBUUBUUBUUBBUUBUUUUUUUBUBUBUUUUUBBUUUUUUBUBUUBUBUBBBBBUUBUUBUBUUBUUUBUUUUBUBUBUUUUUU
UUUUUUUBUBUUUUUUBUUBBBBUBBBUBBBUUBBBUUBUBBUUUUUUUUBUUBBUBUUUUUUUUUBUUUUUBBUUUUUUUBBUUUBBUUUBBBBUUUUUB
BUUUUBUBUUUUUUUBUBUUUUBUUBUUBBUUUUBBUBUUUUUBUUBUUUBUUUUBUBBUBUBUUUUUUUUBBUUUBUBUBUBUUUUUBUUBBUBUUUUUU
UUBUBBUBUBUUBBUBUBBUBUUUUUUUBUBUUUBUBBUUBUUUBBUUBUBUUBBBUBBBUUUUBUUUUUUUBUUUUUBBUBBUUUBUUUUUUUUUBUBUU
UBBUBBBUUBUBBUUBUUUUUUUBBUUBUBBBUUUUUUBUBUUUUBUUUUUUBUUUUUUUUBBUUUUUBUUBBUUUUBBUUUUBUBUUUBUBUUUBBUUUU
BUUUUUBBUUUBBUUUBUBBBUUUBUUUBBUBUBBUBBUBUUUBUUUUUUBUBUUUUUUBUUUBUUUBBUUBUUUUUBUUUUUUUUUUBUUBUUBUUBUBU
BBUUUUBUUBUUBUBUBUUUUUUUUUBUUUUBBUUUUUUUUUBUBUBUBUUUBBUUUUUUUUUUBBBBBUUUBUBUBUUBUUBUUUUUUUUUUBBUBUUUB
UUBUUUUBBUUBUUUUBUUUUUUUUUUUUBUUBBBBUBBUUUBUBBUUBUUUBUUBBUUUUUUUUUUUUBUUUUBUUUUBBBBUUUUUBUUBUBBUUBUUB
UBUBBUUUUUUUUBUBUUUUBUBUUUUBUBBUUUBBUUUUUUBBUUUUBUBUUUBBBUUUUUBUBUUUUUUBBUUUBUUUUBBUUUUUUUBUUUUUUBUUU
UUBUBUUUUUBUUUBUUUUBBUUBBBBBUUUBUUUUUBUUUUUUUUUBUUBUUUUUBUBUUBUUUUBUUUUUBUUUUUBUUBUBUBUUUUUUUUUBUUBBU
BBBUBUUUBUUUUBBUBUUUBBBBUBUUUUBUBUUBUUUUUUUBUBUUUUUUBBUUUBUUUBUUUUUUUUBBUBBUBUUBUUUBUUUBBUUUUUUUUUBUB
BBUUUUUBUUUUBUUUUBUUUBUBUUBUBUUUUUUUBBUBBUBBUBUUBBUUUUBBBUUUBUUUBUBUBUUUBUBUUUUBBUUBUUUUBBUUBUBUBUUBU
UUUUBUUBUUBUBUBUBUBUBBBBUBBUUBUBUBUBBUBUUBUUBBUUUUUUBBUUUUUUUUUUUUBBUUUBBUUBUUUUBUUBUBUBUUUUUUBUUUUBU
UUUUBUUBUUBUBUBBUUBUUUUBUBUBUBUUUUUBUUUUUUUUUUBUBUUBBUBUBUBUBBUUBUUUBUUBUUUUUUUBUUUUBBUUUBUUBUUBUBUUB
UUUUUUBUUUUUBUBUUUUUUUUUBUBBBUUBUUUBUUUBBUBUUUUUBUUUUUUUUBUUUUUBUBUUBUUBUUBBBUUBBUUUUUBBUUUUUBBBBUBUU
UUUUUUUUUUBUUUUUUUUBUBBUUUUUBUUBUBUBUUBUUBUBBBUUBUBUUUUBBBUUUUBBUUBUUUUBBUBUUUBBBUBUUUUUBUBUUUBUUUUBB
BBBUUBUUUBUBBUUBUUBUUUUUUUUUUUUUBBUUUUBBUUUUUBUUUBUUUUBUBUUUUBUUUBBBUUUUUBUUBUUBBUUUUUBUBBUUUUUUUUBBU
UUUBUUBUUBBUUUUUUBUUUUUUBBBUUBUBBUBBBBUUBUUBUUUBBUBUBUBBUUBUUUUBUUBUUUBUUBBBUUUBUUBUBBUUUBBBUUUUUUUUB
BBBBUUUUBUUUUUUBUUBBUUUUUBUBUUUBBUBBBBUBUUUBUUBBUUUBBUUUUUUUUBUUUUBUUUUUUUUBUUUUUUUUUBBBBUUUBUUUUUUUB
UUBUUUUUUBUUUUUBUUBUUUUUBBUBUUUBBUUUBUUBUUBBUUUUUUUUBUUUUBUUUBBBUBUUUBBUBUUBUUBBBUUBBUUUUUBUUBUUBUBBU
BUUUBUUUBUUUUUUUBUUBUBUBUBUUUBUUUBUUUUUUUUUUUUUBUUUUUUBUUUBUUUUUUUUUBUBUUUUUBUBUUUUUUUBUBUUUUUUBUBUUB
BUUBUUUBUUBUUUBUUBUUUUUUUUUUUUUUUUBUUUUBUUUUUUUUBUUBBBUBUBUBUBUUBUBUBUUUBUUBBUUBBUUUBUBBBBUUBUUUUUUUU
UUUUUBUBUBBBUUUUBUBUUUUUUUUUUUUUBBUUUBUBBBUBUUUBBBBUUUUBUUUUUUUBUUUUUUUUUUBUUBUUUUUUBUBUUUUUUUUUUUBUB
BUBBUBUBUUUUBUUBUBBUBUUUUBUBUUUBUBUBUUUBUUBBUBUUUBBUUBBUUUUBUBBUBUUUBBUUUBUBUBUUUUBUUBUUUUUUBUUBBUUUB
UUBUBUUUUBUBUUUUBBUUUUUUUBBUUBBBBBBUUUUUUUBUUUBUUBUUUUUUUUBBBUUUUBUBUBBUUUBUUBUUUUUUUUUUUUBBBUUBUUBBU
UUUUUUUBUUBUUUBUUUBUUUBUUUUUUBBUBBUBUBUUBUUBUUUBBUBBBUUBUUUUUUUBBUUUBUUUUBBBUBUUBUUBUBUBUUUBUUUUUBUBU
BBUBUUUBUBBUUUUUBBUBUUBBUUUUBUUBUUUBUUUUUBBUUUBBUUBUUBBUUUUUUBUBUBUBUUUUUBUUBBUUUUUUUBBBUUUUUBUUUUBBU
UUUUUBUUUUBUBUUUBUBBBBBUUUUBUBBBBUUUUUUUUUUUUBUBUUUUBUUUUUBUUBBBUBUUBUUUUUUUUUBUUUUBBUUBUUUUBUBUUUBUU
BBUUUUBUUUUBUBUBUBBUUUUUBUUBUUUUUUBBBUBUBUBBBUBUUUUUUUUBUUBBUUUUUUBUUBBBUUBBUUUUUBUUUBUUBUUBBUBUBUUUB
UBBBUBUUUUBBBUUUUUUUBUUUBUUBUUUBUUUUUUUBBUBUBBUUBBUBUBUUUBUUUUBBUUUUUUUUUUBUBUUUUUUBUUUUBUUUBUUBBUUBU
BUUBUUBUUUUUUBUUBUBUUUUUUBBBUUUUUUBUUBUBBBUUUUBUBUUUBBUUUUBUUUUUBUBUUUUUUUUUBBBUBBUBUUUUUBUUUUUBUBUUU
BUBUUBUUUUUBBBUUBUUUUBBUUUUUUUBBUUBUBBUUUUBBUBUUUUUUUUBUUBUUBBBUBUBBUBUBUUUUUUUUUUUUBUBUBBUUUUUBUUUUB
BUUUUUUBUBUUUUUUUBUUUUUUUUUUUBUUBUUBUUUUUBUUBUUUUBBBUBUUUBBUUUUBUUBUUUUUBUBUUUUUBUUBUUUBBUUUUUUBBUUUU
UBUUUUUUBUUUUBUUBUUBBUBUUUBUUBUUBBUUBUBBUBBUUUUUUUUUUUUBUUUBUUUUUUUUBBUBUBUUUBBBUUUUUUBBUBUUBUUBUBUUU
BUBUBUUBBUBBUBUUUUUBUUUBUUUUUBBUBUUUUBUUUUBBBUUUUUUUUUUUUUBBUUBBUUUUUBBBBBUUUUUUUBBUUBUUBUBUBUBUUBUUU
BUBBUUUBUUUUUUUUBUBUUUUUUUUBUBUUUUUUUUBUUBUUBUUUUUUBUUBUUUUBUUUUUUUUUUUBUUUUBBUUUUUUUBUUUUUUUUUUUBUUU
BUUUUUUUUUUUUBUUBUBUUUBUBUUBUUUUBBUBUUUUUUUBUUBUBBUUUUUUUUBUBBUBUUUUUUBUBBUUUUBBBUUUUUBUUUUUUUUUUUUUB
UUUUBUUUUUUUUUUUUUBUBBBUBBUUBUUBBUUBUBUUBUBUUBUUUUUUUBUUBUUUBUUUUUUUBBUUBUUUBUBUUUBUUUBUUUUBUUUUUUUUB
BBBBUUUBUBUBUUUUUBUUUUUUUUUUUBUBBUUUBBBBUUBUUUUBUBUUUUUUUBBUUBUUUUUUUBBUUUUBUUUBUUUUUUBUUUUUUUUUUBUUU
UUUUUUUUUBBUBUBUBBUUUUUUUUBUUUUUBUUUBUUUUUBUUUBBUBBBUUBUUUUUUUUBUBBUBUBUUUUUUUUUUUBBUUUBUBUBBUUUUBUUU
UUUUBUBUUUBUUBUUUBUUUUBUBUBUUBBUBBUUBUUBBUUBUUUBBBUUUUUUUUBUUUUUUBUUUUUUUUUUUBBUUUUBUUBUUUUUBBUBBUBUU
