UUUBBUUUUUUBUUUUUUBUBUUUUUUUUUUUBBBUBUUUBUBUUBUUBUUUUBBUUUBBUUUUBUUBUBUUUBUUUBUUUUBUBUUUUUUUUBUBUUUBB
UUBBUUUBBUBUBUUUBUUUUUUBUBUUUBUUUBUUBUBUBUBBUUUUUBUBUBUBUUBUUUUUUBUUUUBUUBUUBUUUUUUUUUUBUBUUUUUUBUUBU
UBUUUBUUBUUUBUBBBBUUBUBUUUUUUBUUUUUUUUBUBUBBUUBUUUBUUBUBUUUUUUUBUUUUUUBBUBUBUUUBUUUUUBBUUUUBUBUBUUUBU
UUUBUUUUBUBBUUUUUBUUUBUUUUUUBUUUUBBBUUUBUBUUUUUUUUUUUBUBUBBUUUBUUUBBBUUUUUBUUUBUUUBBUUUBUBBBUBUBUBUUU
BUBUUUUBUUUBBBBUUUBBUUUUUBUBUUUUUUUUUUBUUUUBUUBUUUUUUUUUUUUBUUUBUUUBBUUUUUUUBBUBUBUUBUUUUUUBUUBUUUUUU
UUBUUUUUBBUUUUBUUBUBUBUUBUUBBUUUBBUBUBUBUUUUUUBUBUBUUUUBUBUBUUUUUUUBUUUUUUUUUUUUBUBUUUUUUBUUUUUUUUUUB
BBUUBUUUBBBUUBUUBUUUUUBUUBUBUUUBBUBBBBUBBBUUUBBUUUBUUUUUUBUUBUUUUBUUBBUUBBUUBUBUUUBUUUUUUUUUUBUUUBUUU
UUBBUBBUUUBBUBBUUBBBUBUBUBUBUUBUUBUBUUUUUBUUUUUUUUUBBUUUBUUUBUBUBUBBUUUUUUUBUUUUUUUBBUBUUBBUUUUUBUUUU
UUUBBUBUUUUBUUUUBBUUUUBUUUUUBBUUUBUBBUUUUUBUUUUUUUBUUUBUUUUUUUUBUUUUUUBUUUUUUUUUUUUUBUBBUUUUUUUBUBBUB
UUUUUUUBUUBUBBUBUBBUUUUBUBUUUUUUUBBBUUBUUUUBUUUBUUUUUUBUUUUUUBUBUUBUUUBUUBUUBUUUBBUBUUUUUUUUUBUBUUUUB
BBBBUUUBBUUUUBUUUUUBUUUBUUBBBBUUBBBBBUUUUUBUUBUUUUUUBBBBUUBUUUUUUBUUUUBUUUBUUUUBUBBUUUBUBUUUUBBBUUUUU
BUUBBUUUUBUBUUBUBUUBUUBBBUUUUUUUUUUUUBBUUUUUBUUUUUBUBBUBUUUUUUBUUUUUBBUUUUBUBUUBUUBUUBUUUUBBBBUUUUUUU
BUUUBUUUUBBUUUBUUBUUUUUBUUUUUUUUUUUUBBBUBBBBUUUBUUUBUUBBUUUUUBUUBBBUUBUBUUUUUBUUBUUBUBUUUBUUUUUUUBBUU
UUUUUUBBUUUUUUBUUBUBUBBBBUUUBUUUBUBUUBUUUBUBBUUUUUUBBUUBUUUUBBBUUUUUBBBUUUBUUBBUUUUUUBUBUBUUBUUUUBBUB
BUUUUBUUBUUUUUBBUBBUBUBUUUUUUBUUUBUUUUUUUUUUUUBBUUUUUUUUUUBUUBUUUUBUBUBBBUBBBUUUUUBUUBUUBBUUUBBBUBUBU
UUUBUBBBBBBUUBBUUUUBUUUUBBBUBUBUBUUUUBUUUUUUBBBUUUBUUUBBUUUUUBUBBUUBBUUUBBUUBUBBUUUUBBBUUUUUBBUUUBUUU
UUUUUBBUUUUUUBUUUUUUUBUUUUUBUUUBUUUUBUUUUUBUUUUBBBUUUBBUUUUUUBUUUBBUUUBBUUUUUUBUBUUUUBBBUUUUUUUUUBUBU
UBBBBBUUUUUUUUUUUUUUUUBUUUUUBUBBBBBUBUUUUUBUBUUUBBUUUUBUUUBUBUUBUUUUUUUBUUUUUBUBUUUUUBBUUUUUBUUBUUUUB
BUUUUBUUBBUUBUUBBUUUBUUUUUBUUUUUUUUUUUBBBUUUBUUUBUUUUBUUUUUUUUUBUUBUUUUBBUUUUUBBBUUUUUUUBBUUUBUUUUUUU
UBUUUUBUUUBUUBUUUBBUUUUBUUUUUUUUUUUBBBUBUUUUBUUBUUUUUUUBUBUUBUUUBUBUUUUUUUBUBBBUUUUUUUBUUUUBBBUUBBUUB
BUBBUUUUUBBUUUUBUUUBUUBBUUUUUUUUBUBUBBUUUUUUBUUBUUBUUBUUUBUUBUUBUUBUUBUBUUUBBBUUUBBBUBUBUBUUUUBBBUBUB
UBUUUBBUUUUUUUBUUBUUUBUBBUUUUUBUBBUBUBUUUUUBUUUUBUUUUUUBUBUUBUUUUUBUUUUUUBUUBBBUUBBUBBUBUBUUUBUUBUUUU
UUUBUUUUUBUUUUUUUUUUUUUUUUUUBUUUUBUUUBUBUBUUBUUUBUBBBBUUBUUBBUBBBUBUUUBUUUBUBUBUBUUBUUBBUUUUUBUUUUUBU
UUBUUBUBBBBBUUUBUUUUBUUUUUUUUUUUUUUUUUUUUBUBUUUUUBUUUUUBBUUUUUBUBBBBUUBBUUUUUBUUUUUBUUBBUUUUBUUUUUUBB
UBUUBUBUUBBUBUUUUUUUBUUBUUBBBUUBUUUUBUBUBBUUUUUBUUUUUUBUUBBUUUBUBUUUUBUUUBBUUUUUUBUUUBUBUUUUUUUUUUUUU
BBBBBBUUBUBUUBUUUBUUUUUUUBUUUUBUUUUBUUUUUBUUUUBUBUUUUBUUUUUUUBBBBUUUUBUUUBBUUUBUUUUBUUUBUUUUUUBBUUUUU
UBUUUUUUUUUUUBUUUUBUUUBBBUBUBBUUUUBUUUUUUBUUUBUUBBUBUUUUUBBUUUUUUUUUUUUBBUUBBBBUUBUUBBUUUBUUUBBUUUUUB
BBUBUUUUUUUUUUBUBUBUUBBBUUBUUUUUUBUUUUUBUUUBUBBBBUUBUUUUUBUUUUUUUUBUBUUUBUUUBUUUUUBUBUBUUBBUUUUBBBUUB
UUUUBUUUBUUBUUBBUUUUUBBUBUBBUBUUBBUUUBBUUUBUBUUUUBBUBUBUUBUBUBBBUUBBUUUUBUUBUUUUUUUBUUUUUBUBUBUUUUBUB
UUUUUUUUBBUUUUUBUBBBBUUBUBUBBUBUUUUUBUUUBBUBBUUUBUBUUUUUUUBUBUUUUUBUUBUUBUUUUUUUUUUUUUBUUBUUUBUBUUUUU
UBUBUUUUBUUUBBUBUBBBBUUUUUUUBBBUBUBUBBBBBUBBUUUUUUUUUUUUUUBUBUUUBUUUBUUUUUUUBUUUUUBBUBUUUUUUBUUUBUUUB
UUBUBUBUUUBUBUUBUUUUUBUUUUUBUUUBUBUBBBBBUBUUBUUUUUUBBBBBBUBUUUBBBUUBUUUBUUBUUUUUUUUUUUUBUBUUBUUBUUUUB
UUBUUUUUUUBUUUBBBUBUUBBUUBUBUUBUUBUUUUUUBUUUUUUBUUBUBUUBUBUUUUBUUUUBUUBBBUUBBUBBBUBBBUBUUBUUUUBUUUUUU
UBUUBUBUUUBBBBUUUUUUBBUUUUUUUBBUUBBUUUUUUBUUUUUUUBUUBUUUUUBUUUUBBUBUUUBUUUBUUBUBUUBBUUUBBUUBBUBUUBUBU
UUUUBUUBUUBBUUUUUBUUBBUUUUBUBUUUUUUUBUUBBUBBUBBBBBUUUUUUBBBUUUUUBUUUBBUBBUUUUUUUUUBUUUUUUUUUBUBUUUUUU
BUUUUUUUBUBBBBUUUUUUUUBUUUUUUBBBUBBUUUBUBBUUUBUBUUUUBBUUUBUBUUUUUUBUUUBBUBBBUUUUBUUUBUUUUUBUUUBBBUBBU
UUUUBBUUUUUBUUUBUBUUUUUUUUBUUUUUUUUUBUUBUBUUUUBUBUUBUBUUUBUBUUBBBUBUBBBBUUUUUBBUUBUUUUUUUUUUUUUUUUUBU
UUUUUUBUUBBUBUUUUUUBUUBUBUUUBUUUBUUUUUUBUUUBBUUUUBUUUUUUUUUUUBBUUUUUUUBUBUUBUUUUUUUUBBUUUUUUBUUUBUUUB
UBUBUUUUUUUUUUUBBUBBUUUUBUUBUBUUUUUUBUUUBUBBBUBUUBUUBUBBUBUBUBUUBBBUBUBBUUUBUUUUUUUUBUBUUUUUUUUBBUBUB
BBUUUUBUUBUBUBBBUUUBBBBBUBUUBBUUUBUBBUBBUBBBBUUUBUBUBUBBBUUUUUUBUUBUBUUBBBUUUUUBBUUUBUBUUUUBUBBUBUUUU
UUUBUUUUUBUUUUUBUUUUUUUBUUUBUBUUBUUUUUUUUBUUUUBUUBUUUUBBUUBUUUBUUUUUUBUUBUUUUUUUUUBBUUBBUBUUUUUUUUUUU
UBBUUUUUUUUBBUUUUUUUUBBUUUBBBBBUBBUUUBUBUUUUUUUBBBBUUUUBUUUUBUBUUBUUUBUBUUUBBUBUUUUUUUUUUBUUUUUBUUUUU
BUBUUUBUUUBBUBUUBUBUUUUUUUBUBUBBUBBUUUUUUUUUUUUUUUUBUBUBUUUBUUBUUUBBUUUUBBUUUUUUUUUUUUUUBUUBUUBBBUUBB
UUUUUBUUUBBUUBBUBBBUUUUBUUUBUBBBUUUBBUBBUUBUUUUUUBBUUUUUUUUUUUBUUUBUBUUBUUUUUUBUBBUBUBUUUBBUUUUUUUUUU
UBBUBBUUUBUUBBBUBUUUUUBBUUUUUUUBUUUBBBBUUUUUUUBUUBUUUUUBUUUUUUUBUUBUBBUUUUBUBUUUBUBUUBUBBBBUUUUBBUBUB
UBUUBUUUUUBUUUUUBBBBUUUBUUBUUUUBUUUUUUUBBUUUBBUBUUUBUBUUUUBUBUUUBBUUUBUBBUUUUUUBUUUBBUBUBBUUUUUUUUUUU
UUUUUBUUUUUBUUUUUBBUUBUUUUBBUBUUUBUUBBUUUUUBBBUBBUUBUBUUUBBUBUBBUUUUBUBBUBBUBUUUUUUUUBBUUUBUBBUUUUBUU
UUUBBBBBUUUUUUUUBUUBUUBBBUBUBUBUUUUUBUUUBUUUUUUUUUUBUBUBBUBUUUUBUUUUUUBUUUBUBUUBUBBUUBUBUUBUUUUUUUUUU
BUUUUBBUUUUBUUUUUUUUUUUUBUUUUUUUUUUUUUUBBUBUUBUBUUUUBBUUUUBUBUUBBBUBBBUUUUBUBUUUUUUUUUBBBUUUBUUBUUUBB
UBUUBUUUBBUBUUUUBUUUUUUUBUUUBUUUBUBUUBUUUUUUUUUBUBUUUUBUUUBBUBUUBBUUBUUBUUUUBBUBUUUUUBUBUBUUUUUUUUBBU
BUUUBBUUBUUUUBUUUUUBUUUUBUBUUBBUUUUUUUBUUUBUUUBUUUUUUUBBBUUBUUUBBUUUUUUUBBUUBUUUUBUUUUUUUUBBBUUUUUBBU
UUUUBUUUBBUBUBUBUUBUUUBBUUBUUUBUUUBUBUBBUUUUBUBBUBUUUUUUUUUUUUUUBUUUUUUUUUUUBUUUUUBBUUUUUUUUUUUBUUUUB
UBBUBUUUUUUUUUBUUBUUBBUBUUUBUUUUBUUBUUUUUBUUUUUUUBUBUUUUBBUBBUUUUBBBBUUUUUUUUUUUUBUBUUUUUUUUBBBBUBBUU
UBBBUBUUBUUUUBUBUBUUUUUUUBBUUBUUUUUUBBUUUBUUUUUUUBUBBUUUBUUBUUUUBUBUUBUUBUUUBBUUUUUBUUUUUUUUUUUBUUUUU
BBUUUUBUUBUUUUBUUUUUBBUUBUUUBBUUUBUBUUUUUUUBUUBUUUUBUUUUBUUUUBUUUUUUUUBUBBBUBBUUBBUUUBBUBUUUBUUUUUUUU
UUUUBUBUUUUBUBBUUUUUBUBUBUUUUUUUUUUUUUBUUUUUUBUUUBUBBUUUBUUUUUBBBBUUBUUUUUUUBBUUUBUUUUUUUBUBBBBUUBUBU
UUUUBUBBUBUBBUUUBUUUBUBUUBBUBBBUUUUUBUUUUUUUUUBUBUUUUBUBUUBUUUBBUBBUUUBUBUUBUUBUBUBUUUUUBUBUUUUUUBBUB
BUUUBUBUUUUUUBUBUUUUBUUBUBUUUUUBBUUUBBBUBBUUUBBBUBUBUUUUUUUBBBBUUUBUUUUBBUBBUUBUUBBUUBUBBUUUUUUUUUUBB
UUUBUBBBBBUUUUBUBUUUUUBUUBBUUBBUUBBUUBUUUUUUBUUUUUUUBUUUUBUUBBUBUBUUUUUUBUUUUUUUUUUUUUUBUUUUBUUUUUUUU
BBBBUUUUUUBUUBUUUUUUBUUUUUUUUBBUUBUUUBUBUUUUBUBUUUUUBBUBUUUUBUUUUUBUUUUUUBUUBUBUBUUBBUUUBBUBUUUUBUBUU
UUUUUBUUBBUUUBUUUBUUUUUUBBBUUBBUBUUUUUUUBBUUUBBUUBBUBBUUBUUBUUUBBBUUUBUBBUUUUUUBBUBUUUUUUUUBUUBUUUUUU
UBUUBBUUBUUUBUUUBUUUBUBBUBUUUBUUUUBUUUBBUUBUUBUUUBBUBBBBBUUUUUUUUBUUUUUBUUUUUBUBBBBUUUUUUUUUUUUUBBUUU
UBUBBUBUBUBUUUUBUBUBUUBUUUUUUUUUUUUUUBBBUBUBUUBUUUBUUUBBUUUUUUBBUUBUUUUBBUUBUBUUUUUUUBUUUUBUUUBBUBUBU
UUUBBBBUUUUUUUUUBBBUUUBUUUUUUUBUUUUUUUUUUUUUUUUUUBBBUBUUBUUUUUUUBBUBUUUUBUBUUUUBBUUUBUUBBBBBBBUUUBBBU
UUUUUUBBBUUUUUBUUBBUUUUUUUUUUUUUUUUBUBBBUBUUUBUUUBUUUUUBUUBUUUBUUUBUUBUUUUBUBUBUUUBUUUUUUUUUUUBUBUUUB
UUBBUUUUUUBBBBBUBUUUBBBUUUBUUUUUUBUBUUUBUUUUUUBBUUUBBUUUUBUUBUBBUBUUUUUBBUUUUUUUUUUUUUUUUUUUBUBUBUBUB
UUUUUUUUUUUUUUBBBBBUBUUBUUBUUUBBUBUUUUUUUUBUUUUUUBBUUUBUUUUUUUUUUBUBUBUUBBUBUBBUBUUUBUBUUUBUBUUBUUUUB
UUBBUUUUBUUUUBBUUUUUBUBUBUBUUBBBUUUUUBBUUUUBUUUUBUUBUUUUUUUBBUUUBUUUUBBUUUUUBUUUUUBUUBUUBUUUUUBUUUBBB
UUUUBUUUUUUBBUUUBBBUBUUBUUBUBBUUUUUBBUUUUUUUUUUUUUUUUUBUUBBUBUUUUUUUUUUBUBBUUBUUUUUUUUBUUUUUUUUBBBBUU
UBUUUUUUUUBBUUUBUUUBBUBUBBUUUUBBUUUUUUUUUUUUUUUUUBUUUUUUUBUUUUUBBUBUUUUUUUBUUBUUUUUUUUUUUUUUUUBBUBBBU
UUBUUUUUBUUUUUBUBBUBUUUUUUUBBBBUBUUUBUUUUBUUUUUUUUUUUUUUUUUUUUBUBUUBUUBBBUBBUUBUBBUBUBUUBUUBUBUUUUUBU
BUUUBUUUUBUUUBUBBUBUBUUUBUUUUBUUUUUUUUUUUUUUUUUUBBUUUBUBUBUBUUUBUBUBUUUUUBBBUBBUUBUUUUBBUUUBBUUUUUUUB
UUUUUUUBUUUUBUBUBBBUUUUBBBUBBBBUUBUBUUUUBUUBUBBBUUUBBBUBUBUUBUBUBUUBUUUBUUUBUBUUBUUBUUUUBUUUUBBBBBUUU
UUBUUBUBBUUUUUBUUUUBUUBUBUUUBUUUBBUBBUUUBBUUUUUUUUUUUUUBUUUUBBUUUBBUUBUBUUBUUBUBUUBBBUUBUUBBUBBUUUUUU
UUUUBBBUUUUUBBUBUUUUUUUUUUBUBUUBUUUBUUUUUUUUBBUUUBUUBUBUUUUBUBUUUUUUUBUUUUUBUBBBUUBUBUUUBUUBUUUUUUUUU
BUUBBUUUBUUUUUBUUUBBBUUUUBUUUBUUBBUUUUUBUUUUUUUUUBUUUUUUUBUUBUUUUUUUUUUUUUUUUUBBBUUUBUUUUUBBBUUUUUUUU
UBBBUUUUBBBUUBBUBUUUUUUUUUUUBBBUUUUBUUUUUUUUUUUUUUUBUUUBBUUUBUUUUBBUUUUBUBUUUBUUUBUUBBUUUBUUUBBUUUUUB
BUUBUUBUUUBBUUUUUUBBBBUUBBUUUUUBUBBBUBUUUUUUUUBUBUUUUUUUBBUUBUUBBUUUUUUUUUBUBUUUBUBUBUUBUUUUUUUBUUUUU
BUBUUBUUUUUBBBUBBUBBUUUBUUBBUBBUBBBUUUUUBUUUBBBUUUUBUBUBUUBUBUUUBUUUBBUUBBUUUUBUUUUUUBUBUUUUBUUUUUBUU
UBBUUUBUUUBBBBBBUBUBUUBUUUBUUUUUUBUBUUBUUUUUUBUUBUUUUBUUUUBUUUUUUUBUUUUBBUUBUUUBBBUBBUUUUBUUUBUUUUBBB
UBBUUUUUUUBBUUUUUUUUUBBUUUUBBUUBUUBUBBUBUBUUUUUUUUUBUUBUUBBBUBUUUUUBBUBUUUUUUUBUBUBUBUBUUUUUUUUUBUUUU
UUBUUUUUUUUUUUUUUUUUUBUBBUBUUUBUUUUUUBUUUUBUBUUBUUUUUUUBUUBUUUUUUUUUBUUUUUUBUUBUBUBUUBUUBUUBUUUUBUBUB
BUBBUUUUBUUUBUUUUUBBUUBUBBUUUUUBBUUUUBUUUUUUUUUUUBUBUUUUUUBUUBBUUUUBBUUBBUUUUBUUUBUUUUUUUUUUUUUUUUUUU
UUUUBUUBUUBBBUUBUUUBUBUUUBUUUUUUBUBUUBUUBBBUUUUBUUUUBBUBUUUBUUUBBUBUUUUUUUUUUBUBBUUBUUBUUBBUUUBUUUUUU
BUUBBUBUUUUBBUUBBUBUUUBUUUUUUUUBUUUBBUBUUUUBUBUUUUUBUUUUBUUUUUBUBBUUBUUUUUUUBUUBBUUUUUBBUUBUUBUUUBUBU
UUUUUUUBBUUUUUUUBBUUUUUUUUBUBUBUUBUUBUUBUBBUUUBBBBUUUUUBUUUBUUBUUUUUBUUUBBUBUBUBBUUUUUUUUBUBUUUBUBBUU
BUBUBUUBUUBUBUUBUUBUBUUBUBUUUUBBUUBBBUBUUBUUUUBUBUUUUUUUUUUUUBUBUUBBBUUUBUUUUUUUUUUUUBBUUUBBUUBUBUUUB
BUUUUBUBBBBUUBUUUBBUUUBBUUUUBUUBBUUUBUUUUBUUBUBUBUUUUBBUUUUUUUBUUUBUUBUUUBUUUUBUBUUBBUBBUUBBUUBUBUUUU
BUBUBUBBUUUBBUBUUUUBUBUUBBUUBUUUUUUUUUUBUUUUUUUUUBBUUUUUUUUUUBBBUUUUUBUBUUUUBUUUBUUUUUUUUUUUBUUUUUBUB
UUUBUBUUUUUUUUBUUUUBBBUUBUUBBUUUBUUUUUUBUUBUBUUUUUUUBBBUUUUBUUUBUBUBUUUBUUBUUUUBUBUBUBUUUUUBUUUUUUBUB
BBUUUUUBBUUUUUBBUBUBUBBUUBUUBUUUUUBUBUBUUUUUUUBUUBUBBUUUBBUUUUUBBUBBUUUBUUUUBBUUUBBUUUUUUBBUBUUBUUUUU
UUUBUUBBUUUUUBBBUBUUUUUUBUUUUBUUUBUUUUBBBUBUUBUUBUBUUBUUUUBUUUBUUBUUBBUUUUUUUUUBBUUUUBBUUUUUBUUUUBBUU
UUUUBUBUBBUBBUUUUUBUBUUUUUBUUBUBUUUBUUUUBBBBUBUUUUUUUUUBUUUBBUUUUUBUBBUUBBUBUUUBUUUBUUUUBBBUUBUUUUUBB
UBUUUUBUBUBUBUUUUUUUUBUUUUUUBUUBBUUUUUUBUUUUUBUUUUUUUBUUUBUUUUUUUUUUUUUUUUUBBUUUUUUUBBUUBUBBUUUBUUBBB
BBBUUUBBBBUUUBUUBUUBBBBUUBUBBUUBUUUUBUUUUUUUBUUUUBUUUUUUBUBBUBUUBBBUBUUUUUUUBBUUUUUBUUBUBUBBBUBUUUUBU
UUBUUUUUBUUUBBUBBUUUUUUBUBBUUUBBBBUBUBUUBUUUUUUBUUUBUUBBBBUUUUBBUBUUUUUUUBUUUUUUBUUUBUUUBBBUBUUUBUUUB
UUUUUUUUUBUUUUUBUBUUUUUUUBUBBUUUBUUBUUUBBBUUUUBUBBUUUBUUUUUUUUUUBUUUUUUUUUBBBUUUBUBBUUBBUBUBBUBUUUBUU
UUUUBUBUUUUBBUBUUUUUUUUUUUBUUBUUUBUBBUUBBUUUBUUBBBUUUUUBUBUBBUBBBBUBUUBUUUUBUUUUUUBUBBBUUUBUBUUUUBBUB
UUBBUUUUUBUUUUUUBUUUBUBBBBBUUUBBUUUUUUBUUBUUUUUBUUUUUUBUUUUUUBUUUBUBUUUBUBUUBUUUUUUUBUBBUUBBUUBUUUBBU
UBUUUUUUUUBUBUUUUUUBBBUBBUUUUUUUUUBUUUUUUUUUUUUUBUUUUUBBUUUBUUUUUUUUUUUBUUUUUBUUBUUUBBUBUUUUBUUUUBUBU
BUUUBUBUBUUBUUBUUBBBUBUUUUBUBBUBUUUUBUUBUUBUUUBBUUUBUBUBUBUBUUUUUUBUUBUUUUUBBUUUBUBUBBBUUUUUBUUUUUUUU
