UUUUUBUUUUUUBUUBUUUUUUUUUUUUUUUUBUUUUBUUUUBUUBUBUUUUUUUBUUUBUUBUUUUUBBBUUUBUBUUUUBUUUUUBUUBBUBUBBUUUB
UUUBBUUBUUUUUUUUUUBBUUUUUUUBUUUBBUUUBUBUUUUUUUUUUBBUUUUUBUUUBUUUUUBUUUUUUUUBUUBUUUUUBUUUUBBBBBUUBUUUB
BBUUUUUUUUUUUBUBBUUUBBUBBBUUUBBUUUUUUBBUUBUUUUBUUUUUBBUUBUBUBUUBUUUBUBBUUBUUUUBUBUUUUUUUUBBBUUBUUUBUU
UUUBUBUUUUBBUBUUBUUUBUUUUBUUUUBUUUBBUUUUBUUUBUBBBUUUUUUUUUBBUUUBUUUUUUUUBBBUUUUBUBUUBUUUUUUUUUUUUBUUU
BUUUUUUUUUBUBBBUBUUUUUUUBUUUUUBUBBBUUUUUBUBUUUUUUUUUBUUUBUUUUUBUUUUBUUUBUBUUUUUUUUUBUUUBBUBBBUUUUBUUU
UBUBUUUUUBUBUUUUBUBUBBUBBUBBUUUUUBUBUBBBUUUBBBBBBUUUUUBUUBBUUUUUUUUUBBBUBUBUBUBUUUUUUUBUUUUUUUBBBBUUU
UUUBUUUBBUUUBUUUUUUUBBBUUUBBUUBBBUBBBUUBUBUUUUUUUBUUUBUUBUUUUUUBBUUUUUUUUUUUUUBUUUBUUUUBUUUUUUUUBUUUU
UBUUBBUUUUBBBUBUUUUUBUUBUBUUBUUUBUBBUUUUUUUUUBUUUUBBUUBBUUUUUUUBUUUBUUUBUUBBBBUBUUUBUUBUUBBBUUUBUBUUU
UUUUUBUBUBBUUUBUBUUUUUBBBUUUUUUUUUUUUBBBBBUBUBUUUUUBUUUUUUBUBBUUUUBUUBUUUBUBUUBUUUBUBBUUUUUUUUUBUBUUU
UBUUUBUUUBUBUBUUUUUBUUUUUUBBUUUBUBUUUUBUBBUUBUUBUBBUUUUUUUBUUBUUUBUUUBUBBUUUUUUUUUBUUUUUBUBUBUUBUBUUB
UUUUUUUUBBBBUUUBUUUBUBUUBUBUBUUUUUBUUUUUBUUUUUUBUUUUUUBUUUUUUUUBUUUUUUUBUUUUBUUBUUUUBUBUUBUUUUUBBBUUB
UUBUUUBUBUUUUBUUUUBUBBUUUUUUBUUUUUUUUUUUUBBUBUBUBBBBUUUBUUBBUUUBUUUUUUUUUBUUUUUBUUBUUUUBBUBBUBUUUBBUB
UBBUUBUBUUUUBBUBUUUUUUBUBUUUUBUBUUBBUBUBUBUUUUUBUBUUBUBBBUBUBUUUUBUBUBUUUUBBUUUUUBUUBUUBUUUUBUUUUUUUU
UUBUBBBUUUUBUUUUUBUUUBUUUUUUUUUUUUUUUUBBUUUUUUUUUUUUUBUBBBUBUBBUUBUBUUBUUUUBUUUBBUUUBUUUUBUBUUUUUUUUB
BUUUUBUBBUUUBBUUUUBUBUUBUUBUUUBUBUUBUUBBUUUBBBUUUUUUUUUBUUUBBUUUBBUBUUBBUBUUUUBBBUUUBUUUUUUBBUUUUUUUB
UUUUUUUBUUUUUUUUUUBUBUUBUUUBUUBBUBBUUBUBUBBUUBUUBUBUUUUUUBUUBBUUBUUUUUUUBUUUUBUUUUBBUUUUUBBBBUBBUUUUU
UUUBUBUBUBBUUBBUUUUUUUUUUUUBUUUUBBUUBUUUUUUBBUUUBBBBBBUUUUBUBUUBBBBUUUUBUUUBUBUUBUUBBUBUUUUUBBUBBUUUU
UUUBBUUBUUBUBUBUUUUUBUUBBUUUUUUUUUBUUBBUUUBUUBUUUUBBBUUUBUUUUUUUUUUBUUUBUUBBBBUUUUUUUUUUBBUUUUUUBUUBU
UBBUUUUBUBBUBUBUUBUBBUUUBBUUBBUBUUUUUBBUUUUUBUUBUUUBUUBUBBUUBUBBBBUBUUUUBUUBUUUBBUUUUUUUUUUUBBUUUUBUB
UBUUUUUUUUUUUBUUUUUUUUUUBUUBUUUBUUUUUUUUUUBUBUBBUUUUUUUBUBUUBUUBUBUBUUUUBUBBUUBUBUUUUUUBUUBUUUUBBUBUU
UBUUUUBBUUBUUUUUUUUUUUUUUBUUBBUUUBUUUUUUUBUBUUUUUUUUUUBUUUUBBUUUBBBUBUUBUUUBUUBUBUUUUBUUBBUUUUBUUUUUU
UUUUUBUUBUUUUUUBUUUBUBUBUUUUBUUBUUUBBUUUBUUBUBBUUUBUBUBUBUBUBUUUUUUUBUUUUUBUUUUUUUUUUUUUUUUUUUBUUBBUU
UUUBBUUBUUUUBUUUUBUBUBUBUUUUBBBBUUBBUUBUUUUUUUUUBUUUBBUUUUUUUUUUUUUUUBUUUUBUBUUUUBBUBUUUUUUUUBBUUUBUU
UBUUUUUUBBUBUBBUBUBBUUUUUBUUBUUUBBUBUBUUBUBBUUUUBUUUBUUBUUUBUUUUBUUUUUUUBBBUUUBUBUUBUUUUBBUUBBUUBBBUU
BUBBUBUUUBBUUBUBUUBUUUUUUBUBBUUUUUUUUUUUBUUUUUBUUBUUUUBUUBBBBUUUUBUUBUUUUUBBUBBBUUBUUUBBUUBUUUUBUUUBU
BBUUUUUUUUUBBBUBUUUUUBUUUBUBUUUUBBUBBUUBBUBBUBBUBBUBUUUBBBUBUBBUUUUUUUUUBUUBUUBUUUBBUUBUBBBUUBUUUBUBU
UUUUBUBUUUBBUBUUUUUBUUBUUUUUUUUBUUUUUUUBUUBBUBBUUUBUUUUUUUUUUUBUUUUUUUUBBBUBBBUUUBUBUUBBUBUBUUUUUUUUB
UUUBBUBBUUUUBUBUUUUUUBUBBBUUBUBUUBUUUUUUBUUBUUUUBBUBUBUBBUBBUBUUUUUUUBUUUUUUUUUBUUUUUUUUBUBUBBUUBBUUU
UUUUBUUUUUUUBBUBBUUUUUUUUBUBBUUUUBUUUUBUUBBUUBUBUUUUUUUUBUUUUUUUUUUBBUUUUUUUBUBUUBUUBUUBUUUBUUBUUUBUU
BUUUUUBUUUBUUUUUUUBUBBBBUBUBUUBUUUUBUBBUUBUUBBBBUUUUBBUUUUUUBUUUBBUUBUUUBUUUUUUUUBBUBUBUBBUUUUUUUBUUU
UBBUUBUUBBUUUUUBBUBUBUBUUBBBUBUUUUUBUBUUBUUUUUBUUUUBBBUUUUUUUUUUUUUUBBBUUUUUBUBUBBUUBBBBUUBUUUUBUBBBU
BUUUBUBBUUBUUUUUUUBUUUBUUUUUBUUUUBUUUBUUBUUUUUBUBUBBUUUBUUUUUBUUUBUUUUUUUUUUUUUBUUUUUBUUBUBBUBUUUBBBU
BUUBUUUUUUUUBBUBBUUUUBBUUUBUUUUUUBBUBUUBUUUBUUUBUUBUUUUUBUUBUUUBUUUUUBUUUBUUUBBUUBUUBUUUUBUBUBUUUUBUU
UUUUBUUUUUUUUUUUUUUUUUBUBBBBUUBUUBUUBUBBUBUBUUUUBUUBUUUUBUUUBBUUUBUUUUUUBUUUUUUUUBUUUUUUUUBUBUUUUUUUU
UBUUUUBUBBBUUUUBUBUUUUUUBUUUUUUBBUBUUUUUBUBBUUUUUUUUBUUBBUUUUUUUUUUBUBUUBBUBBUUUUUUBBUUUUUBUBUUUUUUUU
UBBUUUUUUBUUUUUUBUUUUUBUUUUUUUUUUBUUUBBUUBBUBUBUUUBBUUBBBBUUBBUUUUBUBUBUUUBBUUBUUUBUUUUBUUUUUBBBUUUUU
UUUBBUBBUBUUUUBUUBBUUUUUUBUUBUBUUUUUBBUUBUUUUUUBBBUBBUBBUBBUUUUUUBUBUUUUBUBUBUUUUBBBBBUBBBUUUUBUBBUUU
BUUBUUUUBUUUUUUUBUUUBUUUUUBUUBUUBUUBUUUUBUUBUUUBUUUUUUUUUUUBBBUUBBBBUUBUUBUUUUBUUUUBBUUUUUUBUBUUBUUUU
BUBBUUUUUUUUUUUBUBBUUBBBUUUBBUBUUUUUUBUBBUUBBUUBUBUUUBUUUUBUUUBUBUUUUUBBUUBBUUBUUBUBUUUUUBUUUBBBBUBUB
UBUUUUUUUUUUBUUBUUUBUUUUUUBBUUBUUBBBUUUBUBUUUUUUBUBUUUUUUUUUUBUBUBBUUUUUUUUUUBBBBBUBBUBUUBUUBBBUUUUUU
UUBUBUUBUBUBUUUUUUUUUUBBUBUUUUUBUBBUBUUUUBBUUBUUUUUUUBUBUUUUUBUUUUUBUUUUBBBUBUUUUUUBUUBUUUBBBBUUBUUUU
UUUUUUUUUUUBUUUBUUBUUUUUBUBUUUUBUUUUUBBUUUUUBUUUUUUBUUUUUUUUUUBUBUUUUBUUUBUUBUUUUUUUUUUBBUBBUUUUBBUUU
BUUUUUUUUBUUBUUUUBBUUUUBBUUUUBUBBBUUUBUUUUUUUUUBUBUUBUUBUUUBBUUUUUBUBBBUUUUUUBUBUBUBBUBUUUBUUBUBUUUBU
UUUBUUBUUUUBBUBUUUUUBBBUBUUUUUUUBBUUUUBUBUUBUBUBBUUUUUBUBUBUUUBUBBBUUUUUBUBUUUUUUBUUBUUUUUUBUUUBUUUUB
UBUUUUUUUBUUBBUUUUUUBBBBUUUUBUUUBUUUBBBBUUUUUUUUBUUBUUBUUUBUUUUUUBUUBUUUUUUUUUBUUBUUUUBUUBBUUBBUUBUUB
UUUBUUUUUUUUUUUUUUUUUUUUUUBUBBBBUUUUUUUUUBUUBBBUBUBBUBUBBUBBBUUBBUBBUUBBUUUUUUBUUBUUUUUUUBUUUUUUBBBUU
UUUUBBUUUUUUUUUUUUUUUUBUUUUUBUUUUUUUUBUUUUUUUUUBBUUUUUUUUUUBUUBBBUBUBBUUBUUUBUUBUUBBUBBUUUUUUUUUBUUUB
UUUBUUBUUUUUUBUBUUUUUUUUUBUBBBUBBBUBUUUUUUUUBBUUUUBUUBUUBBUBBUBUUUBUUBUUBUUBUUUBUUUUUUUUUBUBBBUUBBBBB
UUUUUBUBBUBBUBUBUUUUUUBUBUBBBUUUUUUUBUBBBBBBUUUBUUUUUUBUUBUBBUUUBBUUUUBUUUBUBBUUUUBBBUUUUBUUUBUBUBUUU
UUBUUUUUUUUUUBUUBUUUUUUBUUUUBUUUBUBBUUBUUUUBBUUUUBUUUUUUUBBUUBUUUUUUUUUUUBUUUUUBBUBUUUUUUUUUUUUUUUUBB
UBUUUBUBBUBUUUUUUUUUUUBUUUBBUUUUBUUUUUUUBUUBBBBUUBBUUUUUBUBBBUBUUUUUUBBUBUBUUUBUBBUUUUUUUUUBUUUUUUUUU
UUUUUBUUBUUBUUBBUBBUUUBUBUUUUUUUUUUUBUUBUUBBUBUBBUUUUUUUBUUUUUUBBUUUUUUUUBUUBUUUUUUBUUUBBUUBUUBUUUBUU
UBUUUBBUUBUUUUUUUUUBUUUUUUUUUUBUUUUUBUBUUUBBBBBUUBUUUUUUUBUUUUUBUUUUUUUUUUUBUUUUUUUUUUUUUBUBUBBUBUBBB
UUBBUBUBUUUBBUUUUUBUUUUUUUUBUBUBBBUBBUUUBUBUUUUUUUBBBUUUUUUUUUUUUUBUUBUBUBBUUUBUBUBBUUUBUUUUUUUUBUBUB
BBUUUUUBBUUBUBBBUUUUUUUUUUUUBBBBBUUUUUBBBUUUUUUUUUBBBBUUUUBUBUBUUUUBUUUUBBBBUBBUBBUUUUUUUBUBBBUUUBUBU
UUUBBUUUUBBUUUUUBUBUBUBUUUUBUBUUUUUUBUBUUUBUBUUUUUBUUBBUBBUUUUUUBUUUBUBUUBUUUUUBBUBUUUBUUUUUBUBBUBBBU
UUUUUUUUBBBBUUBBUUUUUBUUUUUUUBUUUBBUUBUUBUUUUBBUUBUUUUUUUBUUUUUUBUUUUUUBUBUUBBBBBUUBBUUBUUUBBUUUUUBUU
UUUBUUBUUUBBUUUUUUUBUUUBBBUUUBUUUUUBBUBBUUBBUBUUUBUUUBUUUBBUUUUUBBUBUBBUBBUBUBBUUBBBUBUUBUUUUUUUUUBBB
BUUBUBUUUUUBUUUUUBUUUUBBUUUUUUUUUUBBUUUBBBBUUBUBUUUUUBUUBUUBUBUUUUUUBBBUBUBUUUBUBUUUUUUUUUUUUUUUUUBUU
BBUUUBUUUUBBUUBBUBUUUBUUUBUUUBBUBBBUUUUUUUBUUUUUBUUUBUUBUUUUUUUUUBUUBBUUUUUBBBBUUUUUBUUUUUBBUBUUUUBUB
BUUBUBUBUUUUBUUUBUUUUBUBUBUUUUUUUUBUBUUUBUBUUBUUBBUUUBUUBUUUBUUUBBUUBUBBUBBBBUUBUBBBUUBUUUUUUUUUBUBBU
UUBUUUUBUUUUUUBUBUUUUUUUBBBBUUUUUBBUUBUUUUBUUBBUUUUUUUUUUBUUUUBBUUUBUUBUUBUUBUUUUUBBBBUBBBUUBUUUUUUUB
BUUUUBUUUUBBUBUUUBUBUUUUUBBBUBBBUBUUBUUUBBBUUUUUBUUUUBUUUUBUUBBUBUUUUUUUUUUBUBUUUUUUUUBUUBBUUUUUUUBUB
UUBUUUUUUBUBUUUUUUUUBUUUUUUBUUBBBUUBUBUUBBUUUUBUUBBUUUUUUBUUBUUUUBUUUUUUUUUBBUUUUUBUUBUBUUBBUUUBBUUUU
BUUUBBBUUBUBBUUBUUBBBUUUBUUUBUUUUUBUUUBUUBBBUUUUUUUBUUUUBBBBUUBUUUBUUUBUUBUBUBUBUUUUBBUUUBUBBBBUUBBUU
UBUUUUUUUUBUUBBUUBBBUUUUUUUUBUBUUUUUUUUBBUBUBUUUUBUUBUUUBUBUUUUBBUUBBUBUUUBUUUUBUUBUBBBUUUUUUUUBUUUUB
UUUUUUBBUBUBUUBUUUUUUUUUUUUUUUUUUUBBUBUBUUUUUUUBUUBUUBUUUUUUUUUUUBBUUUUUBUUBUUBUBUUBUUUBUUUUUUUUUUUUU
UBUBUUUUUUUUUUUBBUBUUUBBUUUBBUUUUBUUUUUBBBBBBUUBUBBUUUUBBUUBUBUUUUUBBUUUBUUUBBUUUUBUUUUUUUUUUUUUUUUUU
UUUUUBUUBBUUBUBUUBBUUUBBBUUBBUBBUUBBUUBUBUUUUUUUUUUUBUUUUBBUUBUUUBBUUUUUUUUUUUBUUUBUBUUUBUUUUUUBBUBUU
UUUUUUUBUUUUUUUUBUUBUUBBUUUBUUUUUUUUBBUUBUUUUUUBBUBUUUUUUBBBBUUBBUUBUBUUUUUBUUUUBUUUBBUBUBUUUBUUBUUUU
UBUUUUUUUUBUBUUUBUUUUUUUUUUUUUUUBBBUUUUBUBUBUUBUUUUUUUBBUUUUBBUBUUBUBBUUBUUUUBBUBUBUBBBBUUUBUUUUUUUUU
UUBUUUUUBUBUBUUBUUBUUUBUBUBUUBUBUBUUUUUUUBUBBBBBUUBBUUUUUUBBUBUBUUBBUUBBUUBUUUUUBUUUBUUBBBBUBBUUUBUBU
BUBUUBUBUBUUBUUUUUBUUUUBBUBUBBUBUUUBUBUBUUUUUBUBBUBUUUUUBBUUBBBUBUBUBUUBUUUBUUBUUUBUUUUUUUUBUUUUUUUUU
UBUUBUBBUUBUBUUUUUUUUBBBUUUUBBUUUBUUUBUBBUUBBUUUUUBBUBUBBBBBBBUUBUBUUBBUBUBUUUUUBUUBUUUUBBBUUBBUUUBUU
UUUUUUBBUBBUBUUUUUUUUBUUBUUUUUUBUUBBBUUBUUBBUUBUUBBBUBUUBBUUUUUUUBBBUUUBUBUUUUUUUUUUUUUUUUBBBUUUBUUBB
UUBBUUUBBUUBUUBUBUUUUUUUUUUUUUUUUBUUUBUUBUUBUUUBUUUBUBUUUUUUBUUUUBUBUBBUUUBUUUUUUUUUUUBUBBUUBBUUUUBUB
BUUUUBBUUUBUUUUBBUUUUUUBBUUUBUUUUUUUUUBUBUBUUUUUBUBUUUUUBBUUUUUUBBUUBUBUUUBUUBUUUUUUBBUUUBUUBUUUUBUUB
UBUUUUUBUUUBUBUBUUUUUUUBUUUUUUUUBBUBBBUUUBUBUUUUUUBUUUUBUUBUBUUUBBUUUBUUUUUUUBBUUUUUUUUUUUBUUUUBUUBUB
UBUBBUUUUUUUUUUUUUUUUBBUUBBUUBUUBUUUUUUUUUBBUBUUUBUUBUUUBUUBBUUUUUUUBBBBBUUUUUUBUUUUUUUBUBBBUUUBUBBUB
UUUBUUUBUUUUUUUUUBUUBUUUUBBUUBUUBUUUUBUUUBUBUBUUUBBUUUUUUUUUUUUUUUUUUUUBUUUUBUBUUUBUUUUBBUUUUUBUUUUUB
UBUUUUUBUUUBUUBBBUBUUBBUUUUUUUUUBUUUBUUUBUUUBUUUUBBUUUUUUUUBUBUBUBUUBBUUUUUUUUUUUUUBBUUBUBUUBUUUBUUUB
UBUUUBBBBBUBUUUBUUBUUUUUBUUBBUUUBBUUUUBUUBBBUUUBBUUUBUUBUBUUBBUUUBUUUUUUBBUUUBBUUUUBUUUUBUBUUBUUUUUUU
UUBBUBUBUBBUUBUUUUUBUUUUBUUUUUUUUBUUUUBUBUBBUUUBUBUUBBBUUBUUUUUUUUBUUBUUUUUBBBUUUUUUUUBUBUUUUBBUUUUUU
UBUUUBBBUUBUBBUUBBUUUUBBUUUUUUUUUUBUUUUUUUUUBUBUUUBUUBUUUBUUUUUUUBBBUUUBUBUBBUUUUUBUBUBUUBUUUUBUUUBUU
UUUBUUUBUUUUUUBBUUBUUUUUUUUBBUBUUUUUUBUUUUBBUUBBBUUBBBUUUUUUUUUBBUBUBUUUUUUUBBUUUBBUUUUBUBBUUUUBUUUBU
UUUUUUBBBBUBBUBUUUUUBUUUUUUUUUUBBBUBUUUBBUUUUUBUUUUUBUUUBUUUBBBUUUBUUUBUBBUUUUBUBBUUUBUUUUUUUUUBUUBUU
UUBUUUUUUUBUBUUBBUBBBUUUUUBUUUUUUUBUBUBBUUBBUBBUBUUUBBBUUBBUBUUUUBBUBUUBUBUBUBUUBBUBUBBBUUBUUUBUUUBUB
UUUUUUUUBUUUUBUUUBUUUBUUUBUUUUUUBUUUBUBUUUUBBUBUUUUUBBBUUUUUUBUBUUUBUUUUUUUUBUUUUBBUUUUBBBUUUBUBBUUUU
BUBUUBUUBUUBUBUUBBBUUBUUUUUUUBBBUUBUUBUUUUUUUUBBBUBUBBBUBUUUUBUBUUUUUUUBUUUBUBUUUUBUBUBUUUUUBBBUBBUUB
BUUBBUUUBUUUUUBUUUUUBBUUUBUUUUUUUUUUUUUUUUUBUUUBUBBUUBUUUUUUUUUUBUUUBBUUUBUUUUBBUUUBUBUBUBUBUBUUBUUUB
UUBUUUUUBBUUUUBBUBUUUUUUBUUBUBUBUUBBUBUBUUUUBBBUUUUUBUUBBUUBUBUBUBBUUUBUUUUUUUBUBUUUUUUUUUUBBUUBBUUUU
UUUUUUUUUUUUUUUUUBUBBUUUBUUUBBUUUBBUUUBUUUBUUBUUUBUUUBUUBBBUUBUUBUUUUUUUUUUBUUUUBUBUBUUUUUUUUUUBUUBUB
UBUUBBUUUBUUUUBUUUUBUUUBUUBBBUBBUBBBBBUUUBUUUUUUUUUUUUBUUUUBUUUUUUBUBUBUBBUUUUUUUBUBUBBUUBUUUUUUUUBUU
UUUUUUUUUUBBUUBBUBUUUUUBUUUUBBBBUUUBUBUBUUUBUUBBBUBBUUUUUUUUBBUUBBUBUBUUUUUUUBUBUBUBUUUUUBBUUUBUUBBUU
UUUBUUUBBBBUUUUUUBBUUUBBUUUUUUBBBUUUUUUUUUUUUUBBUUUUBUUUUBBUUBUUBUBUUUBBBUBBUUUUUUUUUUBUUBUUUBUUUUUUU
UUUUUUUUUBUUBUUBUUUUUUBBUBUBBUBBBBUUUUUUUUUUBUUUUUUUUBUBBBUUUUUBUBBBUUUBUBUUBBBBBUBBBUBUUBUUUBUUUBBBU
UUUUUUBBUUUBBUUBUBBUUUUUUUUUUBUUBBUUUUUUUBBUBUBUUBBBUBUUUUBBUUUUBUBUUUBBBUUBUUUUUUUBBUUUUUUUUUUBUBUBU
UUUBUUUBUUUUBBBUUUUUUBBBUUBUBBUUUUBUUUUUUUUUBUUBBUBUUBUUUUBUBUUBBBUBBUUBUUBBUUUUUUBUBUBBBUUUUBUUUUUUU
UUUUUUUBUUBUBUBUUUUBBUUBUUBBUUBUBBUUUUUUBBUUUBUUBUUUUUBBUUUBUUUBBBBUUUBBUBUBBUUUUUUUUUBBUUUBUUUUUBUBB
UUBUBUUUUBBUBUUUBUBUUUUBUBBUBUUUUBBUUUUUBUBUUUUUUUBUBUBBUBUUUUUUUBUUUBBUUUBUBUUUUUBBUUUUUUBUUUBUUBUUU
BUUUBBUUBUBUBUBBUUBUUUUBUUUUUUBUUUBBUBUUBUUUBBUBUBUUBUBBUBBUBBUUUUBUBBUBBBUUBUBBUBUUBBUUBBBUUBUUUBUUU
