UBUBUUUUUUUBBBBBUUUBUUUBUUBUUUBUBUUUUBUUUUBUUUUUUUBUUBBBUBUUUUUBUBUUBUBUUUUUUUBUUUUUUUUBBUBBBBUUUUBUU
UUBUBBUUUUBUUUUUUUUUUUUUUUUUBUBUUUBUUUUUUBUUBUUUUUUUBBBUBUUBBUBUUUBBBUBUUBUUBUBUUUUUUUBUUUBUUUUUUBBUU
BUUUUUUUUBUUUUUBBUUUUUUBUUUUUUUBUBUBUUUUUBUUUUBUUUUUUUUUUUUBUUBBUUUUBBBUBUBBUUUUUUUUBUUBUUUBUBUBUUUUU
BUBUUBUUUUUUUUUUUBUUBUUUUUUBUUUUUUBUUUUBUBUUBUUUUBUUUBUUUUBBUBUUUBUBUUUBUUBUBUUUBBUUBUBBBUUUUUBBBUBBU
UUBUUUUUUUBUUUUBUUBBUUUUUBUBBBBUBUBBBUUUUBUUUUBUBUUUBUBBUBBUUBUBUUUUUUBUBUUUUUUUBUBUUBBUUUUUUBBUBBBBU
UUBBBBUBUBUUBUBBUUUUUUUUUUUBUUUUUUBBUUUUBUUUBBBBUUBBUBUBBBBUBUUUUUUUBUBBUUBUUUUBBUUUUUUBUBUUBUBBUUUUB
UBUUUUUUUUUUUBBUUUUUUUBUBUUUUBBUUUUUBUUBUUUUUBUUBUUUUUBBUUBBUUBUBUBUUUUUBBUUBBUBUBBUBBUBUUBUUUUUBBUUU
UUUUBBUBUUBUUUUUUUUUUUUBUUBBUUUUUUBUUUUBUBBUUUUUBUUUUUUBUUUUUUBUBUBBUUUBUBUBBUUUUBUUBUUBUUUUUBUUUBBUU
UUBBBUUBUBBUUBUUBBUUUUUUUBUUUUBBUUUBUUBBUBBUUUBUUUUBUBBBUBUUUUUUUUBUUUUBUUBUUUUUUBBUBUUUUUUUUBUBUBUUU
UBUUBUBBUUUUUUBUBUUUBUUUUUBUUUUUBUUUUBUUUUUUUUUUBBBUUUBUUUUUUUUBUBUUBUBUBUUUUUUUBUUBBBUUUBBUUBUUUUUBU
UUUUUUUUUUUUBUUUUBUUUUUBUBUUBUBBUUUUUUUBUBBUUUBUUUUBBUUUUUUUUUUBUUUUUUUUUBUBUUBUUUUUUUUBBBUUUUUUUBBUU
UUUUBUUUUUUUUBBBUUUBUUUBUBBUBUBUUBUBUUUUUUBUUBUUUUUUBBUBBBBUUUUUUUUBUUUUUUUUUUBBUBUBUUUUUUUUUBUUUBUUB
UUBUUUBBUUBBUBBUBBUUBUUBUUUUUUUUBUBBUUUUUBBUBUUUUUUUUUUUUBUUUUBUUBUBUUUBBUUUUBUUUBUUUBBUUUUBUUUUBUUBU
UUBUUUUUBUUBBBBUUBUUUBUUUUBUBUUBUBUUUUUUUUBUUUUBUUBUBUUUUUUBUUUBUBUUUUUUUUUUUBUBUBUUUUBUUUBUUUBUBUBBU
UUBUBUBUUUUUUUUUBUUBUUBUUBUBUUUUUUUUUUUBBBUUUBUUUUUUUUUUUUBUBBUUUUBUUUBUBUUBUBUBUUUUUUUUUUUUUBUUBUUBU
UUUBBUUUUUBBUBUUUUUUUUUBUBUBBBBBUUUBUUUUBUBBUUUUBUUUBBBBUBUUUBUUUUBUUBUUBBUUUUBUBBBBBUUUUUUUUBBUUBUUU
BUUBBBUBUUBUUBUUBBUBUUUUUUUUBUUUBUUUUUUBBUBUUUBUBUUBBUBUBBUUUUBUBBBUBUBUBUUUBBUBUUUBUUUUUUUUUBUBUUUUU
BBUUUBUUUUUUUUUBUUUBUBUUBUUUUUUUUUUUBUUBUBUUUBUUBUBUUUUUUBUBBUUUUUUUUUUUUBUUUUBBUUBUUUUBUUUBBUBUUBUUU
BBUUUUUUUUBUUUBUBUBUBBUUUUUUUUUUUBUUUUBUUUUUBUUUUUUUUUUBUUUBBBUUBBBUUUUUBBUUUBBUUUUUUBBUUUUUBUUBUUUBB
UUBBUUUUUUBBBBUUUUUBBUUUBUBBUBUBUUUUUBBUBUUBBUUBUUBUUBUUUUUUUUUBBBUBBUUUBUUBBUUUUUUBUBBBBUBBUBBUUUUUU
UUBUUUBBUUUUUUUUUUUUUUUUUUBBUUBBUUUBUUUBUUBUBUUUUUUUUUUUBUUUBBBBUUBUBBBUUUBBBUUUUUUUUUUBUBBUBUUUBBUUU
BUUUBUUUUBUUUBBUUUUBUUUBBBUBBUUUUUUUBBUBUUUUUUUBBUUUUUUUBUUBUUUUBBBUUUUUUBUUUUUUUBUBUUUBUUUUUUUUBBBUU
UBUBUUUUUUBUUBUUUUBUBUUBBUUUUBUUUUUUBUUBUUUUUUUUBUBUBUUUBUUUUBUUUBUUUBUUUUUUBUBUUBUUUUBUUUUUUUUUUUUUU
UUUBUUUBUUUBUUUUUUUUUUUUUUUBUUUBUBBBUBBUUUBBUUBUUUUUUUUBUUUUUBUUBBUBUBBUUUBUBUUUUUUBBBUUUUUUBUBUBUBUU
UUUUBBUUUUUUUUUUUBUUBUUUUUUUUBUUUUUUUUUUUBUBBUUUUBBUUBBBUUUUBBUUBBBBUUUBUUBUUBUBUUUUBUBBBUUUUUUUUBUUU
BUUBUUUUUUUBUUBUUUUUBUUUUUUBUUBBUBBUUUUUBBBUUBBBUBBUUBUBBUUUUUUBUUUBUUUBUUUUBUUUUUBUBBBBUUUUUBBUUBUUB
UUUBBUUUBUUBBUUUUUUUBUUUUUUUBUUUUBBUBBUBBBUUBBUUBBUBUUUUBUBUUUBUBUUUBUUUUUBUUUUBUUUUBUUBBBUBUUBUUUUUU
BUUBBUUUUUUUUUUBUUUUBBBUUUUUBUUUBBUUUUUUUUBBUUUUUUUUUUUBUBUUBBBBUBUUUUUUBBUBBBBBUBUUBBUUBBUUBUUUUUUUB
BBBUBUUUUBUUUUUUUUUUUBUUBUUBUUUUUUUUUBBUBUUUBUUUBUBBUBBUUBUUUUBBUBBUBBUUUUBUBUBUUUUBBUUBUBUBBUUUUBBUB
BBUUUUUUUUBUBBUUBBUUUBUBBUBUBBUUUUUUUUBUBBBUUUUUUBUUUUUUUUUUBBUBUBUUUUUBBUBBUUUUBUUUUBUUUUUUUUUUUUBBU
UUUUUUUUUUUBUBBBUUBUUUUBUUBUUUUUUBUBUBUUBUUUUUUUBBUUBUUUUUUUUUBUUUBUUUUUUUUUBUBUUUUUBUBBUUBUUUUUUBUBU
BUUBUBUUUBBUUUBUUUBUBUUUUUUUUBUUUUUBBUUBUUBUUUUBUBUBUUUUUUBBUUUUUUUBUUUUUUBUUUBUBUUUUUBUUUUUBBUUUBUUU
UUUUUBUUBUBUUBUBBUUBUBBUUUUUBBUUUBUBBUUUBUUUUUUBUUBUUUUUUUBUUUBBBUUBUUBUUBUBUBUUUUUUUUUUUBBUBBUUUBUUU
UUBBUUBUBUUUBUUUUBUUBUUUUBBUUUUUUBUUUUUBBUUBUBUUUBBUUUUBUUBUUUUUUBBBUUBUUBUUUUUBUBUUBUUUUUUBBUUUBUUUB
BUUUUUBBUUUUUBUUBBUUUBBUUBUBUBUUUUUUUUBUUUBUBUUUBBUUUUUUBUBUUUUUBBBUUBUUBBUUBUBUUBUUBUUBUBUUUBUUBUBUB
UUUBUUUUBUBUUUBUBBBUUUBUUBBUBUUUBBBBUUUBUUUBBBBUUUUBBUUUUUUUUUUUBUBUUUUUUUUBUUUUUUBBUUBUUUBBBBBUBUUUB
BBUBBUUUBUUBUBBUUUBUBUUUUBUUUUUUUUUUBUUUUUBUBUUBUUUUUUUUUUUBBUUUUBUBUUUBUUUBUUUBUBUUBBUUUUBUBBUUUUUUU
UUBUUBUBUUUUUUUBBUBUUUUUBUUUUBUUBUUUUUBUUUBUUUUBBUBUUBBBBUUBUUUUUUBUUUUUUUUUUUUUBUUUUUBUUUBUUUUUUBUUU
BUUUBUUBUUUUBUUUUUUUUBUUUUUUBBBUBUUUUUUBUUBUUUBBBUUBBUUUUUUUUBUUUBUUUUUUUUUBUBUUUUBUUUUBUUUUUUUUBUBBU
UUUUUUBUUUUBUBUUUUUBUBUUBUBUUBUUUUBUBUUUBBBUBBUUBBUUUUUUUUUBUBBBUBUUUUBBBBUBBUUBUBUUBBUUBUUUUUBUBUUBU
UUUUUBBUUUBUUUBUUUUUBUUUUBUUUUUBUUUUUUUBBUUBUBUUUUUUBUBUUUBBBUBBBBUUUUUBUUUBBUUUUUUUUBUUBUUUUUUBUUUBU
UBBUUBUUUUBUUUUUUBBUBUUBBBUUUBUUUUBBBUUUUUUUBBBUUUUUBUUBUUUUUBBUUUUUUUBUBUUUUBUUBUUUUBUUBBBUBUUUUUUUB
UUUUUUUUUBUUUUUUUBUUUUUUBBUUUUUUUUUUUUUBBUUBUBUUBUUUBUBUUBBBBBUUBBUUBUUUUUUBUBBBUUBUUUUUBBUUUUUUBBUUU
UUUUBUUUUUUBBUUUUUBUBBUBUUUBUUUUUUUUUUUBUUUUBBUUBBUUUUUUUBUUBBUBBUUBUUUBUBUUUUUUUBBUUBBUUUUUUUUUUUUUU
UUBUBBUUUUBUUBBBUUBBBUUUUUBUUBUBUUUUUUUBBUBUUUBUUUUUUUUBUUBBUUBUBUBUUUUBBUUUBUUBBUUBUUUUBBBUBBBUUUUUU
BUUUUUBUBBBUUUBUBUUUUUUUUBBUBBUBUBUUBUBUUUUUBUUUBBUUUUUUUUBUUUUUUUUUBUUUUUUUUUBUUUUUUBUBUBUBBUUUUUUUB
UUUUBUBUBUUUUUUUUUUBBUUBBUBBUUUUBUBBUUUUUUBUUUBUUBUUBBBUUUBUUUUUBBUUUUUUUUUBBUUUBUUBUUUUUUUBUUUBBUUUB
UUUUBUBUUUUUUBBUBUUBBUUBUUUUUUBUUUUUUUUUUBBUBUUBUUUUUUUBUBUUUUUUBUBBBUUUUUUBUUUBUUUUUUBBUBUUUBBUBUUBB
UUBUUBBUUBBUUUUUUUBBUUUUUBBUUUUBBUUUUUUBUUUUBUBUUUUUBUUBUUUUUUUUUUUBUBBUBUUUBBBBUBUUUBUUUUUUUBUUUUBUU
UUUUUUUBUUUUUUUBUUUBBUBUUUUUUUBUUUUUUUBUUUBUUUUBBUUUBUUUUUUUBUUBUUUBUUBBBBUBUUBUBBBUBUBUUBUUUUUUBUUUU
BBUUUUUUUUUUUBUUUUUUUUBBUUBBUUBUBBUUUBUBBBUBBUUUUUBUUBUUUUUBUBBUBUUBUBUUUUUBBUUUUUUUUUBUBUUBUBUUUUUBU
BUBUUUUUUUUUUUBUUBUUUBBUBUUUBUUBUBUUUBUUBUBUUUBUUBUUUUUBUUBUBUBBUUUUBUBUBUUUUUBUUBUUUUUUUBUUUUBUUBUUU
UBUUUUUUBUUUBUBBUUUUUUUUBBBUUUUUUUUUUUUUBUBBBUUUUUUUBBBBBBUBBBUBUBBBUUBUBBUUUUUBUUBUBBUUUBUBBUBUUBUUU
BBBBBUBBUBBBUBUUUBBUUUUUUUUUUUBUBUUBBUUUUUUBBUBUUBUBBUUUBUBUBUBUUUUUBUBUUBUUUUUUUUUUBUUUUUUUUUBBUBBBB
UBBUBUUUUBUBBUUBUUUUUBUUUBUUBUUUBUBUUUUBBUUBUUUUBBBBUUBBUBBUUBBUBBBBUUUUBUUBUUBBUBBUUUUUBUUUUBUUUUUUU
UBUUUBUUBUUBUUUBUUBUUBUUUUBBUBBBBBUUUUUBUUBUBBUBBUUUUUUUUUUBBUUUUBBUUUBBUUBUUBUUUUBUBBUUUUBBUUUUBBUUU
UBUUUUUBBBUUUUBBUUUUUBUUBBUUBUUUUUUBUUBUUUUBUUUUBBBUUUUBUUBUBUBBBUUUUUBBUUUBBBUUUUUUUUUUUUBUUUUUUBBUU
BUBUUBUUUUUBUUUUUBUBBUUBUUUBUBUBBUBBUUBUUUUUUUUBUBUUUUUUUBBUUUUBUUUUBUBUBUUUUUUBBUUUUBUBUUBUUUBUUUUUB
UBUUUUUBBBUUUUUUBUUUUUUUBUUBUUUUBBBBBUUBBUUUBBUUUBUBUUBBUUBBUUUBUBUUBBUUUUBBUUBUUUUUUBBUBUUUBUUUUUUUB
UUUUUUUBBUUUUBUUBUBUBUBUUBUUBUUUUUUUUBBUUBUUUUUBUUUBUUUUUUUUBUUUUBBUBBUUUUUBUUUUUBUUUUBUUUUBUUUUUUBBU
UUUUUUUUUUUUBUUBUUUBUBUUUUBBUUUUUUUUUUBUUBUUBUBUUUUUUUUUUUBUUBUBUUBUBUUUUBBUUUUUUUUUBUBUUBBUUUUBUUUUU
UUUUUUUUUUUUUUUUUUBBUUUUUBUBUUBUUUBUBUUUUUUBUUUUBBUUBUUUUBUUUBUUUUUUBUUBUUBBUUUBUUUUUBUUUBUBUUUUUUUUB
BBUBBUUBUUUUUBBUUBUUUUUUUUUBBUBUUBUUBBUBUUUUBBUUBUBUUBUBUUUUUBUBUBUUBUBBBUUUUBUUUUBUUUUUBUBUUUUUBUBUU
BUUBUBUBUUUUBUUUUUUUUBBBUUUUUUUUBUUBBUUBUUUUUUUUBUUUUUUUUUUUUUUBUBUUUUUBUBBUUBBUBBBUUUUUBBBBBUUBUUBUU
UUUBUUUUUUUUUUBBUUBBUBBUUUBUBUBBBBUUBBBUBUUUUUBUUUUUBUUUUUUUUUUBUBUUBUUBBUBUUUUUBUUUUUBUUUUUUUUUBUBBB
UBUUBUBBUUBBUUUUUUBUUBUBBBBBUUUUUUBBUBUUUUUUUUUBBBUUUUBUUUUUUBUUUUBUUUUBBBUBBUUUBUUBUUBBUUBBUUBUUUUBU
UUBUUUBUUUUBUBBUBUBUUUUUUUUUUUUUUUUBUUBUUBUBBUUUBUUBUBBUUUUBBUUBBUBBUBUBUUUUUUBUUBUUBUUUUUUUUUUBUBUBU
BBUUUUUUUUBBUBUUUUBUUUUUBUUUUBBUUUUUUUUBUUUUUBUUUUBBUBBUBUBUUBUUUBUUUUBBUUUUUBUUUUUBUUBUUUUUUUUUUUUUU
UUBBUBUBUBUBUUUUUUUBUUUUUBBUBUUUBUUUUUBUUBUUUUBUUUUUBUBBUBBBUUBUBUBBUUUUUBBUUBBUBUUUUUUUUUUBUBBUUUUUB
UUUUUUUUBUUUBUUUUUUUUUBUUUUUBUUUBUBUBUUUBBUBUUUUUUBBUBUUBUUBBUBBUUUUUUUUUUBUBBUUUBBUUUUBBUUUUBBUBBUUU
UUUBUBBBUUUBUUUUBUBBBUBUBUUBBUUUUUUUUUUUUUUUUUUUBUBUUUUUUBUBUUUUUUBUUUUUBUUBBUBUUBBBBUUUUUUUUBUUUBBUU
UUBUUUBUUUUUUUBUBBUUUUBUBUUBBBBUUBUUUUBBUUUBBUUUUBUUUUUUUUBUUBUUUUUUUUUBUUBBBUBUBUBBUUBBUUUUBUBUUUUUB
UBUUBUUUUUUUUUBUUUUBUUUBUUUUUBUUUBUUUUUBUBUUBUUUBUUBBUUUUUUUBUUBUUUUUUBBUBUUBUUBUBUUUUBBUUUUUUUBUUBUU
UBUUBBBUUUBBUUUUBUUUBUUUBUUUUBBUBUUUBUUBUBBUUUBUBUBUBBUUBUBUBUUUUUBBUUBUBBUUUBBUUBUUBUUUUUUUUUUBUUUUB
UUUUUUUUUBUUUBUBUUUBBUUBUBUUUUUUBUUUBUUUUBUUUUUUUUUBBUUUUUBBUUBUBUUUUUBUUUUUUUUUUUUUUUUBUBUUUUBUBUUUU
UBUUUBUUUUBBUBUUUUBUUUBBBBUUUBBUUUUBUBUBUUUUUUUUBBUUUUUBUBUUUUUUBUBUUUUUBUUBUBBUUUUUUUBBUBUUUUBUUUUUU
BBBBUBUUUUBBBBUBBUUUUUUUUBUUUUBUUUUUBBUBUUUUBUUBUBUUUUBUUBUUUUUUUBUUUUBUBUUUUUBUUBUUUBUBBUBBBUUBUUUBU
UUUUUBUUUBUUBUUUUUBBUBUUBUUUUUUUUUUBUUUUBUUUBUUUBUBUUUUUUUUUUBUUUBBUUUBBUBUUBUUUBUUUUUUBUUBBUUBBUUUUU
UBUUBUUUUBBUBUUUBUBUUUUUUUBBUBUUBUBUUUUUUUUUBBUUBUUUBBUBUUUBUUUUBBBUUUUUUBUUUBUBUBBUUUBBBBBBUBUUBUUBU
UUBBUUBUBBBUBBBUUUUUBUUUUUBUUBUUUUUUUUUUUUUUBUUUUBUUUUUUBUBBUUBBUBUBUUUBUUUUUUUBUUUUBBUBUUUUUUBUUBUUU
UUUUUBUBBUBBUUUUUUUUUUUBUUBUUBUUUBUBUUUBBUUBUUBUUUUBBUUUUUUUUBUBUUUUBBUUUUUBBUBUUBBBUUUBUUUUBBUUUUUUB
BUUUUBUUUUBBBBBUUUUBUUUUUUUBUBUBUUUUUUBBUUUBUUUBBBBUBUUBUBUUUUUBUUBUUUUBBUBUUBBUUBUUUBUUUUUUUUUUBBBBU
BUUBUBUUBUUBUBBUUUBUBUUUBUBUUBBUBBUUUUUUUUUUUUUBUUUUUBUBUBUBUBUBBBUUUUBUUUUBBBBUUUUBBUUUUBUUUUBUBUUBB
UUBBUUUUUBUBUUBBBBBBUUUUUUUBBBUUUUBUBUUBBBUBUUUBBUBBUUBUUUUBUUUUUUBBUUUUUUBUBBUBUBUUUUBUUBUUUUBBBBUBU
UUUUUBUUUBUUUUUUUUUUUBUUBBUBUBBBBBUUUBUUUBUBUUBUBUUUBUBUUUBUUUUUUUUBUUUBUUUBBUUBUUUBBUUUUUBUUBUUUUBUU
UBUUBUBUUBBBUUUUBUUUUUUUUBBUUBUUUUUBBUUBBUUUBUUUBUUBBUUBUBBBBBBUUUUBUUUUUUUUUUUBBUUBBUBUBUBBUBUUUUUUB
UUUUUUBUBBUUUUUBBUUUUUBUUBBUUUUUBUBUUBBUUBBUUUUUUUUBBUBUUUUUUUUUUUUUUUUUBBUBUUBBUBUUUUUUUBUUBUUUBBBUU
UBUUUBBUBBUUUUUBBUUUBUBUUBBUUUUUUUUUBUBUUUUUUUUUBBUBUBUUUUBBUUUUBUUUBUUUUUBUUUUBUUUBUUUUBBBBUUUBUBUUU
BUBBBBUUUUUBUUUUUUUUUBUBUUBUUBUUUUUUUUUUUUUBUBUUUUBBUBUUUBBUBBUUUUUUUUUUBBUUUBBUBUUUUUUUBBUUBUUUUUUUB
UUUUUBUBUUUBBUBBUBBUBUBUBUUUUBBUUUUBUUUUUUUUBUBUUBUUUBUUUUUUUUUBUUUUBUBUBUBUBBBBUBUUUUUUUUUBUUUUUUBUU
UBUUUUUUUBBUBBBUUUBUUUBBUUUUUBUUBBUUUUUUUUBBUBUUBBBBUUBUUBUBUBUUUUUUUBUUUUUUUUBBUUBBUUBUUUBBBUBUUBBBB
UUUUUUBUBUBUBUBBUBBUUUUBUUUUBUBUUBUUUBUUUBUUUUBUBBBBUUUUUBUUUUBUUUBUUUUUUUBBUUUBBBUBUUUUUUBUBUUUUUUUU
UUUUUUUUUUUUBBBUBUUUUUUUUUUBUUUUUUUUUUBUUBUUBUBBUUUUUUUUUUBBUBUUBBBUUUBUUUBBBUUUUBUUUUUBUUBUUUUUUBUUU
BUUUUUUBBUBUBBUBUUUUUUUUUUUUUBUUBUBUUUUUUBUBBBUUUUUBUUUBBBUBUUUUUUUBUBUBUUUUBUUUUUUBBBUUUUUUUBBBBBUBB
UUUUBUUUUBBUUUBUUBBUUUUUUUUUUUUUUBUBBUUUBUUUBUUBUUUBUUBUUUUBUUBUUUUUBUUUUBUBUUBUUBBUBUUBBUUUUUBBBBUUB
BUUBBUBBUUUBUUBUUBUUUUUUUUUUUUBUUUUUUBBBUUBUBUUBUUUBUUBUBUUUUUUUUUUUUUUUUBUUUBUBUBUUUUUUUUUUBBUUUBBUU
UUBBBBBBUUBBUUUUUUUBUUUUUBBBBUUUBUBUUBUUUUUBUUUUBUUUUUUUBUUBUUUUBUUUUUUUBUUUUUUBUBBBUUUBUUBBUBUUUUUUU
BUBBBUBBUUUUUUUUUBUBUBBUUUUUUBUUUUUUUBBUBUUBBUUUBUUBBUBBBUUUUBUUUBUUUUUUUUUUUUBUUBUUBUUUUUBUUUBUUUUUU
UUUUUBUUUUUUUBUUUBUUUUBBUUBUUUUUUUUUUBBUUUUBUUUBUUUBUUUUUBUUBUUUUUBUBUUUUUUUUBUBUUUUUUUUUUUBBBUBUUUUU
UUUBBUUUUUUUBUUUUUBUUBUUBBUBBBUUUUUUUBUBBBUUUBUUBBUUUUUUBBUUUUUUUBUUUUUUUUUUUBBBBUUBUUUBBUUUBUBUUUUUU
UBBUUUUBUUUBUBUBBUUUUUUBUUUUUUUUUUBUUUUUUUUUUUBBBUUUUUUBUUUUUBUUBUBUUBUBUBUUUBBUUUUBBUUBUUUBBBUBBUUBU
