UUUUUUUUUBBUUUBBBBBUBUUBUUUBBUBUUBUUUUUUUUBUBUUBUBBBBUUUUUUBBBBUBBUUBUBUUUUUUUUUUUUUUUUBUUBUUBUUBBUUU
UUBUUUBBUUUBBUBBUUUUUUBBUBUUBBUUUBBBUBBBUUBUUBUUBUUUUBUUBUUBBUUUUUUUUUUBBUUUUUBBUUUUUUBUBBBBBUUUBUUBU
UBUUUUUUUUBUBUBUBUBUUUUUUBUUUUBUBUUUBUUUBBUUBUUBBUUUUUUUUUUUUBUUUBUUUBUBBUUUUBUUUUUBUUBUBUUUBBBUUUBUB
UBBUUUUUUUUBUUUBBBBUUUUBBUUBUUUUUUUUUUUBBUUBUUUUBUUUBUUUUBUBUUUUUUBBBUUBUUUBUUUBUUUBBUBUUUBUBUBUUUUUU
UBUUBBBUUUUUUBUUUUBUUUBUUBBBBUUUBUBUUUUUUBUUUUBUUUBBUUUUUUBUUUUBBBBUUUUUUBUUBBBUUBBUBBUUUUUBUUUBUUUBB
UBBBUBUBBUUUUUBUUUUUUUBBUUUBUUUUUUUUUUUBUUUUUUBUUUBUUBUUUUBUBBBUBBUBUBUUUUUUUUUBUUBUUBUBUUUUUBUBUUUUB
UUUUBUBUUBBUUUUUBUUUUUBUUUUUUUUUUUUUUUBUUUBUUBUBUUUBBBUUBUUBBUUUUBUBUUBUUUUUUBUBUBUUUUUBUUUUUUBUUUUUU
BUUUBUUBUBUUUUUUUBUBBBUUUUUBUUUUUUUBUUUBUUBUUUUUUUUUBUBUBBUBUUUUBUUUUUBUUBUBUBUUBBBUUBUUUBBBUUUUBUUUU
UBBBUUUUBUUBBUUUBUBUUUUUUUBUUBUUUUUUUBBUBBUUUBBUBUUUUUBUUUUBUUUUUUBBUBUBUUUUUUUBUUBUBUUUUBUBUUUBUBBBU
UUUUUUUUUBUBUUBUBUUUUUUUUUBUUUUUUBUUUUUUUBUBUUBUUUUUBUUUUUBUBUUBBBUUUBBBBBUUBBBUUUUUBUUUBBUUUBUUUUUBU
UUBBBUUBBUUUUUBUUBBBUBUUUBUUBUUUUBUUBBUUUUUBUUUBUUBUUUUUBUUUUUUUUUUUBUUUUUUUUUUUBUUUUBUBUUUUUUBUBBUBU
UUUUUUUUBUUUUBUBBUUBUBUBUUBUBUBUUUBBUUUBUBUBUUUUUUUBUUBUUUUUUUUUUUUBUBUUUUBBBBUUUUBUBBUUBUUUUUUUBUUUU
UBUUUUUUUUBUBBUUUUUUUUUUUBBUUUBUUUBUUUUBUBUUUUBUUUBUUBUUUBUUUBUUUUUUBUUBUUUUBUBUUUUUUUBUUUUUBUUUUUBUU
UUUUUUUUUUUBUUBUBBBBUUBBUUUUUUBBBUUUUUUBBBBUUBUUBUUBBUUUUBUUUBBUUBBUUUBUUBBUUUUUUUUUUUUUUBUUUUUUUUUUU
BUBUUUUUBBUUUUUUUUUBUUUUBUUUUUUUUBBUUUUUUBUUUUUUUUUUBUUBBUBUUUUUUUUBUUUUUUUUUUUUUUUBUUBBUBUUUUBUUUBUU
UUUBBBBUUUBUUUUUUBBUBUUUUUUUUUUUBUBUUUUUUUUBUUBUUUBUBBBUUUUUUUUUUBUBUUUBUUUUUUUBUUUUUUUUBUUBUUBUUBUUU
UUUUBUBBBBUUBUBBBUUBBUBUUUBUBBBBUBUUUUUUBUBUUUUUUUUBUUBUUUUUUUBBBUBBUUBUBUUUBUUUUUUUUUUUUUUUUUUUUUUUU
UBUUUUUBUUBUUUBBUUBUBBUUBUUUBUUUUUUUUUBUUUUBBBBUUUBUBBBBBUUUUBUUUUUBUBUUUBUUUUUUBBUUUBBUUUBUUUUUUUUBU
UUBBUUUBBUBUBBUBUUUUUUUUUUUBUUBUUUBBBUUUUUBUBBUUBUBUBBUUUBUBUBBUUUUUBUBUUUUUUBUUUUUUBUUBBBUUUUUUBUUBU
UUUBUUUBUBUUUBUUUBUUUUBUUUUUUUUUUBUUBUBUUUBBUBBUUUBUUUBBUBUUUUUUBUBUUBBBUUUBUUUUUUUBBUBBUUBUUUUUBBUUU
UUUUUUUUUUUUUUUUUUBUUBUBUUBBBUUBUUUUBUUUUUUUUUBUUBUBUBUBUBUUUUUUUUBUBUBUUUUUUUBUUUUUUUUUBUUBBUUBUBUUU
UBUUUUUUUUUBBBUUUUUUUUUUUUBBUBUUUUUUUUUUBBBUBBUUBBUUUUBBUBUUBUUUUUBUUUBUUUUBUUUUUUUUUUBBUUUUBBUUUUUUU
UUUUUUUUUUUUBBUUUBUUUUBUUUUBBUBUBBBUBBUUUUUUBUBUBUUUUBUUUUUBBBBUUBUUUUBUUUUBUUBUUUBUUUUUUBBUUUBUBBBUB
UUUUBUBBUUUUUUUUUUUUUBBUUUUUUUUBUUUUUBUUUUBUUUBBUUUUUBUUUUUUBBUUUUUUBUBUBBUUUUUUBUUUBUUUUUBBUUUBUUUUB
UUUBBUUBUUBBBUUUBUUUBUUUBUBUUUBBBUUUUBUBBBUUUUUUBUBUUUUBUBUBUUUBBUUBUUBUBUUUBBUUUUBUUUBBUUBUBUBUUBBUU
BUBUBUUUUBUUUUUUBUUUBUBUUBBUBUUUBUBUBUUUBBBBUBUUUUUBUUBUUBBUUUBUUUUUUUUBUUUUUUUUBUUBUUUBUUBUUBUUBUBUB
BUUUUUUUUUUUUUUBUBUUUUBUBUUBUUUUBUUBUBUUUUUBBBUUUBBUUBUUUBBUUBBUBUUUUBBUUUUUUUUUUUUUUBUBBUUUBUUUUUUBB
UUUBBBBUUBUBUBUBUUUBUUUUUUUUUUUUUUBUUUUBUUUUUUUUBUUUUBBUBUUBUUUUUBBUUUBUUBBBUUBUUUBBUBBUUUUBUUUBUBBUB
BUBUUUUBUBBUUUUUBUBBBUUUBUUUUUUUUUUUUUUUBBBUUUUUUUBUUBUUBUBBUBUBBUUUUUBUBBUUUUBUUUUUUBUBUUUUBUUUUUUUB
UUBUUUBBUUBUUUBBUUBUUBUBUUBUUUUUBUUUUUUUBUBBUUUUUUBBUBBUUUUUUUUUUBUUUBUUUBBBBUBBUUUUUUUUUBUUUUUBUUUUU
UUBUUUUBBBUBUUBBUUUUUBUUUUBBUUBUBBBUUBBBUBBUBUUBUBBUUBUUBUUUBUUBUUUUBUUBBUUBUBUUUUUUUUUBBUUBUBUUBBUUB
UUUBUUUUUUUUUBUBBUUUUUBUUBBUUBUBUUUBUUUUBUUUUUBBBBUBBUUUUUUUUBUUUUUBBUUUBBUUBBBUBUUUBBUUUUUBBUUUUUUBU
BBUUBBUUUBUBUBUUUUUUBUBBUBUUUUBUUBUBBBUBUUBBUUBBUUUUUBUUUBBUUUUBUUUUUUUBBUUUBUBUUBUBUBBBUBUUUBUUBBUUU
BUUUUUBBUUBUUUBUUUBUUBBBBUUUUUUUBBUUUUUBUBBBBUUUUUUUUUUUUUUBBBBUUUUUUBUBBBBUUUUUUBBUUUUUUUUUUBBUUUUUB
UBUUUUUUUUBBUUBUUUUUUUUUBUUUBBUUUUUUUUUUBUBUUBUUUUUUBBUBUUBUUUUUBUUUBBUUUUUUUUUUUBUUBUUUBUBBBBUBUBBUU
BBBUBBUUUUBUUUUUBUUUUUUBUBBUUUUBUUUUUUUUUUUBBUUUUBUBUBBUBUBBBBUBBUUUUUUUUUUBUUUUUBUUBUUUUBUUUUUUUUUUB
BUBUUUBBUBUBBBUUUUUUBUUBUBUUUUUUUBUUUUUUUUBUUBUUBBUBBUUUBBUUUBUBUUBBUUBUUUUUUBUBBBUUUUUBUUUUUUUUBUBUU
BUBUUUBUBUUUUUBUBUUBUUBUUBBBUUUBUUUUUBUUUUUUUUUBUBBBUUUBUUUUUUBBUUUUBBUUUUUUBUUBUUUBBUBUBUBUBUBUUUUUU
UUUUBUUBUUUUBUUUUBUUBBBBUUUBBBUUUBBBUUUUUUUUUUUBUBUUUUUUBBUUUUUBUUUBUUUUUBUUUUUUBUUBUBBUUUUUUBBBUUUUU
BUBUBUBBBUUBBUUBBUBUUUBBUBUUUBUUUBUUUBBUUUBBBUUUBUUBUUBUUUUBUUUBUBBBBUUBUUUUBBBUBUBUBUUUUUUUBUUUBUUUU
BBBBBUUUUUBUUUUUBBUBUUUUBUBUBUUUUUUBBUUUBUUUUUBBUUBUUUUBUUUUBBUUUUUUUUBUUBBUUUUBBUUUUUUUBUUBUUUBUBBBU
BUUUUUUUBUUBUUBUBUBUUUUUUUUUUBBBUUBUBBUBUUUBBUUUUUUUUBUUBUUUBBBUUUUBBUUUBUBBUBBUUUUBUUBBUUUBBBUBUUBUU
UUUUUUBUUBUBUBUBUUUUUUUUBUUBUBUUUUUBUUUUBUUUUBBUBBUUUUBUUBUUBBUUUUUBUBUBUUBUUBUUUBBUUUUUUUUUUUUBUUUUU
UUUUUUBBUUUUBBUBUUUUUUUUBUUUBBUBBBUUUUBUBUBUUBBBBBUUBBUBBBUUUUUUBUUBBBUUBBUUBUBUUUUUUUUBBUUUUUUUUUUUU
UUBUBBUUUBUUUUUBBUUBUUBUBUBBUBBBUBBUBBUUUUBBUUUUUUUBUUUUUBUUUUUBBUBUUUBUBUUUUUUUBUUUUUUUUUUUUBBUBBBBU
BBBUUUUUUUUUUBUUUUBUUUUUUUUUUUUUUUUBUUUBUUBBUBUUUBUBBUUBUBUUUBUUUUUUUUUUUUUUUBBUUUUUUBUUUBBBUUBUUBUUU
UUUUUUUUUUBUUBUUUUUUUUUBUUUUUUUUBUUUUUUUBUUBUUUUBUUUUUUUUBUBUBBUUUUUUUUUUUUUUBUUBUBUUBUUUUUUUUUUUBUUB
UBUBUUUUUUUBUUUUUBUUUUBUUUUUUBBUBBUBUUUBUBUBBUUUUUUUBBUBUBUUUUBUBUBUUUBUBUUBUUBBUUBBUUBUBUUBBUUUUUUUB
UUUBUUBUUUUUUBUBUUBUUUBBUBUUUBUUUUUUBBBUUUUUUUUUUUBBBUUUUUUUBUBBUBBBBUUBUUUBUUUUUUUUUUBUUUUUUUUUBUUBU
UUUUUUUBBBBUUBBUUUUUUUUUBUUUUUBUUUUUUUUUUUBUBUBBUBBUBUUUUUUUUUBBUUUUUBUUUUUBUUUUUBUUUBUBBUUUBUBUUUUBU
UUUUUUBUUBUUUUUUUUBUUUUUUUBUUUUBBUUUUUBUUUUUUUUBBUUUBUUUUUUBUBUUBBUUBUBBBUUUUUUUUUBUBUUUUUUBBUBUUUBUB
BBUUBUBUUUUUUBUUBUBBUUBUUBUBUUBUBUUUUUUBUUUUUUBUBUUUBBBUUUBBUUUUUUUUBUUUUUBUBBUBUUUUUUBUUUBUUUUUUUUUU
UUUBUUUUUUUUUBUUBBUUBUUBUBUUBBUUUBUBUBUUUBUBUUBUBUUUUBUUBUBBUUUUUBUUUBUUUUBUUBUUBUUUUUUBUUUUUBUBUBBUU
UUUUBUUBUBUUBUUUUUBUUUBBBUUUBUUUUUBUBBUUUUBUUBUBUUUUUUBBUUUBBUBBBUUUUUUUUUUUUUUUUUBUUUUBUUUBBBBBUBUUB
BUUUUUBUBUUUUUUBUUUUUUUBBUBUBUBUUUUUUUBBUUUUUUBUUUBBUBUBUUUUUBUUUUUUUUUBBUBUUUUUBUUUBUUBUUUUBUUUUBUUU
UUBUBBBBBUBUUUBBUUBUUBUUUUUBUUBBUUBUBUUBBUUBUBUUUUUUBBUBBUBBUUUBUUBUUUBBBUBUBUBBUUUUUUBUUBBUUUUUUBBBU
UBUUUUBUUBBUUUUUBUUUUUBUUBUUUUUUBUBUUUBUBUUUUUUUUBBUUUUUBUUUUUBUUBUUUUUUBUUUBUUUUUBUUBUUBUBUBUUUUUUUU
UUUUUBUUUBUBUUUBUUBUUUUUUBUBUUUUUUUUBUBBUBUUBUBBBUUUBUUUUUBUBBUUUUUUBUUBBUBBUUBUUUUUBUBUUUUUUBBUBUUUU
UBUUUUBBUUBBBBUUBUBUUUBUBUUUUBUUUUBUBBUUUUUUBUBUUUBUUUBUUUUBUUBUUBBUBUBBUUUBUUUUUUUUUUUUUUUUUUUUUUUBU
BUBBUBUBUBUBUUUUUBUBBUBUUBUBUUUBBUUBBBUUBBUUBUBUUUUUUUUUUUUUBBUUBBBBUUUUUBUUUUUUUUUBUUUUUUUUBUUBBUUUU
UUUUUUUBUUBBUBUUUUUBUUBUUUUUUUBBUUUBUUUUUUBUBUUUUUUUUUUUUUUUUUUUUUBBBUUBBUUUBUUBUBUUUUBUUUBUBUBUUUUBU
UUUBUUBUUUUBUUBUUUUUUUUBUUUBBUUBUBUBUUUBUUUBBUUUUUBUUBUUUBUUUUUBUUUBUUUBUBBUUUUUUBUUBBBBUUUUUUUBUBUUU
UUUUUUUBUUUBUUBUUBBUUBUUUUUBUBUBUUBUUBUUUBUUUUBUUUBUUBUBBUUUBUUUUUBUUUBUBUBUUUBUUBUUUUUUUUUUUUBBUBBBB
UUBUUUUUUUUBBUUUUUUBUUUUUBUUBUUBBUUUBUBBUUUBBUUUBUUUUUUBUUUUUUUUUUUUUUBBBBBBUUBUBUBBBBUBUUBUUUUUUUUUB
UUUUUUUUUBUBUUUUBBUUUUUBBBUUUBUUBUBUUUUUBUUUUUBBUBBBBUBUBUUBUBUBBUUUBBUUUUBUUUUUBUUUBUBUUBUBBUUUBBUUU
BUUUBBBUUUBUUBUBUUUBUBBUUUUUUUBUBUUUUUUUUBUUBBUBBUUUUUUBUBBUUUBBBUUUBBBUUUBBBUUUUBBUBBUUUBUBBBUUUUUUB
BUBBUUBUUUUBUUUUUBUUUUBUUUUUUUBUBBUUUUUBUBBUUUUBBUUUUUUUBBBUUUUBUBUUUUUBUBUUUUUBUUBBBUUBUUBUUBUUUUUUU
UUUBUUUUUBBBBUUUUBUUBUUUUBUUUUUUUUUUUUUUUUUBUUUUUBBBUUBUUUUUUBUUBUUUUBUUUUBUUUUBUUUUBBUUUUUBUUUBUUUUB
UUUUBUBBUUBUUUUUBBUUUUBUBBUUUBBUUUUBBBBUUBBUUUUUUUBUBUUBBUUUBUUUBBBUUUUBUUBUBUUUBUBBUUBUBUUUBUBUUUUUB
UUUUUUUUUUUUUBBUUUUUBUUUUUBUUUUUUUUUUBUUBUUBUUUUBUUBUBUUUUUUUUUBBUBUUUUUUUUUUUUUBUUBUUBBUBBUUUUUBBBUU
BBUUUUUUUUUBUUUBBUUUBUBUUBBUUUUBUUUUUUUUUUBUUBUUUUUUUBBUUUBUBUBUUUBUUBUUUBUUUUBUBUBUUUUBUBUUUUUUUUUUB
BUUUUUUUBBUUBBUBBUUUBBUBUBBBBUUUBBUUBUUUUUUUUBUUUUUUBBUBUUUUUBUUBBBUUUUBUUUUBUUBUUUUUUBBUBUBUBUBUBBUU
BUBUBUUBUUUUBUUUUBUBUUUUUBUUBUBBBBUUBUBUUBBUUUBBUUUBUBUUUUUUUBUUUUUUUUUUBBUUBBUUBUUUBBBUBUUUUBUBUBUBU
BUUUUUBUBUUBUBBUUUUBUUBBUBUUUUUUUUUUUUBUUUUUUUUUBUBUBUUBUUUUUBUUBUUBBBUUUUUUBBUUUUBUUBUUUUUUUUBBBUUUB
UUBBUBBUUUUUBUUBUUUUUUUUUUUUUUUUUUUUUUUUUUBUUUBUBBUBUBUUUUUUBBUUUUBUUBUUUUBBUUUBBUBUUUUUUBUUUBUBUBUUU
UUUUUBBUBUBBUBUUUUBBUUUUUUUUUUUUBBUBUUUUUBUBBUUBUUUUBUBBUUUBUBBBUUUUUBUUUUUUUUUUUUUUUUBBUUBUUUBUUUUUU
BBUUUBUUUUBUUUUUUUUUUUUBUUUUBUUUUUUUUBUUBBBBUBUBBBUUUUUBBBUUBUUUBUUUUBUBUUBBBBUBBBUUUBBBBUUUUUUBBBUUU
UUUBUUBUUUUUUUUUBUUUUUBUUUUUUBUBUBUBUBUBUUUUBBUUUUUBUBUUBUUUUUBUBUUUBUUUUUUUUUUUUUBBUUBUUBUUUBBUUUBBB
BBUUUUBBUUUUUBUUBUUBBUUBUUUUUUBUUUBUBBUUUUUUBUUBUUUUUUUUUUUUBUUUUUUUUUBBUUBBUUUUBUUUUUBUUBUBUUBUUUBUU
UUUUBUBBUUUBUUUUUBUUUUUBUUUBUUUBUBUUUUUUUUUUUBUUUUUBUUUBUUUUUUBBUUUUUBUBBUUUBBUBUBUUUUUUBBBUUBUUUBUUB
BUUBUUBBUBUUBUBBUUUUBUUBUUUBUBBBUBUUUUBUBUUBUUUBBBUUUUUUUUUBUUBBUUBUBUUUBUUUUBBBUBUUBUUBBBUUUBBUUBBUU
UBUUUBBBUUUBUBUUUUUBUUUUUUBUUUUBBUUBUBBUBUUBUUUUBBBBBUBUUUUUBUUUBBUUUUBUUBUUBUUUUUUBBUBUUBUBUUUUBBUBU
UUUBUUUUBUUUBBUBBUBUUUUUBUUUBUBUUBUUUUBUUBUUUBUUUUUUUUUUUUUUBUUUUUUUBUUUUUUBBUUUUUBUUBUUBBBUUUUUUUUUB
UUUUUUUBBUBBUUUUBUUBUUUUUUUUUUBUUBBUBBBUUUBUBBUUUUUUUUBUUBUUUUBUUUBBUUUUBUUUUBBBUUUUUUUUUUUUUBBUUUUUB
UUUUUUBUUBUBUUUUUBUUUBUBUUUUUUUUUUUUBUBUUUBBBUUUBUUBUUUUUUBUBBUUUUUUBUUUBUUUUBBBUUBBUUUBBUUBUUUUBBBUU
BBUBBBUUBUBUUUUUBUBUUBUUBBUUUUBUUUUBUUBBBUUUBBUUUUUUUUUBBUBUUUUUBBUBUUBUUBBUUUUUUUUUUBUUUBBUUBBUUUUBB
UBBBBBUUUUUUUUUUUBUUBUBUUUUUBUUBUUUBUBUUUUUUUUBBBBUUUBBBUUUUUUUUUUUUUUUUUBBBUUUUBUUUUUUUUUUUUUUUUBBUU
UUBUBBUBBUUUUBBBBUUBBBUBUBBBUBUUUUBUUBUUUUUUUUUUBUBBUBUBUBUUUUUUUUUUUUUUUBUUBUUUUUBUUBBBBUUUUBBBUBUUU
BUUUUUBUBBUUBBUUUBUBUUUUUUUBBBBUUUUUUUBBUUUBBBBUUUUUUUUBBBUUBUBBUUUUUUUUBUUUBBUBUUBUUBUUBBUUBUBUBUUBU
BUBBUUUUUUUBUUBBBUUBBUBBBBUBUUBBUUBUUUUBBBUUUUUUUUBBUBUUUBBBUUUUUUUBUUBUUUUBUUUUUUBBUBBUBUUBBUUUUUUUU
UUUUUBBBUUUUUBUUBBUUUUUUUBUUBBUBBBBUUBUUUUBBUUUUBBBUBUUUUBUBUUUUUBUUUBUUUUUBUUUUUUUUBBBBUUBBBBBUBUBUB
UUUUBUBBBUUBBUUBBBUBUUBUBUUUUBUUUUBUBBUUUUUUBUUUUBUBUUUBBUBBUUUBBUUUUUUUUUUBUBUBUBUUUBUUUUUUBUBUUUUUU
UBBBUBUUUBUUUUBUUUUUUUUUUBBUBBBUUUUUUUBBUBUUUUBUUBUBUBBBUBUBUBUBUUBUBBUUUUUUUUUBUBBUBUUUUBUBBUUUBUUBU
UUUBBUUUUUUUUBUBUUBBUBBUUUUUUUUUBUUBBUUBUUUUUUBBUBUBUBUBUUUBBUBUBUUUUUUUUUUBUBUUBUUUBBUUUUBBUBUBUUUUB
UUUBUUUBUUBUUUUUUUBUUUUUBBUUUBUBUUUBBUBUUBUBBUUUUUBUBUUUBUBUUUUBBUUUUUBUUUUBUUUBBBUBUBBUBUBBBUBBBUBUB
BBUUBUUUBBUUUUUUUUUBUUBUUBBBBUUUUUUBUUUUBUBUUUBUBUBUUBBUBUUUBUUUBUUUUBUUUBUBUBUUBUBUUBUUBBUBUUUBUUUUU
BUUUBBBUUUUBUUBUUBUUBUUUUUUUUUUUUUUUUBUUUBBBBUUUBUUUUUBUUBBUBUBUBBUBUUUBBUBBUUUUUUUUUUUBBUUUUUUBUUBBB
UUBUUUBUUUBUUUBBBUUUUBUUBUUUBBUUBUBUUUBUUBUBUUBUUUBUUUUUUUUBBBUBBUBUUUBUBUBUBUUUUBBUUBUUBUBUUBBUUBBUU
BUBUBUUUUUUUUUUUUBBUUBUUBUUUUUBUUBUUUUBUBUBUBUUUUUUUUUUUBUBBUUUUUUUBBBUUUUUUUUBBBUBUUUBUUBBBUUUUUUBBB
UUUUUUBUUUBBUUBUUUUUBUBUUUUUBUUUUBBUUBBUBUUBUUBUUUUUBUUUUBUUBUBBUUBBUUBUUUUUBUUUUUBUUUBUUUUBBUUUUUUUU
UUUUUUBUUUUUUUUBBUUUUUUUUUUUUUBUUBUUUUUUUUUUUUUUUUUUUUBUBUUUUBUBUBBBUBBUBUBBBUUUUUUUBUBUBUUUUUBUBUBUU
