UUUBUUUBUUBBUUBUUUUUBBUBUUUUBBBUUUUUUBUUUUUUBUUUUUUUUUUUUUUUBUUUBUUUUUUUBUBUBUUBUUBUUUUUUUUBUBBUUUUUB
BUUUBUBBUBUUBUBUUUUUUUUUBUUUUUUUUUUUUBUBUBUUBUBBUUUBUUBUUUUBUUBUBBUBBUUUUUUUBUBBUUUUUUBUBUUBUUUUBUBBU
UBUUUBBBBUUUUUUBUUUUBUUUBUUUUUUUBUUUBBUUBUBUUUBUUBUUBUUUUUUUUUUBUUUBUBUUBUUUBUBUUUUUBUUUUUUBUBUUUBUUU
UBUUBUBUUBBUBUUUBBBUUUBUUUUUUUBUBUBBUUUUUUUUUBUUUUBUUUUBUBUBUUUUBBUUUBUUUUUUUUBUUBUUBUUBUBUBBUBUUUUUU
BUBUUBUUUUUUUBUBUUUUUUBBUUBUBBUUUUUUBBBBBBUUBUUBUBUUUUBBUUUUBUUBBUUUUUUBBUUUUUUUUUUUUUUBBUUUUBUBBUBUU
UBBUUUUUBUUBBUUUBUBBUUUUBUUUUUBUBBUUUUUUUBBUUBBUBUUUUBUUUUUUUUUBUBUUBUBUUBBUBBUUUUUUUBUBUUUBUBUUUUBUU
BUBUUUUUUBUUBUUUUUUUUUUUBBUUBUBUBUUUBUUUBUUBBUUBBUUUUBUUBUUBUUUUUBUBUUUUUUUUUUUUUUUUUUUUUUUBUBUUUUUUB
UUBUUBBUUBBUUBUUUBUUUUUUUUUBUUUUUUUUUUUUUUUBBUUUBUUUUBUUUUBUBUBUUBBBUUBUUUUUBUUUBUUUBUBUUUBUUUUUUUUBB
BBUBUUUUUUUBUUUUUUBUUBUUBBUBUBUUBUUUBUBBUUBUUUBUUUBUBUUBUBBUBBUUUBBUUBUUBUBBUUUUBUBUUBUBUBUUBUUBBUUUU
UUBUUBUUUUUBUUUUUBUUUBUUUUBUUUBUUBUBUBUUBBBUUBBUUBUBUBUBUUBUBUBUUUUUUUUBBBUBBUUUUUUUUUBUUBUBUBBUUUBUU
UUUBUUBUUBBUUUUBBUBUBBUUUBUUUUBUUUUUUUUUUUBUBUUUUBUUUBUBUUUUBUUUUUUUUBUUUBUBUBUBUUBBUBUUBUUUBBUBUUBUU
UBUUUUBUBUUBBBUUUUUUUUBUUUBUUBUBUUUBUUUUUUUUBUUBUUUUUUBBBUUUBUUBUUUBUUBUUUUBUUBUUUUUBBBBUUUBUUBBBBBUU
UUUUUUUUBUUUBBBUUUBBUUUBUBUUUBBUUUUUUUUUUUUUBUUBBUUBBUUUUBUBBBUUUBUUUUUBUUBBUUUUUUBUUUUBUUUBUUUBBUUUB
BUUUBUUUBUUBBBUUUBBBUUBBUUUUUUUBUUBBUUUUUUUUUUUUUUBUBUBUUUBBUBBUUUUUUUUUUUUUUUBBBUUBBUBUUBUUUUUUBUUUB
UUUBBUBBUUBBUBBBUBUUUUBBUUUUBBBUUUUUBUUUUUBBUUUBBUBUUUUUUUUUBUUUUUBUUBBUUBUBUUUBBBBUUUBBBBUBBUBBBUUUB
UBUUBUUUUUBUUUUBUBUBUUUBUUUUBUBUUUUBBBUUUUUUUUUUBBBUUUUUBUUUUUUUUUUUUBUUBUUBUUBBUUUBUUUBBUUUBUUBUUUBU
UUUUUUBUUBUUUUUUBBUUBUUBUUUUUUUBUBBUUUUUUBUBUBBUUUUUUBUUUUUUBUUUUUBUBUUUBUUUUUBUUUUUBBUBBUBBUUBUUUBUU
UUBUUUBUUUBUUBUUBUUUBUUUUUUUBUUUBUUUBUBUBBUUUUUUUUUBUBUUUBUUUUUUUUUUBUUUBBUUBBUUUUUUBUUUUUUUUUUBBBBUB
BUUUUUUUBBBUUUBUBBBUBBBUBUUUUUUBBUUUBUUUUBBUUBBBUBUUBUBBUBUUBUUUBUUUUBUBUUUBUUBUUUUUBUUUUBBBUBUUUUUUU
UUUBUUUUUBUBUBBUUUUUUUUUUUUUBUBBBBBUUBUUUUUBBUUUUBUUBUUUUUBUBBUBUUUUUUBUUBBUBUBUUBUUUBBUUUUBUBUUUBUUU
BUUUUUUBUUUUUUUUBBBUUUUUBUUUBUUBUBBBUUUBUBUUBBUUUUUBUBBUBUUBUBBBBUUUUUBUUUBUUBBBUUUUBBUUBUUUBUUUUUUUU
UUUUBUUUBUUUUUUBUUUUBUUUUUBBBBUUBUUUBBUUUBUUUUUUUUUBUUUBUUBUBUUUUBUBUBUUBUUBUUUBUBUUUBUUUUBBBBUBUUUUU
BUUBUUUUUUUUUUUUBUBUBBBUUUBBUUUUBBUUBBUUBBBUBBUBBBBUBUBUBUUUUBUBUUUBBUUUBUUBUUUUBUUUUBUUUBUBUUUBBUUBU
BBUUUBUUUUBUUBUUUUUUBUUBBUUUUUUUUUBBUUUUUUBUUBUUUUUUUBUUBUUUBBBUBBBUUBUBUUUUUUUUUBUUBUUUUUUBUUUUUUUUU
UBUBUBUUUUUUUUBUUUBBUUUBUUUBUBUBUUUUUUUUUUBUUBUUBBUUUUUUBUUUUBBUUUBUUUUBUBUBBBBBUUBUUUBUUUUUBUUUUUBBU
BUUUUUUUUBUUUUBUUUUUUBUUBBUUUUUUBUUBUBUUUUBUBUBBBUUUUBUBUBUUBBUUUBUBBUUUUBUUUBBBBUBUUUBUBUUBUUBUUBUBU
UUUUBUBBUUUBUUBBUBUUUUUUUBUUUUBUBUUUUBUUUUUUUUBUUUUBBUBUUBUUUUBUUUBUBUUUUUBUUUBUBUBUUUUUBUUBUBUUUUUUU
UBBUBUUUUUUUUUUUUUUUBBUUUUBUBUUUBUUUUUBUUBBUUBUBUUUBBBBUUBUUBUUUUBBBUUUBUBBBUUUUUUUUUUBUUBUBUUUUBUBUU
UBBBBUBUUUUBUBBBBUBUUBUUUUUBUUUUUUUUUUUUUUUUUUUUUUUUBUUUUUUUBUUUBUBUBUUUUBBUUUBUUUBUUUUBUUUUUUBUUUUBB
BUUBUUBUBUUUUBUUUBUBUUUUBUUBUUUUUUBUUUUUUUUBUUUUUUUBUBUBBUUBUUUUUBUUUUUUUBBBUBUUBBBUUUBBUBUUBUUUBBBBB
BBUBUUBUBUUBUBUUBUUUBUUBBBUUUUUBBBBUUUBUUUUBUUUUUBUUUBBUUUBUUBUBBBUBUUBBUUBUUUUUUUUUBUUUUUUUUUBBUUUUU
UBUUBBUUBUUUBBUUUUUUBUUUUBUUBBUUUUUUUBUBUUUBUBUUUUBBBUUUUUBUUBBBBUBUUBUUUUUUUUBUUUUBUUBBUUUUUUUBUUBUU
UUBUUUBUUUUBUBBBBUUBUUBUBUUUUUUUUUBUUBUUBUUUUUBUBBBUUBUUUBUUBUUBUBBUUBBUUUUUBUUUUBUUUUUUUUUBUUUUUUUUU
UUBBUUUUUUUUUBUBUBUUUUUUUBUUUUUBUBUUUUUUUUUBBUUUUUBUUUUBBBUUUBBUBUBUBUUBBBUUUBBBBUUBUBUUBUUBUBUUBUBBU
UUUUBBUUUUBUUUUBUBBUBUUUUBBUBUUBUUUUUUUUUUUUUUBUBUUUUUUBBBUUBBUBUUUBUUUUUUBUUUUUBUBUUBUUBUUUBUUBUUUUB
UUUBBUUUUBUUUUUUBBBUBUUUUUUUBUUUUBUBUUUUBUUBUUUUUUBUUUBBUUUBUBUUUUUUBUUBUUUUUBUUUUUBUUUBUBUUBUUUBUUUU
UUUBUUUUUBBBUUUBUUUBUUUUUUBBBUUUBUUUBBUUUUUUUUBUUUBUUUUBUBBUUBUUBUBUBUBUUBUUUUUBBUUUUBUUUUUUUBBUBUUBU
BBBUUBUUUUUBBUUBUUUUUBUBBBUBUUBUBBUUUBBUBUUUUUUUUUUUBBBUUUUUUUBBUUUUBUUBUBBUUUBUBBBUUBBUUUBUUUUUUUUUU
UBUUBUBBUUUUBBUUBBUUBBUUUUUBUUUUUUUUUUBUBBUUUBUUUBUUUUUBUBBBUUUUUUUUBUUUUUUBUBBUUUUUUBUUUUUUUUBUUUUBB
BUBBUUUUUBBUUBBBUUBBUUUUUUBUUUBBUUUUBUBUBUUBBBBUBUBUBBUBUUBUBUBUUUUUUBUBUUUBUUUUUUUBUUUBUUUUUUUUUBUBU
UUUBUBBUUUBUUUUUUUBUUUBUUUBUUUUUUBUUUUUUUBBBBUBUUUUUUBUBUBBUBUUUUUUBBUUBUBUUUUUUUBUBUUBUUUUBUUUUUUUUU
UBUUUBBUUBBUUUUUUBUUUBUUUUUUUUBBUBBUUUBUUBUUUUBBUUUUUUUUBUUUUUUUBUBBBUBUUBUBUUBUUBUUUUUBUBUUBUBUUBUUU
UUUUUBUUUUUUBBBBBUUUBBUUUUBBUBUUUUUUUUUUUUBBBUBUUBBUUBUBBUUUUUUBUBUUUBBBUUUBBBUUUUUUUUBUUUUBUUBUBUBUU
BUUUUUUUBUUUUBUUUUBUUUUUBUBUUUBUUBBBUUBUUUUUBBBUUUUUUUUBUUUBUUBUBUBBUUUUUUUUBUUBUUUUUUBUBUUUUUBUUBBBU
UUUUBUUUUUBUUBUBUUUUUUUUUUUBBUUBUUUBUUUUUBUUUUUUBUUUBUBUUBBBUUUBUBUBUUUUUUBUBBUUUUBBUUBUUUUUUUUUUUBUU
UUUUBUBBUBUUUUUUUBUBBBBUBBUUBBUUBUUBUUBUUUUUUUUBUUUUUUUUUUUBUBUBUBUUUBBUBBUUUBUBUUBUUUUUUUUBUUUBUBBUU
UUBUUUUBUBUUUUUUUBUBUUUUUBUBUUBBBBUUUUBUUUBUUUUUUUBBUUBUUUUBUUBUUUUBUUUBBUUUUUUUUUUBBUBUUBUBUUUUUUBUU
BBUBBUUUBUUUUUUBUBBUBBUUUBUBBBUUBUUUUUUUUBUUUUUUBBUUUUUUUUBUBBUUBUUBUUUUBUUUUUBUBUBUUUBBUUBUBUBUUBBUU
UUUUUBUBUBUUUUUBBUUBBBUUBUUUUUUBBUBBBUUUBUBBUBUUUUUUUUUBUUUUBUUUUUBBBBUUUUUUUUUUBBBBUUUUUUUBUUUBUUUUU
UUUUUUUUBUUUUUUBUUUUUBUUUBBBUUBBUBUUBBBUUUUUUUUUUUBBUUUBUUUBBUBUBUUUBUUUUBBUUUUUUUUUBBUUUUBUBUUBBUUUB
UBBBUUBUUBBUUUUUUBUUBBUUBUUBBUBUUUUUUBBUUUUUUUUBUBUUBUBUBUUUBUUUUUUUUUUUUBBUUBBBUUUUBUUUUBBUUUUUUUBUU
UBBUUUBUUUUUBUBUBUUUUUUUBUBBUUUUUUUUBBBUBBUUUUBUUUUUBUUUUBBUBUUUUBUUUUUBBBUUBUUBUBBBUUUUUUUUUUUUUUBUB
BUUUUUUBUUUBUUBBBBUUUBUBUUUUBBBBUUUUBUUBBBBUBUUUUUUUUUBUUUUBBUBUBUUUBUUUBBUBBUUUUUUBUUUBBUBUUUUBBUUUU
UUUUUUUUBUBUBUUUUBBUUUBUUUUUBUUUUBUUUBBUBUUUBUUUBUBUUUBUUUUUUBBUUBUUBUUUBUBBUUBUUBUUBUUBUUUUUUUUBUUUU
BUBBUUUUUUBUUUUUUBUBUBBBUUUUBUUUUUUBUUUUUUUUUUUUUBUUBBBUUUBUUUUBUUUUUUBUUBUUBBUUUUUUUUUUBUUUUUBUBBUBU
BUBBBUUUBUUBUBBBUUBUUBBUBUBUBUUUUUBBUUUBBBUBBBUUUUBBBBUUBUBBBUUBUBUUBUBUUUUUBBUUUUUUBUUBBBBBUBUBBBUUU
UBBUBUBBBUUBUUUUUUBUUUUUBUUUUUUBUUUBUUUUUBUUUUUUUUBBUBUBUUUBBBUUUUUUUUUUUUUBUBUUBBUBBUUUUBUUUUUUUUBUU
UUBUUUUUUBUUUUUUBUUBUUBUBBUUBBUUBUUUUBUUUUBBBBUUBUUBBUUUUUUUUBBUUUUBUBUUBUUUUUUUUBUUUUUUUBUUUUUBUUUBU
BBUBUUBBBUUUUUUUUUUBUUBUBUBUUUBBUUUUUUUUUUUUUUUUBBUBUBUBUUUUUUUBUUBUUUUUUUUUUBBUBUUBBUBUUUUUUBUUUUUUU
UBUUUUBUUBBUUUBBUUBBUUBUBUBBUUUUBUBUUUUUUUUUUUBBBUUBBUUUBBUUBUUUUUUUBUBBBBBUBUUUUBUBUBUUUUBUUBUUUUUBU
UBBBUUUUBUUBUBBUUUUBBUUUBUUBUUUUUUUUUUBUBUUUUUBUUUUBUUBUBUBUUUUUBBUUUUUUBBUUBUUUBUUUUUUUUUUUUBUUUUBUU
UUUUBUUBUUUUBUUUUUUBUUUUBUUUUUUUUBUUUUUBBBUBUUUUUUUUBUUUUBBBUUBUUBBUUUUUBUUBBUBUUUBUBUUUUUBUUUUUBBBBB
BUUUUUUUUBUUBUUUUUUUUUUUUUUBBUBUUUBUUBUUBUBUBBUBUUBUBUUBUUUUUUUUUUBBUBUBUBUBBBUBUBUUUUBUBUUUUUUUUUUBU
UBBBUBUUUUBUUUUUUUUBUUBUUBUUUUUBUUUUUUUUUUUUUBUUUUBUBUBUBUBUBBUUUUUUUUUUUUUUBBBUBUBUBUBBBUUUUBUBUBBUB
UBBBUUUBBBUUUBUBUUUBUUUUUBUUBUBUBBBBUBUBUUUUUBUUUBUUUBUUBUBUBUUUUUBBUUUUUUBUBBBBUUUUUUUUBUBUBUUUUBBBU
UUUUUUUBUUUBUUUUUUUBBBUUUUUUBUBBUUUBBBUUUBBUBUUBUUBUUUUUBUUUBBUUUUBBBUBUUBUUBUUUBUUUBUBUBUUBUUBUUUUUU
UUUUUUBUBUUUBUUUUUUUBBUUBUUUBUUUBBUUBBUUBUUUBBUUUUUUUUUUUUUUUUBBBUUUUBUBBUUUUUUUUBUUBBUBUUUUUBUBUBUUU
UUBBBBUBUUUBUBUUUBUUUUBUUBUUUUUUUUUUUUUUUBBUBBUUBUBUUBBUBUBUBUUUUUBUUBUUBUUUBBUUUUBUBUUUUBUUUUUBUUUUU
BUUUUBUBBUUUBUUUBUUBBUUUUUUBUUBUUUUBBUBBUBUUBBBUUBUUBBBUBBUUUBUBUUUUBUUUBBUUBUUUUUBUUUUBUUBUBBUUUUBUU
UUUUUUUUUUUUBUUUBBBBBUUBUUBBBUUUUUUBBUUUUUUBUUUUBUBBUUUUUUUUBUBUUUUUUUBUUUUUUUBBBUBUUUUUUUUBUBBUBUUUU
UUBBUUUUUUUUUUUUUBBUUUBUBBBBUBBUUUUUUUUUBUBUUBBUUBUBUBUUUUUUUBUUUUUUUUUUUUUBUUUUBUUUBUUUBUBBUBBUUUUUU
UUBUBUUUBBBBUBUBUBBUUBUBUUUBUUUUBUUUUBUBBBBUUUUUBUBUUBBBBUUBUUUBUUBUBUUUUUUBUBUUBUUUUBUBBUUUUUBUUBUUB
UUUUBBUUUUUUUUBUBUUUUBUUUBUUBBUUBBUBUUBUBUUBUUUBUUUUBUBUUUUBUUUUUUBBBBBUUUUUBBUUUUBUUUUUUBUUBUUUUUUBU
BUUUUUBUBBUUBUUUBUBUBUUUUUBBBUUUUUUUUUUUUUUBUBUUUUUBBBUUBUBUUUBUBBUUUBUUUBUBUUUUUUUUUBUUUUBUUUBUUBBUU
BBUUUUBUUUUUBBUUUUUBUUUUUUBUUUUBBBBUUUUBUUUBUUUUBBUUUUBUUBBBBUUUBBUUUUBBBUUUUUUBBUUUUBUUUUUBUUUUBBUUU
BUUUBBBUUUUUBUUUUUBBUUUUBBBUBUUBBBBBUUBUUUBUUUUUUBBBUUUUBUUUBUBUBUUUUUUUUUUUUUUUUUBUUUBUUUUUUBUBUUBUU
UUUUUUUBUBUBBBUUUBUBUUBUUUUUBUUUBUUBBUBUBBBUUUUUUUBUUUUUBBUUUBBUUBBUUBBUUUUBBBUUUBUUUUUUUUUUUUBBUUBBU
UUBUUBUUUBBUBUUBUUUBUUUUBUUUBUUUUBUBUUUBUUBUBUBBUBUUUUUUUBBUUUUUUUUUUUUBUUBUUUUUBUBUBUUUUBUBUUUBUUBUU
BUBUUBUUBUUUUUUUUUUUUUUUUUUBUUBUUUUBUUUBUBBBUUUUUUBUUUBUUUUUUBUUUBUUUUUUBUUBUUBUUUUBUBUUUUUBUUUUBUUUU
UBBBBUUUBUUUUUUUUUUBUBUBUBUUUUUUUUUUBUUUUUBUUUBUBUUUBBUUUUUUBBUUBUUUUUUUUBBUUBBBBUUBUBBBUUUUUUBUUUUUU
UBUUBUUUBUBUBBUUUBUUUUBUBUUUUUUUUBBUBUBUUUBBBBUUUUBUUBBUBUBUUUBUUBBUUUBUUUBBUBBBUUUBBBBUUUBBUUBBUUUBU
UUUUUUBUUBBUUUBBUBBBBUUUBUUUBUUBBUUBUUUUUBBUUUUUUUUUUUBUBUUUBUUBUUUUUUBUBUUUUBUUBUBBUUBUUBUUUBUUUBUBB
UUUUUUUUUUUBUBUUUUUUBUUUUUUUBUBUUUUBBBUBUUUUUUUUUBUBUUUUUUBBUUUUUBUUBUBUUUUUBUBUUUUUUUUBUBUUUBUUUUUUB
UBUBUBBUUUUBUUBUBUUUUUBBBUUUBUBUBUUBUUUUUBBUBBBUBBUUBUUBUUUUUUUUBUUBBUUBUUUBUBUUUUUBUUUUUUUUUUUUUUUBU
UUBUUUUBUUUUUUUUUUUBUUBBUUUBUUUUUUUUUUUUBUUUUUUUUUUUUBUBUUUUBBUUUUBUBUBUUUUUUUUUBUUUUBUUUBBUUUBUUUUUU
UUBBBUBUBUBUUUBBUUUUUBUBBUBUUUBUUBUUUUUUBUUBUUUUUUBBUUUUUBUBUUUUUUUUUUUUBBBUUBUUUBUBUUUBUUUUUBBUBUUUU
BUBUBUUUUUBUUBUUUBBUUUUUUUUUUUUBUBBUBUUUUBUUBUUUBUBBBUBUBBUUUUUBBBUUUUUUBUUBBUUBBBUBBUBBUUUUUUUUBUUUU
UUUBUUBBUUUUUUUUBUBBUUUBUUUUUUUBBUBUBBUUBBUUBBUBUUUUUUUBUUUUUUUUBBUUUUUUBUUUUUUUBUUUUBUUBUBUUUBBUBUUB
UBUUUUUUUUUUUUUUUUUBUUBUUBUBBUUUUUUUBUUUBUUUUBUUUUUUUBUUBUBBUUBUUUUBUUUBUUUBUUBUBUBUUUBUBBUBUBUBBBUUU
UUBUUUBUUUUBUBUBBUUUUBBUBUUUBBUUBUBUBUUUUUUUUUBBBUBUUUBUBBUUUUUBUUUBUUUUUUBUUUBUUUUUUUUUUUUBBUBUUUUUU
UBUUBUUBBBBUUUUUUUUUUBUUUUBUUUBUUUBUUBUBBUUUUUUUUBBUBBBBUBUUBUUUUUBUBUBBUUUBUBUBBUUBBUUBUUBUUUUUUUUUU
BUBUUBUUBUBBBUBUUUUUUUUBBUUUUUBUBBUUUUBUUBUUBUUUUUUUBUUUBUBUUUUBUUUBUUUUBBUUUUUBBUBUUUUUUUUUUUBBUUUBB
BUUBUUBBBUUUBBUUUUUBUUUBUUUUUUBUBUUUUUBUUBUUUUUUUUUBBUBUBUUBBUBUUUUBUUUUBBBUUUBUUUBBBUUBBBUUUUUUBBUUB
UUUBUUUUBUUBUUBBBUBUBBUUBUUUUUUBUUBUBUBUUBUUBUUBUUBUUBUBBUUUUUUUUUUUUBBUBUUBBBUUUBUUUUUUBUBUBBUBUUUUU
BBUUBBUUUUUUUUBUUUUUUBUUUUUBBBBUUUUBBBUBBUUUUUUUUUUUBBUBUUUUBBBUUUUUBBBBUUUUUBUBUUUBUUUBBUUUUBBUUUUUB
UUBBUUUUUUBUUUUUUBUUUUUUBBUUUUUUUUUUUBUUBUUBUUUBBUBBUBBUBBBBUBUBUUUUUUBUUBUUUUUUUBUUUBUBBUUUUUUUUUBUU
BBBBUUBUBUBUUBBUUBUUUUBBUUBUUUUUUBUUUBBBUBUUBUUUUBBUUUUUUUUBUUUUUUUUUUUUUBUUBUUBUUUUUUUUUBUBBUUUUBUUU
UBUUUUUUUUBUUUUUUUUUUBBUBUUUUUUBUBUBUUBBUUUUUUUUBUUUBUUUUUUUUUUUUUUBUUUUUBUUUUUUUUBBUUUBUUUUUBUBUBBUU
UUBUUUUUBUUUUBBUUUBUBBUUUUBUUUBUUBUUUUUUUUUBUUBUBUUUUUBBUUBUUUUBBUUUUUUBUBUUUUUUBBUUUBUUUUUUUUUBBUUUU
BBUUUUUBUUBUBBUUUBUUUBUUUUUUUUUUUBUUBUUUBUBBUUBUBUUUBUUUUUUUUUBUUUUBUUUBUUUBBUBBUBUBUUUUBUBUUBUUUBBUU
UUUUBUUUUBBUUUUUUUUBUBUUUUBUUUUUBUUBUUUBBUBUUUUUUUUUBUBUUUBUBUUUUUUUUUUUBUBUBUUUBUBUUUUBBUUUUUBUUBBUU
