UUBBUBUUUBUUBBBBBUBUUBBUUUUBUBUBUBUBUUUUBUUUUUUUUBUUUUUUUUBUUUUUUUUUBBUUUBUUBBUUUUBUUUUUUUUUUUUBBUUUU
BUUUBUUUUUUUBUUUUUBUUBUUUUUBBBUUUUBUUBUBUBUUUUBUUUUUUBUUUUUUBUUUBBUUUUBUUUUUUUUBBBUUUUUBUUUUUBUUUUBUU
UUBUBUBBUBBBUUBUUUBUUUUUUBUBUUUUBBUBUUUUUUUUUBBBUBUUBUUBBUBBUUBUUUBBUBUUUUUBUBBBUUUUUUUUUUBUUUUUUUBUU
UUUUUUBUUUBUBUUUUUBUUUUUUUUUBUUUBUUUUUBUBUUBUBBUBUUUUUBBUUBBBUUUBUBUUUUBUUUUUBUUUUBUUBBUUUUUUBUUBUUBB
UUUBUBBBBUUUUBBBUUUUUBUUBUUUUUUUBUUUUBUBUUBUBUUUUBUUUUBUUUUBUUUUUUBUBUUUUBUUUBUBUBUUUBUBBUUUBUUBUUBUU
BUUUUUUBBBUBUUUUUBBBUBUUBBUUUUUBUBUBBUUBUUUUUBUUUUUUUBUBUUUUUUUBUBBUUUBUUUBUUBUBBUUUUUUBUUUBBBUBUUUBU
UUUUUUUUUUUUBUBUBUUUUUUBUUUUUUBUBUBBUUUUBUUUBUBUUUUBUUBUUUBBUUBUBUBUBUUUBUBBUUUUUBUUBBBUBUBUBBUBUUBUU
UUUUBUUUUUBUUBBBBBUUUUUUUUUBBUUUUUBBBUUUUUUUUBBUUUBBUUUUBBUBUUBUBBUBUUBUUUBUUUUUUBUUUUUBBUUUBUUUUBBBB
BUUUUUBUUUUUUUBUBUUUUUUUUUUUBUUBUUUUUBUUBBBBBBUUUBUUUUUBUBBUUUUBBUUBBUUUBBUUUBUBUUUUBUUUUUUBUBUUUUUBU
UUUUUUUBBUUBUUBUBBUUUUUBUUUUUUUUBUBBUUUBBUUUUBBUUUUBUBUUUUUUBUUUUBUUUUUUUBBUUUUBUUUUUUUUUUBUUBUBUUBBU
UUUUUUUUBBUBBUUUBUUUBUUBUUBUUBUUUUBUUBBUUUUBUUBBUBUBUUUBUUUUUUBUUBUUBBUUBBUUUUUUUBUUBBBBBUUUUUBBBBBUU
UBBUUUBBUUUBUUUUBUBUBBUUUUUUUUUUUUUBUUUUUUUBUUBUUUUUBUUBUBUUUBUUBUUBUUUBUUUUBUUBUUUUUBUBBUUBUUUBBBUBU
UUUUUUBUBUUBBUUBUBBBUUUUBUUUBUUBUBUUUUUBBBBUUBUUUBBUBUUUUUBBUUUBUUBUUUUUUUBBUUUUUUUUUUUBUUBUUUUBUBUUB
BUUBBUUBUUUBUBBUBUUBUUBUUUBBUUBBUUUUBBUUBUUUUUBBUUUUUBBUUUUBUBBBUBUBBUUUBUUUUBUUBBBBBUBUUBUUUUBUUBUUU
UBUBBUUUBUUBUUUUUUUBUUUUBBUUUBUUUUBUUBUUUBUUUUBUUUUUUBBUUBBUUUBUBUBUUUBBUBBUBUUBUBBUUBUUUUUUUBUBBUUUU
UBUUUUBUUUUUBUUUBBBUBBBUUUUUUBUUUUUUUBBUUUUUUUUUUBBUBBUUUBBUUUUUUUBBUUUUUBUUBBUUUUUUBBBBUUUBUUUUUUUUB
UBUUBUUUUUBBBBUUUUUBBUUUUUUUUUBBBUUBUUUUUBUUUUUUUUUBUUUBUBBBUBBUBBUUBUUUUUUBUBUUUUBUUUBUUUBBUBUUBBUUU
UUUUUUUUBBUUBBUUUUBUUUUBBUUBUUBUBUUUUUBUBUUUBUUUUUUUUBUUBBUUBUUUUUUBBUUUBBUBBUBUUUUUUBUBBUBUUUUUUBBUU
UUUUUUUUUUUUUBBBUUBBUUUUUBBBBUBBUBUBBUUUBUBBBBUUUUUUUBBUBUBUUUBUUBUUUUUUBBBUUBUUBBUBUBBUUBUUUBBBBUUBU
UUBUBUUUUBUBUBUBBUBBBUBBUBUUUBUBUUUUBBUUUUUBBUUBUBBUUUUBUUUUUBUUUUUUUBUBUUUUUUBUBUUUUBBBBUUUUUUUUUUUU
BUUUBUBUUUUBUBUUUBBUUBUBUBUUUBBUUBBBBUUUBUUUUUUUUBUUBBUBBUUUUUUUBUBBBUBUUBBUUUUUUBUUUBUUUBUUUBBUUBUUB
BUUBUUUUBUBUUUUBUUUUBBUUUBBUUUBUUUUUBUUBBBBUUBUBUUUUUBUUUBBUUUBUUUUUUUUBUUUUUUUUUUUBUBBUUUUUUUUUBUUBB
BUUUBBBBBUUUBUUBUUUUUBUUUUUUUUBUUBBUUBBBUUUUUBUUUBUUUUUBUBUBBBUUUUUUBUUUBBBUBUUUUBBUUUUUBUUUUUBUBBUBU
UUUBUBUUUBUUUBBUBUUUBBUBUUBUBUUUUUBUBUUUUBUUBUUUUUUUUUBUUBUUBUUUBUUBUUUBUUUBUUBUUBUUUUUUUBBBBUUBUUUUU
UUUBUBUUUUUUUUUBUUUUUUUUUUBBBUUUUUUBUBBUBUUUBBBUUUUBUUBBBUUUUUUUUBUUUUUBUBBUUUBUBBUUUUUBBUUUBUUBUUUUU
UUBUUUBUBBBUBUUUUBUUUBUUBBUUBUBUUUBUUUUBBUBUUUUBUBBUUUBUUBUBBUUUUUUUUUBUUBUBBUUUUUUUUBUBUUUBBUUUUUBBU
UUUBUUBUUBUUBBUUBBUUUUBBUUUUUUBUBUUUBUUUUUBUUUBUUUBUUUUBBUUBUUBUBUUUUUUUBUUBUUUUUUUUBUBUUBUBBBUUUUUUU
BUBUBUBBBBBUUUUBUUUUUUUUUUBUUUUUUBUBBBUBUUUUUUUBUUUUUUBUBBBUUUBBUUUUUBUBUBUBBBUBUUUBUUUUBUUUUUUUUUUUU
UUUUUUUUUUUUBBBUBUUUUUBBUUBUUBBUBUBBUUBUBUUBBUUBBBBBBUUBUBUUBUUUBBUUUBUUUUUUUUUUBBUBBUUBUUUUUUBUUUUUU
UBBBUUBUBBUUBBUUBBUBUBUUBBUUBBUBUUBBUBUUUUUUUUUUUUUUBBUUUUUUBBUUUUBUBUBUBUUBUUUBUBUBBUUBUBBUUBUUUBUUB
BUUBUUUUBUUUBUUUBBBUBUUBUUUUBUUBBBBUUUBBUUUBUBUUBUUUUUUUUUBUUUUUUBUBBBUBUUUUUUUUUUBBBBUUUBUUUBBUUUUUU
BUUUUBUUUUUUUUUUBUUUUUUUUUBUUBUUBUUBBUUUUUBBUUUUBUBUUUBUUUUUUUUUUUUUBBUBUBUBUBUUBUUUUUUBUUUUUUUUUUUUU
UUUUUUUBBBBUBUUUBUUUUUUBBUBBUBUBUUUUBUUUBUUUUUUBUUUUUUBUUUUBUUUBBUUUUUBUUBUUBUBUBBUBUUBUUUUBBUUUUBUUU
UUUUUUBUUBUUUBUBUUUUUUUBUUUBUUUBUUUUUUUUUUBUUBBUBBUUBUUUBBUUUUUBUUUUUBUUUBUBUUBUUUUBBBUUUUUUBUUUUUUUB
UUUBUBUUBUUUUUUUBUUBUBUUBUUUBUUUBBUUUUUBUUUUBUUBUUUUBUUBUUBUUUBUBBBUUUUUBUBUUUUUUUUUUUBUUUBBBUUUUBUUU
UUBUBUBUUBUUBUUUUBUBUUBBUUUBUUUUBBUBUUUUUUUUUUUBUUBUUBUUBBBBBBBUBBUUUBUBUUUBBBUUUBBUBUUBUUBBUUUUUUUUB
UUBUUUUUBUUUUUUUUUUUUUUUUUUBUUUBBUUUBUUUUBUUUBBUBBUBUBUBBUUUUUBUBBUUBBUUUUUUUUUUBUBUBBBBUUUUBUBUBUUBU
UUBBUUBBUUUBUBUBUUUUUUUUBUUUBUUUBUBBUUBBUUUBUUUBUUUUUUUUBBUUUUUUUUBUBUUUUUUBUUUUBBUUUUUUUUBUUBUUUUUUU
UUUBBBUUUUUBUUBBUBBUUUBUUUBUUUUUUBUUUUUBUUUBUUBBUUUUUBUUUUUBUUUUUUBUBUUUBBUBUBBUUUUUBBUUUUBUUBUBUBUUB
UUBBBUBUBBUBUUBUUUUBUUUUUBUUUUUUBUBUUBUUBBUBUBBUUUBUUUUBBUUUUUUUUUBBUUUUUUBUUUUUUBBUUBUUUBUBUUUUBUUBU
UUUUBUUUUUBBUUUUUUUUUUUUUUUUUUUUUBUUUBUUUUUUUBUBBBUUUUBBUUUUBBBUBUBBBUUUUUUUBBBBUBBBUUUUUBUBBUUUBUUUB
UBUBBBUBUUBBBBUUUBUUBBUBUUUBUBUUBBUBBBBUUUBUUUUUUBUUUBUUBBUUBUUBBBUUUBBUBUBUBBBBUUUUUUUUUUUUUUBUUUUUU
UUBUBUUUUUUUUUBBUUUUUUUUUUUUUBUBUUBUBUUUUUUUUUUBUUUUBUUUUUBUUBBUUUUUUUBUBUUUBUBUBUBUUBBBBUBUBUBBUUBUU
UUBUUUUUBUUUUUUUUUUUUBUBUUUUUUUUUUBUBUUUUUUUUBBUUBBUUUUUBUBBBUUUUUUUUUUUUUUUUUUUUUBUUUUUUBUBUUBBBUUUB
UUUBBUBUUBUUBBUUUUUUBUUBBUUBUUUUUBUUUBUUUUUBBUUBBUUUBUBUUBUBUUUBUUBUUUBUUUUUUBUBBBUUUUUUUUUBUUBUUUUBU
UBUUBUBUBBUBBBUUUUBUBBUUUUBUUUUUUUBUUUUBUUUUBUBUUUUBBBUUUUUUUBUUUBUUUUUUBUBUUUBBBUUUUUUUUUUBBUUBUUBUU
UUUUBUBUUUUUBBUUBBUBUUUBUUUUUUUBUUUUBUBBUUUUUUUBUBUUBBUUBBUBUBUUUBBBUBBUUUUUUUUUUUBUBUUUUUUUUBUUUUUBU
BUUBUUBBUUBUBUBUUUUUUBBBUUBUUUUUUUUUBUBBUBBUUUUUUBBUUUUUUUUUUUUUBUBUBUUBUUUUUUUBBUUBUBUBUUBUBUUBUBUUB
BBUBUUUUUUBUBBUUUBUBUUUUBBBBBUUUUUUUUBBUBUUUUUBBUUUUUBUUUUUUBUUBUUUUUBBBBUUUUUUBUUUUBUUUUUUBBUUUUUUUU
UBUUUUUUUUBBUUUBUUUBUUUUBBBUBBUUUUUBUUUBBBUUUUUUUUBUUUUUUUUBUBUUUUBUBUUUUBBBBUUUUUUUUUUBUBUUBUUUBBBUU
UUUBBUBBUUUUBBUUUUBBBBUUUBUBUUUBUUUUUBBUUUUBUUBBUUUUBUUUUUUUUBUBUUUUUUUUUUUUUBBBUUUUBUBUUUBBUUUUUBBUU
UUUUBUUBUUUUUUUUBUUUUUBUUUBUUUUBUBUUUBUUUBUBBUBUUBUUUBUUUUUUUUBUBUBUUBUBUUUBUUBBUUBBBUUBUUBUUBBUUUUUU
UBUBBUBUUBBUUUUUUUUBUBUUUUUBUUUUUUBBUBUUBUUBBUUUBBBBUUBUUUUUUUUUUUBBBBUUUUUUBBUBBUUUUUBUUUBBUUUUBUBUU
UUBUBUBBBUBUUUUUBUBUUUUUBUUUBUBUBBBUUBUBBUUUUBUUBUUBUUBUUUUBUUBUUBBUBUBUUUUUBBUUUUUUUUUUBUUUUUUUUUBUU
UUUUUBBUBBUUUUUBUBUBUUUUUUBUUUBUUUUBUUBUBUUUUUUUUUUUUUUBUBUUUBBUUUUUUUBUBUUUUUBUUUUBUUUUUBBUBUUUUUUUU
BUBBUBUUUBUBBBBUBUUUUBUUUBUUUUUBBUUBBUUUUUUUUUUUUBUUBUUUUUUBBUUBUUBUBUBUUBUUUBUUUBUUBUBUUUUUUUUBUBBUB
BUUUUUUUUBUBUUUUBBUUBBUUUUBUUUUUBUUUUBUUUUUUUUUUUBUUUBUBBUBUUUUUBUBBBUUUUUUUBUBBUUBUBUUUBBUUUUUBBUBUU
BUBUUBUUUBBUUUUBUUBUUBUBUBBBUUUUUUUBUBBBUUBUUUBUUBUUUUUUUUUUUUUBUUBBUUUBBUBBBBBUBUUBUBBUUUUUUUBUUUUBU
BUUUUBUUBUBUUUUBUBUUUUUUBUBUBUUUBUUUUBUUUUUUUUUBUBBBUBUUUUUBBBUUUUUUUUUUUBUBUBUUUUBBBUBUUUUBUUUUUUUUU
BUUUUUBBUUUUUBUBUUUUUUBUUBUUUUBUBBUUUUBUUUUUUUUBUUUBUUUUBUUUUUBUUUUUBUUBUUBUUUBUUUUUUUBUUUUUUUUBUUBUU
UUUUBBBUUUUUBBBBUUUUUUUUUUBUUUUUUUUBUUBUBUBBUUUUUUUBBBUUBUUUUUUUUBUUBUUUUUBBBUUUBUUUUUBBUBBUBBUUUUUUB
UUUUBUUBBUUUUUUUBUBBBBUBUUUUUBUUBBUUBUUBBBUBBUUBUUUBUUUUUBUUBUBUUBUUUBUUUUUUUBUUBBUUBUUUUUUUUUBUBUUUB
BBUBUUUUUUUUUUBBUUUBUBBUUBUUUUUBUBBUUUUUBUUBUBUBUUUUUUUUUBUUUUBBBUBUUUBUUBUBBBUBBUUUUBBUUBBUUBUUBUUUU
UBBUUUUUUUBUUBUBBUUBUUUUUUUBBUUBUBUUUUUBUBUBUUBUUUUUUBBUUUUUUBBUUUUUUUUUBUUUUBUUUUBBUUUUUUBUUUBUBUUUB
BUUUUUUBUBUUUUUUBUBUUUUUUUUUUBBUUUBBBUUBUUUUBUUUUUUUUUUUBBUBUUUBBUUUUUUBUUUBUUUBBUUUBUUUUBUUUUUBUUUUU
UBUUBUUUBUUUUBUUBUUUUUUUUUUBUUUBUBUUUUBBBBUBUUBUBUUUUBUUUUUUUUUBUUBUBUUUUUBUUUUUBBUUBUUUBBUUBUUBBUUUU
BUBUBUBUUUUBUUUBUUBBUUUUBBUBUUBUUBUBBUUUUUBBBBBBUUUBBUBBUBUBUUUBBUBUBUUBUBUUUUBUUBUUBUUUUUBBUUUUUUBUB
UUBUUBBBBBUUBUBUBUBBUUUUUBBUUUUBBUUBUUBUBUBUUUBUUUUUUUUUUUUUBUUBUBUBBUUUUUBBUUBBUUUBBUUBUBUUUUBBUBUUU
BUUUUBUUBUUUUBUBBUBUBUUBBBBUBUUBUBUUBBUBBBBBUUUUUUBBUUUBBBUUUUUUBUUUBUUBUUBBUBBUBBUBUBBUUUUUUUUUUUUUB
UUUUUBUUBUUUBUBUUUUBBUUUBUUBUBUUBBUBUBBUUUUUUBUBUUUUBBUUUUUUBUUUUBUBBBUUUUUUUUUUUBUBUUUUUBUUUBBUUUUUU
BUBUUUUUUBUUUBUUUUBUUUUBUUUUBUUBUUBUUUBUBUUBBBUUUUBUBBBBBUBUUBUUBUBBBBUUUBBUUUUBBUUUUBBBUUBBUUUBUUBUB
UUUUUUBBUUUUUUBBUUUBBUBUBUBUUUUUUUBUUBUUUUUUUBUUUUBUUBUUUUUUBUBBBUBUUUBBUUBUUBBBUUUUUUUBBBUUBUBBUUUUU
UUUUBUBBBUUUUUUUUBBUBUBUUBBUBUUUBUUUUUUUUBUUUUUUUUBUUUBUBBUBUBUUUUUUUBBBUBUUUUUBBUBBUUUUUBUUUUUUBUBUU
UUUUBUBUBUBBUUUBBUBUUUUUUUBBUUBBBUUUUBBUUUUBUUBUUUUUBUBBUUBBUUUUUBUUUUUUUUBUUUUBUBUUUUUBBUUUBBUBUUBUU
UUBBBUUUUBBBBUBBUUUUBUUBBBUUBBUUBUUUUBUUUUUUBUUBUBBBBUBUUUUUUUUBBBBBUBUUUUUBUBUBUBUUBUUUBBUBUUBUUBUBU
UUUUUUUUUUUBUBUBUUUBUUUBUUUUUBUUUBUUUUUBUBBUUBUBBBUUUBBUBBBUUUUBUUBUBBUUUUBUBBUUUUUUUUUUUUUUBUUUUUBUB
BBBBUUUUBUUBBUUUBUUUBBUBBUBUUUBUUUUBUUUUUUUUBBUUUUBUUUUBUUBUUUUBUBUUBUUUUBUUUUUUUBUUUUUUUUUUBUBBUBUUU
UBBBBBUBBUUUUUUUUUUUUBBUUUUBUUUUUUUBUUUUBBUBUBBUUUBUUUUUUBUUUBUBUBUUBUUUUUBBBBUUUBUBUUBBUBUUUBBUUBUUB
UUUUUBBUBUUBUBUBUBUUUUBUBBUUBBUBBUBUBBUUUUUUBBBBBUBUUUUUUUBBUUUUUUUUUBBUUUUUUBUUUUUBUUUUBUUUBUUBUUBUB
UUUBUUBUUUUUBUUUBUUUUUUUUUUUUUUBUBUBBUUUUUUBBBUUUUBBBBBUUUBUBBUUBUUBUBUUUUBBUUBUUUUBUUBUUUUBUBUBBBBUU
BUUUUBUUUUUBUUUBUBUUUBBUUBUUUUUUBBBUUUUUBUUUUUUBBUUUUUUUUUUUUUUUUBBUBUUUUUBBUUBUUUUUUUUBUUUUUUUUBUUUU
BUUUUUUUBUUUUUUUUUUBUBUUUUUUBBUUUUUUUUBUUUUBUUUBUUUUUBUBUBUUBUUBBBUUUUUUBBUBUBUUBUUUUUUUUUBUBUBUUUUUU
BBUBUUBUUBUUBBUBUUUUUUUBUUBUBUUBUUUUUUUUUUUUUUUUUUUUUBBUUBBUUUUUBUUBBUUBUBUUBUUUBBUUUBUUUUUUUUUUUUUUU
BUUBUBUUBUUUBUUUUUUUUBUBBUUUUBUBUBUBBUUUUUUUUBBUBUBBUBUUBBUUUBUUBUUUUUUBUBUBUUUUBBBUBBUUUUUBUUUUUUUUU
BBUBBUUUUBUUBUUUUBBUUUUUUUUUUUUUUBUUBUBUBUBUUUUUBBUBBBUBUUBBUUBBBUBUUUUUUBUBBBUBUUUUUBUUUUUUUUUBBUBUB
BUUUUUBUUUUBUUBUUUUBUUUUBUUUUUUUBUUBUUUUUUUUUUBBBUBUBBUUBBBUUUUBUBUUBBUUBUUBUBBUUBUUBUUUUUUUUUBUBUBUU
UUBUUUBUBUBUUUUUUBUBBUUUBUUUUUBBBUBUUUUUUUBUBUUBBUBBBUBBUBBBUUUUBUUBUUUUUUUBUUBBBUBBUBBUBBBUUUBUUUBUB
UUBUUBUUBUUBUUBBUBUUBUUUUBUUBUBUUUUUUUUBBBBUUUUUBUUUBUUUBUUUUUUUUUUUBBUUUUUBBUUUUUBUBUUUUBUUUUUUBUBUU
UUUBUUBUUBUBUUUBUUUBUBBUUBBBBUUUUUUBUBUUUUUBUUBUUBUBUUUUUUUUBUUUUBUBUBUUUUUUUUUBUBUBBBUUBUUBUUUUUUUBB
UUUUBBUUUBUBUUUUUUUUUUBUUBUBBBBUUUBBUUUUUUUUBUUUUUBBUUBUBBUBBUUUUUUBUUBBUUUBUUUBBUUUUUUBUUUBUUUUUBUUB
BUUUUBBUUBBBUUUBUUUUBBUUUUUUUUBUUUBBUUBUUBBBUUBUUBUUBBUUUUUBBUUBUBUBBUBBUUUBBUUBUUUBUBUUUBUUBUBUUBUUU
BUUUUUUUUUBBUUUUUUUUUUBUBUBBUBUBUUBUUUUBBUUBBBUUUUUUUBUUUUUUBUUUBUBUUUUBBBUUUUBBUBUUUBUUUBUUUUUUUUUBU
UUUUUUUUUUUUUBBUBUUUBUUUUUUUUUUUUUUUUBUUUUUBUUUBUUBUUUUUBBUUUBUUUUUBUUUBUUUUUUUUBUUUUUUBUBUUUUUUBUBUU
UUBUUUUUUUUUUUBBUUUUBUBBUUUUUUBUBUUUUUBBUBUUUBUUUUUUUBUUUUUUUUUUUUUUUBUUUUBUUBUUBBUBUBUBBUUUUUUBUBUUU
UBUUBBBUUUUBUUUUUUUUBBUUUUBUUUUUUUUUBUUUUUBUUUUUBBBUUUUUBUUBUUUUUUUBUUUUUUUBBBUUUUBBUUUUUBUBUUUBUUUUU
UUUBUUBBUUUUUBUUBUUBUUBUUBUBUBUBUUBUUUUBUBUUBUUUUUBBBBUUUBBBBUUUUBUBBUUUUBUUUUUBUUUUUUUUBUUUUBUBBUUUU
UUBBUBUBUBUUUUBUUUUBBUBBUUUUBUUBBBUUUUUBUBUUUUUUBUUBBUBUUBUUBUUUBBUUUUUUUUUUBUUUUBUUUUUUUBBBUUUUUUUBU
UUUBUBUUUBBUUUUUBBUUUUBUUUBUBUBUBBBUUUBUUUUUBUBUUUUUBUUUUUUUUBBBUUUUBUUUUUBUUUBBUBBUBUBUUBBUUUUUBUUUU
UBBBUUBBUUUBUBBUBUUUUUUUUBUBUUUBBBUUBUUUUBBUUUUUBUUBUUUUBUUUUUUUUUBUUUBUUUUUUUUUUUUUUUUUUBUUBUUBUUUUU
UUBUUUBBUBBBUUUBUUBUUUUUUUBBUUUUBUUUBUUBUUUBUUUUUUUUUUBUBUBUUUUBUUUBUUUUBBUBUBUBUUUUUUUUUBUUUUUUUUBUB
UUBUBBUBUBUUBUBUUUUUUUUUBUUBBUUBUBBBBBUUUBUUUUUUUBUUBBUBUBBUUUUBUBUBUBUUUUUUBUUBBUUBBUUBUUUUUBBBBBUUU
